,date1,date2,away,home,away_team_score,home_team_score,game_id,spread
0,2012-10-30,2012-10-29,WASHINGTON_WIZARDS,CLEVELAND_CAVALIERS,84,94,1,10
1,2012-10-31,2012-10-30,BOSTON_CELTICS,MIAMI_HEAT,107,120,2,13
2,2012-10-31,2012-10-30,DALLAS_MAVERICKS,LOS_ANGELES_LAKERS,99,91,3,8
3,2012-10-31,2012-10-30,INDIANA_PACERS,TORONTO_RAPTORS,90,88,4,2
4,2012-10-31,2012-10-30,DENVER_NUGGETS,PHILADELPHIA_76ERS,75,84,5,9
5,2012-10-31,2012-10-30,HOUSTON_ROCKETS,DETROIT_PISTONS,105,96,6,9
6,2012-11-01,2012-10-31,SAN_ANTONIO_SPURS,NEW_ORLEANS_HORNETS,99,95,7,4
7,2012-11-01,2012-10-31,SACRAMENTO_KINGS,CHICAGO_BULLS,87,93,8,6
8,2012-11-01,2012-10-31,DALLAS_MAVERICKS,UTAH_JAZZ,94,113,9,19
9,2012-11-01,2012-10-31,GOLDEN_STATE_WARRIORS,PHOENIX_SUNS,87,85,10,2
10,2012-11-01,2012-10-31,MEMPHIS_GRIZZLIES,LOS_ANGELES_CLIPPERS,92,101,11,9
11,2012-11-01,2012-10-31,LOS_ANGELES_LAKERS,PORTLAND_TRAIL_BLAZERS,106,116,12,10
12,2012-11-02,2012-11-01,OKLAHOMA_CITY_THUNDER,SAN_ANTONIO_SPURS,84,86,13,2
13,2012-11-02,2012-11-01,INDIANA_PACERS,CHARLOTTE_BOBCATS,89,90,14,1
14,2012-11-02,2012-11-01,DENVER_NUGGETS,ORLANDO_MAGIC,89,102,15,13
15,2012-11-02,2012-11-01,HOUSTON_ROCKETS,ATLANTA_HAWKS,109,102,16,7
16,2012-11-02,2012-11-01,MILWAUKEE_BUCKS,BOSTON_CELTICS,99,88,17,11
17,2012-11-02,2012-11-01,CHICAGO_BULLS,CLEVELAND_CAVALIERS,115,86,18,29
18,2012-11-03,2012-11-02,SACRAMENTO_KINGS,MINNESOTA_TIMBERWOLVES,80,92,19,12
19,2012-11-03,2012-11-02,UTAH_JAZZ,NEW_ORLEANS_HORNETS,86,88,20,2
20,2012-11-03,2012-11-02,MIAMI_HEAT,NEW_YORK_KNICKS,84,104,21,20
21,2012-11-03,2012-11-02,PORTLAND_TRAIL_BLAZERS,OKLAHOMA_CITY_THUNDER,92,106,22,14
22,2012-11-03,2012-11-02,DETROIT_PISTONS,PHOENIX_SUNS,89,92,23,3
23,2012-11-03,2012-11-02,MEMPHIS_GRIZZLIES,GOLDEN_STATE_WARRIORS,104,94,24,10
24,2012-11-03,2012-11-02,LOS_ANGELES_CLIPPERS,LOS_ANGELES_LAKERS,105,95,25,10
25,2012-11-03,2012-11-02,SACRAMENTO_KINGS,INDIANA_PACERS,98,106,26,8
26,2012-11-03,2012-11-02,BOSTON_CELTICS,WASHINGTON_WIZARDS,89,86,27,3
27,2012-11-03,2012-11-02,TORONTO_RAPTORS,BROOKLYN_NETS,100,107,28,7
28,2012-11-03,2012-11-02,DENVER_NUGGETS,MIAMI_HEAT,116,119,29,3
29,2012-11-04,2012-11-03,NEW_ORLEANS_HORNETS,CHICAGO_BULLS,89,82,30,7
30,2012-11-04,2012-11-03,PORTLAND_TRAIL_BLAZERS,HOUSTON_ROCKETS,95,85,31,10
31,2012-11-04,2012-11-03,CHARLOTTE_BOBCATS,DALLAS_MAVERICKS,99,126,32,27
32,2012-11-04,2012-11-03,CLEVELAND_CAVALIERS,MILWAUKEE_BUCKS,102,105,33,3
33,2012-11-04,2012-11-03,UTAH_JAZZ,SAN_ANTONIO_SPURS,100,110,34,10
34,2012-11-04,2012-11-03,GOLDEN_STATE_WARRIORS,LOS_ANGELES_CLIPPERS,114,110,35,4
35,2012-11-04,2012-11-03,PHILADELPHIA_76ERS,NEW_YORK_KNICKS,84,100,36,16
36,2012-11-04,2012-11-03,PHOENIX_SUNS,ORLANDO_MAGIC,94,115,37,21
37,2012-11-04,2012-11-03,MINNESOTA_TIMBERWOLVES,TORONTO_RAPTORS,86,105,38,19
38,2012-11-05,2012-11-04,ATLANTA_HAWKS,OKLAHOMA_CITY_THUNDER,104,95,39,9
39,2012-11-05,2012-11-04,DETROIT_PISTONS,LOS_ANGELES_LAKERS,79,108,40,29
40,2012-11-06,2012-11-05,NEW_YORK_KNICKS,PHILADELPHIA_76ERS,110,88,41,22
41,2012-11-06,2012-11-05,MINNESOTA_TIMBERWOLVES,BROOKLYN_NETS,107,96,42,11
42,2012-11-06,2012-11-05,PHOENIX_SUNS,MIAMI_HEAT,99,124,43,25
43,2012-11-06,2012-11-05,UTAH_JAZZ,MEMPHIS_GRIZZLIES,94,103,44,9
44,2012-11-06,2012-11-05,PORTLAND_TRAIL_BLAZERS,DALLAS_MAVERICKS,91,114,45,23
45,2012-11-06,2012-11-05,INDIANA_PACERS,SAN_ANTONIO_SPURS,79,101,46,22
46,2012-11-06,2012-11-05,GOLDEN_STATE_WARRIORS,SACRAMENTO_KINGS,92,94,47,2
47,2012-11-06,2012-11-05,CLEVELAND_CAVALIERS,LOS_ANGELES_CLIPPERS,108,101,48,7
48,2012-11-07,2012-11-06,ORLANDO_MAGIC,CHICAGO_BULLS,93,99,49,6
49,2012-11-07,2012-11-06,TORONTO_RAPTORS,OKLAHOMA_CITY_THUNDER,88,108,50,20
50,2012-11-07,2012-11-06,DETROIT_PISTONS,DENVER_NUGGETS,97,109,51,12
51,2012-11-08,2012-11-07,PHOENIX_SUNS,CHARLOTTE_BOBCATS,117,110,52,7
52,2012-11-08,2012-11-07,INDIANA_PACERS,ATLANTA_HAWKS,86,89,53,3
53,2012-11-08,2012-11-07,WASHINGTON_WIZARDS,BOSTON_CELTICS,94,100,54,6
54,2012-11-08,2012-11-07,BROOKLYN_NETS,MIAMI_HEAT,73,103,55,30
55,2012-11-08,2012-11-07,DENVER_NUGGETS,HOUSTON_ROCKETS,93,87,56,6
56,2012-11-08,2012-11-07,MEMPHIS_GRIZZLIES,MILWAUKEE_BUCKS,108,90,57,18
57,2012-11-08,2012-11-07,ORLANDO_MAGIC,MINNESOTA_TIMBERWOLVES,75,90,58,15
58,2012-11-08,2012-11-07,PHILADELPHIA_76ERS,NEW_ORLEANS_HORNETS,77,62,59,15
59,2012-11-08,2012-11-07,TORONTO_RAPTORS,DALLAS_MAVERICKS,104,109,60,5
60,2012-11-08,2012-11-07,LOS_ANGELES_LAKERS,UTAH_JAZZ,86,95,61,9
61,2012-11-08,2012-11-07,DETROIT_PISTONS,SACRAMENTO_KINGS,103,105,62,2
62,2012-11-08,2012-11-07,CLEVELAND_CAVALIERS,GOLDEN_STATE_WARRIORS,96,106,63,10
63,2012-11-08,2012-11-07,SAN_ANTONIO_SPURS,LOS_ANGELES_CLIPPERS,84,106,64,22
64,2012-11-09,2012-11-08,OKLAHOMA_CITY_THUNDER,CHICAGO_BULLS,97,91,65,6
65,2012-11-09,2012-11-08,LOS_ANGELES_CLIPPERS,PORTLAND_TRAIL_BLAZERS,103,90,66,13
66,2012-11-10,2012-11-09,BROOKLYN_NETS,ORLANDO_MAGIC,107,68,67,39
67,2012-11-10,2012-11-09,MILWAUKEE_BUCKS,WASHINGTON_WIZARDS,101,91,68,10
68,2012-11-10,2012-11-09,MIAMI_HEAT,ATLANTA_HAWKS,95,89,69,6
69,2012-11-10,2012-11-09,PHILADELPHIA_76ERS,BOSTON_CELTICS,106,100,70,6
70,2012-11-10,2012-11-09,DALLAS_MAVERICKS,NEW_YORK_KNICKS,94,104,71,10
71,2012-11-10,2012-11-09,HOUSTON_ROCKETS,MEMPHIS_GRIZZLIES,85,93,72,8
72,2012-11-10,2012-11-09,INDIANA_PACERS,MINNESOTA_TIMBERWOLVES,94,96,73,2
73,2012-11-10,2012-11-09,CHARLOTTE_BOBCATS,NEW_ORLEANS_HORNETS,99,107,74,8
74,2012-11-10,2012-11-09,DETROIT_PISTONS,OKLAHOMA_CITY_THUNDER,94,105,75,11
75,2012-11-10,2012-11-09,CLEVELAND_CAVALIERS,PHOENIX_SUNS,105,107,76,2
76,2012-11-10,2012-11-09,SAN_ANTONIO_SPURS,SACRAMENTO_KINGS,97,86,77,11
77,2012-11-10,2012-11-09,UTAH_JAZZ,DENVER_NUGGETS,84,104,78,20
78,2012-11-10,2012-11-09,GOLDEN_STATE_WARRIORS,LOS_ANGELES_LAKERS,77,101,79,24
79,2012-11-11,2012-11-10,WASHINGTON_WIZARDS,INDIANA_PACERS,85,89,80,4
80,2012-11-11,2012-11-10,PHILADELPHIA_76ERS,TORONTO_RAPTORS,93,83,81,10
81,2012-11-11,2012-11-10,DALLAS_MAVERICKS,CHARLOTTE_BOBCATS,97,101,82,4
82,2012-11-11,2012-11-10,MINNESOTA_TIMBERWOLVES,CHICAGO_BULLS,80,87,83,7
83,2012-11-11,2012-11-10,DETROIT_PISTONS,HOUSTON_ROCKETS,82,96,84,14
84,2012-11-11,2012-11-10,BOSTON_CELTICS,MILWAUKEE_BUCKS,96,92,85,4
85,2012-11-11,2012-11-10,PHOENIX_SUNS,UTAH_JAZZ,81,94,86,13
86,2012-11-11,2012-11-10,SAN_ANTONIO_SPURS,PORTLAND_TRAIL_BLAZERS,112,109,87,3
87,2012-11-11,2012-11-10,DENVER_NUGGETS,GOLDEN_STATE_WARRIORS,107,101,88,6
88,2012-11-11,2012-11-10,ORLANDO_MAGIC,BROOKLYN_NETS,74,82,89,8
89,2012-11-11,2012-11-10,ATLANTA_HAWKS,LOS_ANGELES_CLIPPERS,76,89,90,13
90,2012-11-11,2012-11-10,MIAMI_HEAT,MEMPHIS_GRIZZLIES,86,104,91,18
91,2012-11-12,2012-11-11,CLEVELAND_CAVALIERS,OKLAHOMA_CITY_THUNDER,91,106,92,15
92,2012-11-12,2012-11-11,SACRAMENTO_KINGS,LOS_ANGELES_LAKERS,90,103,93,13
93,2012-11-13,2012-11-12,MILWAUKEE_BUCKS,PHILADELPHIA_76ERS,105,96,94,9
94,2012-11-13,2012-11-12,UTAH_JAZZ,TORONTO_RAPTORS,140,133,95,7
95,2012-11-13,2012-11-12,OKLAHOMA_CITY_THUNDER,DETROIT_PISTONS,92,90,96,2
96,2012-11-13,2012-11-12,BOSTON_CELTICS,CHICAGO_BULLS,101,95,97,6
97,2012-11-13,2012-11-12,MIAMI_HEAT,HOUSTON_ROCKETS,113,110,98,3
98,2012-11-13,2012-11-12,MINNESOTA_TIMBERWOLVES,DALLAS_MAVERICKS,90,82,99,8
99,2012-11-13,2012-11-12,DENVER_NUGGETS,PHOENIX_SUNS,100,110,100,10
100,2012-11-13,2012-11-12,ATLANTA_HAWKS,PORTLAND_TRAIL_BLAZERS,95,87,101,8
101,2012-11-14,2012-11-13,WASHINGTON_WIZARDS,CHARLOTTE_BOBCATS,76,92,102,16
102,2012-11-14,2012-11-13,TORONTO_RAPTORS,INDIANA_PACERS,74,72,103,2
103,2012-11-14,2012-11-13,NEW_YORK_KNICKS,ORLANDO_MAGIC,99,89,104,10
104,2012-11-14,2012-11-13,CLEVELAND_CAVALIERS,BROOKLYN_NETS,101,114,105,13
105,2012-11-14,2012-11-13,PORTLAND_TRAIL_BLAZERS,SACRAMENTO_KINGS,103,86,106,17
106,2012-11-14,2012-11-13,SAN_ANTONIO_SPURS,LOS_ANGELES_LAKERS,84,82,107,2
107,2012-11-15,2012-11-14,DETROIT_PISTONS,PHILADELPHIA_76ERS,94,76,108,18
108,2012-11-15,2012-11-14,UTAH_JAZZ,BOSTON_CELTICS,93,98,109,5
109,2012-11-15,2012-11-14,NEW_ORLEANS_HORNETS,HOUSTON_ROCKETS,96,100,110,4
110,2012-11-15,2012-11-14,INDIANA_PACERS,MILWAUKEE_BUCKS,85,99,111,14
111,2012-11-15,2012-11-14,CHARLOTTE_BOBCATS,MINNESOTA_TIMBERWOLVES,89,87,112,2
112,2012-11-15,2012-11-14,MEMPHIS_GRIZZLIES,OKLAHOMA_CITY_THUNDER,107,97,113,10
113,2012-11-15,2012-11-14,WASHINGTON_WIZARDS,DALLAS_MAVERICKS,101,107,114,6
114,2012-11-15,2012-11-14,CHICAGO_BULLS,PHOENIX_SUNS,112,106,115,6
115,2012-11-15,2012-11-14,ATLANTA_HAWKS,GOLDEN_STATE_WARRIORS,88,92,116,4
116,2012-11-15,2012-11-14,MIAMI_HEAT,LOS_ANGELES_CLIPPERS,100,107,117,7
117,2012-11-16,2012-11-15,BOSTON_CELTICS,BROOKLYN_NETS,97,102,118,5
118,2012-11-16,2012-11-15,NEW_YORK_KNICKS,SAN_ANTONIO_SPURS,104,100,119,4
119,2012-11-16,2012-11-15,MIAMI_HEAT,DENVER_NUGGETS,98,93,120,5
120,2012-11-17,2012-11-16,DALLAS_MAVERICKS,INDIANA_PACERS,83,103,121,20
121,2012-11-17,2012-11-16,UTAH_JAZZ,PHILADELPHIA_76ERS,93,99,122,6
122,2012-11-17,2012-11-16,ORLANDO_MAGIC,DETROIT_PISTONS,110,106,123,4
123,2012-11-17,2012-11-16,GOLDEN_STATE_WARRIORS,MINNESOTA_TIMBERWOLVES,106,98,124,8
124,2012-11-17,2012-11-16,OKLAHOMA_CITY_THUNDER,NEW_ORLEANS_HORNETS,110,95,125,15
125,2012-11-17,2012-11-16,NEW_YORK_KNICKS,MEMPHIS_GRIZZLIES,95,105,126,10
126,2012-11-17,2012-11-16,HOUSTON_ROCKETS,PORTLAND_TRAIL_BLAZERS,117,119,127,2
127,2012-11-17,2012-11-16,ATLANTA_HAWKS,SACRAMENTO_KINGS,112,96,128,16
128,2012-11-17,2012-11-16,PHOENIX_SUNS,LOS_ANGELES_LAKERS,102,114,129,12
129,2012-11-17,2012-11-16,TORONTO_RAPTORS,BOSTON_CELTICS,89,107,130,18
130,2012-11-18,2012-11-17,UTAH_JAZZ,WASHINGTON_WIZARDS,83,76,131,7
131,2012-11-18,2012-11-17,MEMPHIS_GRIZZLIES,CHARLOTTE_BOBCATS,94,87,132,7
132,2012-11-18,2012-11-17,DALLAS_MAVERICKS,CLEVELAND_CAVALIERS,103,95,133,8
133,2012-11-18,2012-11-17,NEW_ORLEANS_HORNETS,MILWAUKEE_BUCKS,113,117,134,4
134,2012-11-18,2012-11-17,DENVER_NUGGETS,SAN_ANTONIO_SPURS,100,126,135,26
135,2012-11-18,2012-11-17,CHICAGO_BULLS,LOS_ANGELES_CLIPPERS,80,101,136,21
136,2012-11-18,2012-11-17,MIAMI_HEAT,PHOENIX_SUNS,97,88,137,9
137,2012-11-18,2012-11-17,INDIANA_PACERS,NEW_YORK_KNICKS,76,88,138,12
138,2012-11-18,2012-11-17,ORLANDO_MAGIC,TORONTO_RAPTORS,86,97,139,11
139,2012-11-18,2012-11-17,CLEVELAND_CAVALIERS,PHILADELPHIA_76ERS,79,86,140,7
140,2012-11-18,2012-11-17,BROOKLYN_NETS,SACRAMENTO_KINGS,99,90,141,9
141,2012-11-19,2012-11-18,GOLDEN_STATE_WARRIORS,OKLAHOMA_CITY_THUNDER,109,119,142,10
142,2012-11-19,2012-11-18,BOSTON_CELTICS,DETROIT_PISTONS,83,103,143,20
143,2012-11-19,2012-11-18,CHICAGO_BULLS,PORTLAND_TRAIL_BLAZERS,94,102,144,8
144,2012-11-19,2012-11-18,HOUSTON_ROCKETS,LOS_ANGELES_LAKERS,108,119,145,11
145,2012-11-20,2012-11-19,MILWAUKEE_BUCKS,CHARLOTTE_BOBCATS,98,102,146,4
146,2012-11-20,2012-11-19,INDIANA_PACERS,WASHINGTON_WIZARDS,96,89,147,7
147,2012-11-20,2012-11-19,ORLANDO_MAGIC,ATLANTA_HAWKS,72,81,148,9
148,2012-11-20,2012-11-19,DENVER_NUGGETS,MEMPHIS_GRIZZLIES,97,92,149,5
149,2012-11-20,2012-11-19,GOLDEN_STATE_WARRIORS,DALLAS_MAVERICKS,105,101,150,4
150,2012-11-20,2012-11-19,LOS_ANGELES_CLIPPERS,SAN_ANTONIO_SPURS,92,87,151,5
151,2012-11-20,2012-11-19,HOUSTON_ROCKETS,UTAH_JAZZ,91,102,152,11
152,2012-11-21,2012-11-20,TORONTO_RAPTORS,PHILADELPHIA_76ERS,98,106,153,8
153,2012-11-21,2012-11-20,NEW_YORK_KNICKS,NEW_ORLEANS_HORNETS,102,80,154,22
154,2012-11-21,2012-11-20,BROOKLYN_NETS,LOS_ANGELES_LAKERS,90,95,155,5
155,2012-11-22,2012-11-21,TORONTO_RAPTORS,CHARLOTTE_BOBCATS,97,98,156,1
156,2012-11-22,2012-11-21,PHILADELPHIA_76ERS,CLEVELAND_CAVALIERS,83,92,157,9
157,2012-11-22,2012-11-21,NEW_ORLEANS_HORNETS,INDIANA_PACERS,107,115,158,8
158,2012-11-22,2012-11-21,DETROIT_PISTONS,ORLANDO_MAGIC,74,90,159,16
159,2012-11-22,2012-11-21,WASHINGTON_WIZARDS,ATLANTA_HAWKS,100,101,160,1
160,2012-11-22,2012-11-21,SAN_ANTONIO_SPURS,BOSTON_CELTICS,112,100,161,12
161,2012-11-22,2012-11-21,MILWAUKEE_BUCKS,MIAMI_HEAT,106,113,162,7
162,2012-11-22,2012-11-21,LOS_ANGELES_CLIPPERS,OKLAHOMA_CITY_THUNDER,111,117,163,6
163,2012-11-22,2012-11-21,CHICAGO_BULLS,HOUSTON_ROCKETS,89,93,164,4
164,2012-11-22,2012-11-21,DENVER_NUGGETS,MINNESOTA_TIMBERWOLVES,101,94,165,7
165,2012-11-22,2012-11-21,NEW_YORK_KNICKS,DALLAS_MAVERICKS,111,114,166,3
166,2012-11-22,2012-11-21,PORTLAND_TRAIL_BLAZERS,PHOENIX_SUNS,87,114,167,27
167,2012-11-22,2012-11-21,LOS_ANGELES_LAKERS,SACRAMENTO_KINGS,97,113,168,16
168,2012-11-22,2012-11-21,BROOKLYN_NETS,GOLDEN_STATE_WARRIORS,93,102,169,9
169,2012-11-24,2012-11-23,ATLANTA_HAWKS,CHARLOTTE_BOBCATS,101,91,170,10
170,2012-11-24,2012-11-23,CLEVELAND_CAVALIERS,ORLANDO_MAGIC,104,108,171,4
171,2012-11-24,2012-11-23,OKLAHOMA_CITY_THUNDER,BOSTON_CELTICS,100,108,172,8
172,2012-11-24,2012-11-23,LOS_ANGELES_CLIPPERS,BROOKLYN_NETS,76,86,173,10
173,2012-11-24,2012-11-23,TORONTO_RAPTORS,DETROIT_PISTONS,90,91,174,1
174,2012-11-24,2012-11-23,NEW_YORK_KNICKS,HOUSTON_ROCKETS,103,131,175,28
175,2012-11-24,2012-11-23,SAN_ANTONIO_SPURS,INDIANA_PACERS,104,97,176,7
176,2012-11-24,2012-11-23,LOS_ANGELES_LAKERS,MEMPHIS_GRIZZLIES,98,106,177,8
177,2012-11-24,2012-11-23,GOLDEN_STATE_WARRIORS,DENVER_NUGGETS,91,102,178,11
178,2012-11-24,2012-11-23,NEW_ORLEANS_HORNETS,PHOENIX_SUNS,108,111,179,3
179,2012-11-24,2012-11-23,SACRAMENTO_KINGS,UTAH_JAZZ,102,104,180,2
180,2012-11-24,2012-11-23,MINNESOTA_TIMBERWOLVES,PORTLAND_TRAIL_BLAZERS,95,103,181,8
181,2012-11-25,2012-11-24,LOS_ANGELES_CLIPPERS,ATLANTA_HAWKS,93,104,182,11
182,2012-11-25,2012-11-24,OKLAHOMA_CITY_THUNDER,PHILADELPHIA_76ERS,116,109,183,7
183,2012-11-25,2012-11-24,CHARLOTTE_BOBCATS,WASHINGTON_WIZARDS,108,106,184,2
184,2012-11-25,2012-11-24,CLEVELAND_CAVALIERS,MIAMI_HEAT,108,110,185,2
185,2012-11-25,2012-11-24,LOS_ANGELES_LAKERS,DALLAS_MAVERICKS,115,89,186,26
186,2012-11-25,2012-11-24,CHICAGO_BULLS,MILWAUKEE_BUCKS,93,86,187,7
187,2012-11-25,2012-11-24,UTAH_JAZZ,SACRAMENTO_KINGS,97,108,188,11
188,2012-11-25,2012-11-24,MINNESOTA_TIMBERWOLVES,GOLDEN_STATE_WARRIORS,85,96,189,11
189,2012-11-25,2012-11-24,DETROIT_PISTONS,NEW_YORK_KNICKS,100,121,190,21
190,2012-11-25,2012-11-24,SAN_ANTONIO_SPURS,TORONTO_RAPTORS,111,106,191,5
191,2012-11-25,2012-11-24,PORTLAND_TRAIL_BLAZERS,BROOKLYN_NETS,85,98,192,13
192,2012-11-25,2012-11-24,BOSTON_CELTICS,ORLANDO_MAGIC,116,110,193,6
193,2012-11-25,2012-11-24,PHOENIX_SUNS,PHILADELPHIA_76ERS,101,104,194,3
194,2012-11-26,2012-11-25,NEW_ORLEANS_HORNETS,DENVER_NUGGETS,84,102,195,18
195,2012-11-27,2012-11-26,NEW_YORK_KNICKS,BROOKLYN_NETS,89,96,196,7
196,2012-11-27,2012-11-26,SAN_ANTONIO_SPURS,WASHINGTON_WIZARDS,118,92,197,26
197,2012-11-27,2012-11-26,PORTLAND_TRAIL_BLAZERS,DETROIT_PISTONS,101,108,198,7
198,2012-11-27,2012-11-26,MILWAUKEE_BUCKS,CHICAGO_BULLS,93,92,199,1
199,2012-11-27,2012-11-26,CLEVELAND_CAVALIERS,MEMPHIS_GRIZZLIES,78,84,200,6
200,2012-11-27,2012-11-26,CHARLOTTE_BOBCATS,OKLAHOMA_CITY_THUNDER,69,114,201,45
201,2012-11-27,2012-11-26,DENVER_NUGGETS,UTAH_JAZZ,103,105,202,2
202,2012-11-27,2012-11-26,NEW_ORLEANS_HORNETS,LOS_ANGELES_CLIPPERS,105,98,203,7
203,2012-11-28,2012-11-27,PHOENIX_SUNS,CLEVELAND_CAVALIERS,91,78,204,13
204,2012-11-28,2012-11-27,DALLAS_MAVERICKS,PHILADELPHIA_76ERS,98,100,205,2
205,2012-11-28,2012-11-27,TORONTO_RAPTORS,HOUSTON_ROCKETS,101,117,206,16
206,2012-11-28,2012-11-27,MINNESOTA_TIMBERWOLVES,SACRAMENTO_KINGS,97,89,207,8
207,2012-11-28,2012-11-27,INDIANA_PACERS,LOS_ANGELES_LAKERS,79,77,208,2
208,2012-11-29,2012-11-28,SAN_ANTONIO_SPURS,ORLANDO_MAGIC,110,89,209,21
209,2012-11-29,2012-11-28,PORTLAND_TRAIL_BLAZERS,WASHINGTON_WIZARDS,82,84,210,2
210,2012-11-29,2012-11-28,CHARLOTTE_BOBCATS,ATLANTA_HAWKS,91,94,211,3
211,2012-11-29,2012-11-28,BROOKLYN_NETS,BOSTON_CELTICS,95,83,212,12
212,2012-11-29,2012-11-28,PHOENIX_SUNS,DETROIT_PISTONS,77,117,213,40
213,2012-11-29,2012-11-28,DALLAS_MAVERICKS,CHICAGO_BULLS,78,101,214,23
214,2012-11-29,2012-11-28,TORONTO_RAPTORS,MEMPHIS_GRIZZLIES,82,103,215,21
215,2012-11-29,2012-11-28,NEW_YORK_KNICKS,MILWAUKEE_BUCKS,102,88,216,14
216,2012-11-29,2012-11-28,UTAH_JAZZ,NEW_ORLEANS_HORNETS,96,84,217,12
217,2012-11-29,2012-11-28,HOUSTON_ROCKETS,OKLAHOMA_CITY_THUNDER,98,120,218,22
218,2012-11-29,2012-11-28,MINNESOTA_TIMBERWOLVES,LOS_ANGELES_CLIPPERS,95,101,219,6
219,2012-11-30,2012-11-29,SAN_ANTONIO_SPURS,MIAMI_HEAT,100,105,220,5
220,2012-11-30,2012-11-29,DENVER_NUGGETS,GOLDEN_STATE_WARRIORS,105,106,221,1
221,2012-12-01,2012-11-30,PHILADELPHIA_76ERS,CHARLOTTE_BOBCATS,104,98,222,6
222,2012-12-01,2012-11-30,BROOKLYN_NETS,ORLANDO_MAGIC,98,86,223,12
223,2012-12-01,2012-11-30,PHOENIX_SUNS,TORONTO_RAPTORS,97,101,224,4
224,2012-12-01,2012-11-30,CLEVELAND_CAVALIERS,ATLANTA_HAWKS,113,111,225,2
225,2012-12-01,2012-11-30,PORTLAND_TRAIL_BLAZERS,BOSTON_CELTICS,78,96,226,18
226,2012-12-01,2012-11-30,WASHINGTON_WIZARDS,NEW_YORK_KNICKS,87,108,227,21
227,2012-12-01,2012-11-30,DETROIT_PISTONS,MEMPHIS_GRIZZLIES,78,90,228,12
228,2012-12-01,2012-11-30,MILWAUKEE_BUCKS,MINNESOTA_TIMBERWOLVES,85,95,229,10
229,2012-12-01,2012-11-30,UTAH_JAZZ,OKLAHOMA_CITY_THUNDER,94,106,230,12
230,2012-12-01,2012-11-30,INDIANA_PACERS,SACRAMENTO_KINGS,97,92,231,5
231,2012-12-01,2012-11-30,DENVER_NUGGETS,LOS_ANGELES_LAKERS,103,122,232,19
232,2012-12-02,2012-12-01,PORTLAND_TRAIL_BLAZERS,CLEVELAND_CAVALIERS,118,117,233,1
233,2012-12-02,2012-12-01,BROOKLYN_NETS,MIAMI_HEAT,89,102,234,13
234,2012-12-02,2012-12-01,PHILADELPHIA_76ERS,CHICAGO_BULLS,88,93,235,5
235,2012-12-02,2012-12-01,UTAH_JAZZ,HOUSTON_ROCKETS,116,124,236,8
236,2012-12-02,2012-12-01,OKLAHOMA_CITY_THUNDER,NEW_ORLEANS_HORNETS,100,79,237,21
237,2012-12-02,2012-12-01,BOSTON_CELTICS,MILWAUKEE_BUCKS,88,91,238,3
238,2012-12-02,2012-12-01,MEMPHIS_GRIZZLIES,SAN_ANTONIO_SPURS,95,99,239,4
239,2012-12-02,2012-12-01,DETROIT_PISTONS,DALLAS_MAVERICKS,77,92,240,15
240,2012-12-02,2012-12-01,INDIANA_PACERS,GOLDEN_STATE_WARRIORS,92,103,241,11
241,2012-12-02,2012-12-01,SACRAMENTO_KINGS,LOS_ANGELES_CLIPPERS,81,116,242,35
242,2012-12-02,2012-12-01,PHOENIX_SUNS,NEW_YORK_KNICKS,99,106,243,7
243,2012-12-03,2012-12-02,ORLANDO_MAGIC,LOS_ANGELES_LAKERS,113,103,244,10
244,2012-12-04,2012-12-03,PORTLAND_TRAIL_BLAZERS,CHARLOTTE_BOBCATS,118,112,245,6
245,2012-12-04,2012-12-03,CLEVELAND_CAVALIERS,DETROIT_PISTONS,79,89,246,10
246,2012-12-04,2012-12-03,MILWAUKEE_BUCKS,NEW_ORLEANS_HORNETS,81,102,247,21
247,2012-12-04,2012-12-03,TORONTO_RAPTORS,DENVER_NUGGETS,110,113,248,3
248,2012-12-04,2012-12-03,LOS_ANGELES_CLIPPERS,UTAH_JAZZ,105,104,249,1
249,2012-12-04,2012-12-03,ORLANDO_MAGIC,GOLDEN_STATE_WARRIORS,102,94,250,8
250,2012-12-05,2012-12-04,MINNESOTA_TIMBERWOLVES,PHILADELPHIA_76ERS,105,88,251,17
251,2012-12-05,2012-12-04,MIAMI_HEAT,WASHINGTON_WIZARDS,101,105,252,4
252,2012-12-05,2012-12-04,OKLAHOMA_CITY_THUNDER,BROOKLYN_NETS,117,111,253,6
253,2012-12-05,2012-12-04,INDIANA_PACERS,CHICAGO_BULLS,80,76,254,4
254,2012-12-05,2012-12-04,LOS_ANGELES_LAKERS,HOUSTON_ROCKETS,105,107,255,2
255,2012-12-05,2012-12-04,PHOENIX_SUNS,MEMPHIS_GRIZZLIES,98,108,256,10
256,2012-12-06,2012-12-05,NEW_YORK_KNICKS,CHARLOTTE_BOBCATS,100,98,257,2
257,2012-12-06,2012-12-05,PORTLAND_TRAIL_BLAZERS,INDIANA_PACERS,92,99,258,7
258,2012-12-06,2012-12-05,MINNESOTA_TIMBERWOLVES,BOSTON_CELTICS,94,104,259,10
259,2012-12-06,2012-12-05,GOLDEN_STATE_WARRIORS,DETROIT_PISTONS,104,97,260,7
260,2012-12-06,2012-12-05,DENVER_NUGGETS,ATLANTA_HAWKS,104,108,261,4
261,2012-12-06,2012-12-05,CHICAGO_BULLS,CLEVELAND_CAVALIERS,95,85,262,10
262,2012-12-06,2012-12-05,LOS_ANGELES_LAKERS,NEW_ORLEANS_HORNETS,103,87,263,16
263,2012-12-06,2012-12-05,MILWAUKEE_BUCKS,SAN_ANTONIO_SPURS,99,110,264,11
264,2012-12-06,2012-12-05,ORLANDO_MAGIC,UTAH_JAZZ,81,87,265,6
265,2012-12-06,2012-12-05,TORONTO_RAPTORS,SACRAMENTO_KINGS,100,107,266,7
266,2012-12-06,2012-12-05,DALLAS_MAVERICKS,LOS_ANGELES_CLIPPERS,90,112,267,22
267,2012-12-07,2012-12-06,NEW_YORK_KNICKS,MIAMI_HEAT,112,92,268,20
268,2012-12-07,2012-12-06,DALLAS_MAVERICKS,PHOENIX_SUNS,97,94,269,3
269,2012-12-08,2012-12-07,DENVER_NUGGETS,INDIANA_PACERS,92,89,270,3
270,2012-12-08,2012-12-07,BOSTON_CELTICS,PHILADELPHIA_76ERS,94,95,271,1
271,2012-12-08,2012-12-07,WASHINGTON_WIZARDS,ATLANTA_HAWKS,95,104,272,9
272,2012-12-08,2012-12-07,GOLDEN_STATE_WARRIORS,BROOKLYN_NETS,109,102,273,7
273,2012-12-08,2012-12-07,CHICAGO_BULLS,DETROIT_PISTONS,108,104,274,4
274,2012-12-08,2012-12-07,CLEVELAND_CAVALIERS,MINNESOTA_TIMBERWOLVES,73,91,275,18
275,2012-12-08,2012-12-07,MEMPHIS_GRIZZLIES,NEW_ORLEANS_HORNETS,96,89,276,7
276,2012-12-08,2012-12-07,CHARLOTTE_BOBCATS,MILWAUKEE_BUCKS,93,108,277,15
277,2012-12-08,2012-12-07,HOUSTON_ROCKETS,SAN_ANTONIO_SPURS,92,114,278,22
278,2012-12-08,2012-12-07,TORONTO_RAPTORS,UTAH_JAZZ,99,131,279,32
279,2012-12-08,2012-12-07,LOS_ANGELES_LAKERS,OKLAHOMA_CITY_THUNDER,108,114,280,6
280,2012-12-08,2012-12-07,ORLANDO_MAGIC,SACRAMENTO_KINGS,82,91,281,9
281,2012-12-08,2012-12-07,PHOENIX_SUNS,LOS_ANGELES_CLIPPERS,99,117,282,18
282,2012-12-09,2012-12-08,SAN_ANTONIO_SPURS,CHARLOTTE_BOBCATS,132,102,283,30
283,2012-12-09,2012-12-08,GOLDEN_STATE_WARRIORS,WASHINGTON_WIZARDS,101,97,284,4
284,2012-12-09,2012-12-08,PHILADELPHIA_76ERS,BOSTON_CELTICS,79,92,285,13
285,2012-12-09,2012-12-08,DETROIT_PISTONS,CLEVELAND_CAVALIERS,104,97,286,7
286,2012-12-09,2012-12-08,NEW_ORLEANS_HORNETS,MIAMI_HEAT,90,106,287,16
287,2012-12-09,2012-12-08,NEW_YORK_KNICKS,CHICAGO_BULLS,85,93,288,8
288,2012-12-09,2012-12-08,DALLAS_MAVERICKS,HOUSTON_ROCKETS,116,109,289,7
289,2012-12-09,2012-12-08,ATLANTA_HAWKS,MEMPHIS_GRIZZLIES,93,83,290,10
290,2012-12-09,2012-12-08,SACRAMENTO_KINGS,PORTLAND_TRAIL_BLAZERS,99,80,291,19
291,2012-12-09,2012-12-08,TORONTO_RAPTORS,LOS_ANGELES_CLIPPERS,83,102,292,19
292,2012-12-09,2012-12-08,MILWAUKEE_BUCKS,BROOKLYN_NETS,97,88,293,9
293,2012-12-10,2012-12-09,INDIANA_PACERS,OKLAHOMA_CITY_THUNDER,93,104,294,11
294,2012-12-10,2012-12-09,DENVER_NUGGETS,NEW_YORK_KNICKS,106,112,295,6
295,2012-12-10,2012-12-09,ORLANDO_MAGIC,PHOENIX_SUNS,98,90,296,8
296,2012-12-10,2012-12-09,UTAH_JAZZ,LOS_ANGELES_LAKERS,117,110,297,7
297,2012-12-11,2012-12-10,GOLDEN_STATE_WARRIORS,CHARLOTTE_BOBCATS,104,96,298,8
298,2012-12-11,2012-12-10,DETROIT_PISTONS,PHILADELPHIA_76ERS,97,104,299,7
299,2012-12-11,2012-12-10,ATLANTA_HAWKS,MIAMI_HEAT,92,101,300,9
300,2012-12-11,2012-12-10,SAN_ANTONIO_SPURS,HOUSTON_ROCKETS,134,126,301,8
301,2012-12-11,2012-12-10,SACRAMENTO_KINGS,DALLAS_MAVERICKS,96,119,302,23
302,2012-12-11,2012-12-10,TORONTO_RAPTORS,PORTLAND_TRAIL_BLAZERS,74,92,303,18
303,2012-12-12,2012-12-11,NEW_YORK_KNICKS,BROOKLYN_NETS,100,97,304,3
304,2012-12-12,2012-12-11,LOS_ANGELES_LAKERS,CLEVELAND_CAVALIERS,94,100,305,6
305,2012-12-12,2012-12-11,DENVER_NUGGETS,DETROIT_PISTONS,101,94,306,7
306,2012-12-12,2012-12-11,WASHINGTON_WIZARDS,NEW_ORLEANS_HORNETS,77,70,307,7
307,2012-12-12,2012-12-11,LOS_ANGELES_CLIPPERS,CHICAGO_BULLS,94,89,308,5
308,2012-12-13,2012-12-12,CLEVELAND_CAVALIERS,INDIANA_PACERS,81,96,309,15
309,2012-12-13,2012-12-12,ATLANTA_HAWKS,ORLANDO_MAGIC,86,80,310,6
310,2012-12-13,2012-12-12,BROOKLYN_NETS,TORONTO_RAPTORS,94,88,311,6
311,2012-12-13,2012-12-12,LOS_ANGELES_CLIPPERS,CHARLOTTE_BOBCATS,100,94,312,6
312,2012-12-13,2012-12-12,GOLDEN_STATE_WARRIORS,MIAMI_HEAT,97,95,313,2
313,2012-12-13,2012-12-12,CHICAGO_BULLS,PHILADELPHIA_76ERS,96,89,314,7
314,2012-12-13,2012-12-12,DALLAS_MAVERICKS,BOSTON_CELTICS,115,117,315,2
315,2012-12-13,2012-12-12,WASHINGTON_WIZARDS,HOUSTON_ROCKETS,93,99,316,6
316,2012-12-13,2012-12-12,SACRAMENTO_KINGS,MILWAUKEE_BUCKS,85,98,317,13
317,2012-12-13,2012-12-12,DENVER_NUGGETS,MINNESOTA_TIMBERWOLVES,105,108,318,3
318,2012-12-13,2012-12-12,NEW_ORLEANS_HORNETS,OKLAHOMA_CITY_THUNDER,88,92,319,4
319,2012-12-13,2012-12-12,MEMPHIS_GRIZZLIES,PHOENIX_SUNS,80,82,320,2
320,2012-12-13,2012-12-12,SAN_ANTONIO_SPURS,UTAH_JAZZ,96,99,321,3
321,2012-12-14,2012-12-13,CHARLOTTE_BOBCATS,ATLANTA_HAWKS,90,113,322,23
322,2012-12-14,2012-12-13,LOS_ANGELES_LAKERS,NEW_YORK_KNICKS,107,116,323,9
323,2012-12-14,2012-12-13,SAN_ANTONIO_SPURS,PORTLAND_TRAIL_BLAZERS,90,98,324,8
324,2012-12-15,2012-12-14,PHILADELPHIA_76ERS,INDIANA_PACERS,85,95,325,10
325,2012-12-15,2012-12-14,GOLDEN_STATE_WARRIORS,ORLANDO_MAGIC,85,99,326,14
326,2012-12-15,2012-12-14,DALLAS_MAVERICKS,TORONTO_RAPTORS,74,95,327,21
327,2012-12-15,2012-12-14,LOS_ANGELES_LAKERS,WASHINGTON_WIZARDS,102,96,328,6
328,2012-12-15,2012-12-14,DETROIT_PISTONS,BROOKLYN_NETS,105,107,329,2
329,2012-12-15,2012-12-14,MILWAUKEE_BUCKS,CLEVELAND_CAVALIERS,90,86,330,4
330,2012-12-15,2012-12-14,BOSTON_CELTICS,HOUSTON_ROCKETS,89,101,331,12
331,2012-12-15,2012-12-14,MINNESOTA_TIMBERWOLVES,NEW_ORLEANS_HORNETS,113,102,332,11
332,2012-12-15,2012-12-14,SACRAMENTO_KINGS,OKLAHOMA_CITY_THUNDER,103,113,333,10
333,2012-12-15,2012-12-14,UTAH_JAZZ,PHOENIX_SUNS,84,99,334,15
334,2012-12-15,2012-12-14,MEMPHIS_GRIZZLIES,DENVER_NUGGETS,94,99,335,5
335,2012-12-16,2012-12-15,GOLDEN_STATE_WARRIORS,ATLANTA_HAWKS,115,93,336,22
336,2012-12-16,2012-12-15,ORLANDO_MAGIC,CHARLOTTE_BOBCATS,107,98,337,9
337,2012-12-16,2012-12-15,INDIANA_PACERS,DETROIT_PISTONS,88,77,338,11
338,2012-12-16,2012-12-15,WASHINGTON_WIZARDS,MIAMI_HEAT,72,102,339,30
339,2012-12-16,2012-12-15,CLEVELAND_CAVALIERS,NEW_YORK_KNICKS,102,103,340,1
340,2012-12-16,2012-12-15,BROOKLYN_NETS,CHICAGO_BULLS,82,83,341,1
341,2012-12-16,2012-12-15,DALLAS_MAVERICKS,MINNESOTA_TIMBERWOLVES,106,114,342,8
342,2012-12-16,2012-12-15,LOS_ANGELES_CLIPPERS,MILWAUKEE_BUCKS,111,85,343,26
343,2012-12-16,2012-12-15,BOSTON_CELTICS,SAN_ANTONIO_SPURS,88,103,344,15
344,2012-12-16,2012-12-15,MEMPHIS_GRIZZLIES,UTAH_JAZZ,99,86,345,13
345,2012-12-16,2012-12-15,HOUSTON_ROCKETS,TORONTO_RAPTORS,96,103,346,7
346,2012-12-16,2012-12-15,LOS_ANGELES_LAKERS,PHILADELPHIA_76ERS,111,98,347,13
347,2012-12-16,2012-12-15,DENVER_NUGGETS,SACRAMENTO_KINGS,122,97,348,25
348,2012-12-17,2012-12-16,NEW_ORLEANS_HORNETS,PORTLAND_TRAIL_BLAZERS,94,95,349,1
349,2012-12-18,2012-12-17,MINNESOTA_TIMBERWOLVES,ORLANDO_MAGIC,93,102,350,9
350,2012-12-18,2012-12-17,LOS_ANGELES_CLIPPERS,DETROIT_PISTONS,88,76,351,12
351,2012-12-18,2012-12-17,HOUSTON_ROCKETS,NEW_YORK_KNICKS,109,96,352,13
352,2012-12-18,2012-12-17,CHICAGO_BULLS,MEMPHIS_GRIZZLIES,71,80,353,9
353,2012-12-18,2012-12-17,SAN_ANTONIO_SPURS,OKLAHOMA_CITY_THUNDER,93,107,354,14
354,2012-12-18,2012-12-17,SACRAMENTO_KINGS,PHOENIX_SUNS,90,101,355,11
355,2012-12-19,2012-12-18,TORONTO_RAPTORS,CLEVELAND_CAVALIERS,113,99,356,14
356,2012-12-19,2012-12-18,ATLANTA_HAWKS,WASHINGTON_WIZARDS,100,95,357,5
357,2012-12-19,2012-12-18,UTAH_JAZZ,BROOKLYN_NETS,92,90,358,2
358,2012-12-19,2012-12-18,MINNESOTA_TIMBERWOLVES,MIAMI_HEAT,92,103,359,11
359,2012-12-19,2012-12-18,BOSTON_CELTICS,CHICAGO_BULLS,89,100,360,11
360,2012-12-19,2012-12-18,INDIANA_PACERS,MILWAUKEE_BUCKS,93,98,361,5
361,2012-12-19,2012-12-18,PHILADELPHIA_76ERS,DALLAS_MAVERICKS,100,107,362,7
362,2012-12-19,2012-12-18,SAN_ANTONIO_SPURS,DENVER_NUGGETS,106,112,363,6
363,2012-12-19,2012-12-18,NEW_ORLEANS_HORNETS,GOLDEN_STATE_WARRIORS,96,103,364,7
364,2012-12-19,2012-12-18,CHARLOTTE_BOBCATS,LOS_ANGELES_LAKERS,100,101,365,1
365,2012-12-20,2012-12-19,UTAH_JAZZ,INDIANA_PACERS,84,104,366,20
366,2012-12-20,2012-12-19,BROOKLYN_NETS,NEW_YORK_KNICKS,86,100,367,14
367,2012-12-20,2012-12-19,WASHINGTON_WIZARDS,ORLANDO_MAGIC,83,90,368,7
368,2012-12-20,2012-12-19,DETROIT_PISTONS,TORONTO_RAPTORS,91,97,369,6
369,2012-12-20,2012-12-19,OKLAHOMA_CITY_THUNDER,ATLANTA_HAWKS,100,92,370,8
370,2012-12-20,2012-12-19,CLEVELAND_CAVALIERS,BOSTON_CELTICS,91,103,371,12
371,2012-12-20,2012-12-19,PHILADELPHIA_76ERS,HOUSTON_ROCKETS,103,125,372,22
372,2012-12-20,2012-12-19,CHARLOTTE_BOBCATS,PHOENIX_SUNS,104,121,373,17
373,2012-12-20,2012-12-19,MILWAUKEE_BUCKS,MEMPHIS_GRIZZLIES,80,90,374,10
374,2012-12-20,2012-12-19,GOLDEN_STATE_WARRIORS,SACRAMENTO_KINGS,127,131,375,4
375,2012-12-20,2012-12-19,NEW_ORLEANS_HORNETS,LOS_ANGELES_CLIPPERS,77,93,376,16
376,2012-12-21,2012-12-20,OKLAHOMA_CITY_THUNDER,MINNESOTA_TIMBERWOLVES,93,99,377,6
377,2012-12-21,2012-12-20,MIAMI_HEAT,DALLAS_MAVERICKS,110,95,378,15
378,2012-12-21,2012-12-20,DENVER_NUGGETS,PORTLAND_TRAIL_BLAZERS,93,101,379,8
379,2012-12-22,2012-12-21,ATLANTA_HAWKS,PHILADELPHIA_76ERS,80,99,380,19
380,2012-12-22,2012-12-21,ORLANDO_MAGIC,TORONTO_RAPTORS,90,93,381,3
381,2012-12-22,2012-12-21,MILWAUKEE_BUCKS,BOSTON_CELTICS,99,94,382,5
382,2012-12-22,2012-12-21,INDIANA_PACERS,CLEVELAND_CAVALIERS,99,89,383,10
383,2012-12-22,2012-12-21,WASHINGTON_WIZARDS,DETROIT_PISTONS,68,100,384,32
384,2012-12-22,2012-12-21,CHICAGO_BULLS,NEW_YORK_KNICKS,110,106,385,4
385,2012-12-22,2012-12-21,DALLAS_MAVERICKS,MEMPHIS_GRIZZLIES,82,92,386,10
386,2012-12-22,2012-12-21,NEW_ORLEANS_HORNETS,SAN_ANTONIO_SPURS,94,99,387,5
387,2012-12-22,2012-12-21,CHARLOTTE_BOBCATS,GOLDEN_STATE_WARRIORS,100,115,388,15
388,2012-12-22,2012-12-21,SACRAMENTO_KINGS,LOS_ANGELES_CLIPPERS,85,97,389,12
389,2012-12-23,2012-12-22,CHICAGO_BULLS,ATLANTA_HAWKS,75,92,390,17
390,2012-12-23,2012-12-22,DETROIT_PISTONS,WASHINGTON_WIZARDS,96,87,391,9
391,2012-12-23,2012-12-22,UTAH_JAZZ,MIAMI_HEAT,89,105,392,16
392,2012-12-23,2012-12-22,MEMPHIS_GRIZZLIES,HOUSTON_ROCKETS,96,121,393,25
393,2012-12-23,2012-12-22,INDIANA_PACERS,NEW_ORLEANS_HORNETS,81,75,394,6
394,2012-12-23,2012-12-22,CLEVELAND_CAVALIERS,MILWAUKEE_BUCKS,94,82,395,12
395,2012-12-23,2012-12-22,CHARLOTTE_BOBCATS,DENVER_NUGGETS,88,110,396,22
396,2012-12-23,2012-12-22,PHOENIX_SUNS,PORTLAND_TRAIL_BLAZERS,93,96,397,3
397,2012-12-23,2012-12-22,LOS_ANGELES_LAKERS,GOLDEN_STATE_WARRIORS,118,115,398,3
398,2012-12-23,2012-12-22,PHILADELPHIA_76ERS,BROOKLYN_NETS,92,95,399,3
399,2012-12-23,2012-12-22,MINNESOTA_TIMBERWOLVES,NEW_YORK_KNICKS,91,94,400,3
400,2012-12-23,2012-12-22,UTAH_JAZZ,ORLANDO_MAGIC,97,93,401,4
401,2012-12-24,2012-12-23,DALLAS_MAVERICKS,SAN_ANTONIO_SPURS,91,129,402,38
402,2012-12-24,2012-12-23,LOS_ANGELES_CLIPPERS,PHOENIX_SUNS,103,77,403,26
403,2012-12-24,2012-12-23,PORTLAND_TRAIL_BLAZERS,SACRAMENTO_KINGS,96,108,404,12
404,2012-12-25,2012-12-24,BOSTON_CELTICS,BROOKLYN_NETS,93,76,405,17
405,2012-12-25,2012-12-24,NEW_YORK_KNICKS,LOS_ANGELES_LAKERS,94,100,406,6
406,2012-12-25,2012-12-24,OKLAHOMA_CITY_THUNDER,MIAMI_HEAT,97,103,407,6
407,2012-12-26,2012-12-25,HOUSTON_ROCKETS,CHICAGO_BULLS,120,97,408,23
408,2012-12-26,2012-12-25,DENVER_NUGGETS,LOS_ANGELES_CLIPPERS,100,112,409,12
409,2012-12-27,2012-12-26,MIAMI_HEAT,CHARLOTTE_BOBCATS,105,92,410,13
410,2012-12-27,2012-12-26,NEW_ORLEANS_HORNETS,ORLANDO_MAGIC,97,94,411,3
411,2012-12-27,2012-12-26,CLEVELAND_CAVALIERS,WASHINGTON_WIZARDS,87,84,412,3
412,2012-12-27,2012-12-26,DETROIT_PISTONS,ATLANTA_HAWKS,119,126,413,7
413,2012-12-27,2012-12-26,PHILADELPHIA_76ERS,MEMPHIS_GRIZZLIES,99,89,414,10
414,2012-12-27,2012-12-26,BROOKLYN_NETS,MILWAUKEE_BUCKS,93,108,415,15
415,2012-12-27,2012-12-26,HOUSTON_ROCKETS,MINNESOTA_TIMBERWOLVES,87,84,416,3
416,2012-12-27,2012-12-26,TORONTO_RAPTORS,SAN_ANTONIO_SPURS,80,100,417,20
417,2012-12-27,2012-12-26,LOS_ANGELES_LAKERS,DENVER_NUGGETS,114,126,418,12
418,2012-12-27,2012-12-26,NEW_YORK_KNICKS,PHOENIX_SUNS,99,97,419,2
419,2012-12-27,2012-12-26,GOLDEN_STATE_WARRIORS,UTAH_JAZZ,94,83,420,11
420,2012-12-27,2012-12-26,SACRAMENTO_KINGS,PORTLAND_TRAIL_BLAZERS,91,109,421,18
421,2012-12-28,2012-12-27,DALLAS_MAVERICKS,OKLAHOMA_CITY_THUNDER,105,111,422,6
422,2012-12-28,2012-12-27,BOSTON_CELTICS,LOS_ANGELES_CLIPPERS,77,106,423,29
423,2012-12-29,2012-12-28,PHOENIX_SUNS,INDIANA_PACERS,91,97,424,6
424,2012-12-29,2012-12-28,ORLANDO_MAGIC,WASHINGTON_WIZARDS,97,105,425,8
425,2012-12-29,2012-12-28,CHARLOTTE_BOBCATS,BROOKLYN_NETS,81,97,426,16
426,2012-12-29,2012-12-28,ATLANTA_HAWKS,CLEVELAND_CAVALIERS,102,94,427,8
427,2012-12-29,2012-12-28,MIAMI_HEAT,DETROIT_PISTONS,99,109,428,10
428,2012-12-29,2012-12-28,TORONTO_RAPTORS,NEW_ORLEANS_HORNETS,104,97,429,7
429,2012-12-29,2012-12-28,DENVER_NUGGETS,DALLAS_MAVERICKS,106,85,430,21
430,2012-12-29,2012-12-28,HOUSTON_ROCKETS,SAN_ANTONIO_SPURS,116,122,431,6
431,2012-12-29,2012-12-28,LOS_ANGELES_CLIPPERS,UTAH_JAZZ,116,114,432,2
432,2012-12-29,2012-12-28,NEW_YORK_KNICKS,SACRAMENTO_KINGS,105,106,433,1
433,2012-12-29,2012-12-28,PHILADELPHIA_76ERS,GOLDEN_STATE_WARRIORS,89,96,434,7
434,2012-12-29,2012-12-28,PORTLAND_TRAIL_BLAZERS,LOS_ANGELES_LAKERS,87,104,435,17
435,2012-12-30,2012-12-29,INDIANA_PACERS,ATLANTA_HAWKS,100,109,436,9
436,2012-12-30,2012-12-29,NEW_ORLEANS_HORNETS,CHARLOTTE_BOBCATS,98,95,437,3
437,2012-12-30,2012-12-29,TORONTO_RAPTORS,ORLANDO_MAGIC,123,88,438,35
438,2012-12-30,2012-12-29,CLEVELAND_CAVALIERS,BROOKLYN_NETS,100,103,439,3
439,2012-12-30,2012-12-29,WASHINGTON_WIZARDS,CHICAGO_BULLS,77,87,440,10
440,2012-12-30,2012-12-29,OKLAHOMA_CITY_THUNDER,HOUSTON_ROCKETS,124,94,441,30
441,2012-12-30,2012-12-29,DENVER_NUGGETS,MEMPHIS_GRIZZLIES,72,81,442,9
442,2012-12-30,2012-12-29,PHOENIX_SUNS,MINNESOTA_TIMBERWOLVES,107,111,443,4
443,2012-12-30,2012-12-29,MIAMI_HEAT,MILWAUKEE_BUCKS,85,104,444,19
444,2012-12-30,2012-12-29,PHILADELPHIA_76ERS,PORTLAND_TRAIL_BLAZERS,85,89,445,4
445,2012-12-30,2012-12-29,BOSTON_CELTICS,GOLDEN_STATE_WARRIORS,83,101,446,18
446,2012-12-31,2012-12-30,SAN_ANTONIO_SPURS,DALLAS_MAVERICKS,111,86,447,25
447,2012-12-31,2012-12-30,MILWAUKEE_BUCKS,DETROIT_PISTONS,94,96,448,2
448,2012-12-31,2012-12-30,BOSTON_CELTICS,SACRAMENTO_KINGS,96,118,449,22
449,2012-12-31,2012-12-30,UTAH_JAZZ,LOS_ANGELES_CLIPPERS,96,107,450,11
450,2012-12-31,2012-12-30,CHARLOTTE_BOBCATS,CHICAGO_BULLS,91,81,451,10
451,2012-12-31,2012-12-30,MEMPHIS_GRIZZLIES,INDIANA_PACERS,83,88,452,5
452,2012-12-31,2012-12-30,MIAMI_HEAT,ORLANDO_MAGIC,112,110,453,2
453,2013-01-01,2012-12-31,ATLANTA_HAWKS,HOUSTON_ROCKETS,104,123,454,19
454,2013-01-01,2012-12-31,BROOKLYN_NETS,SAN_ANTONIO_SPURS,73,104,455,31
455,2013-01-01,2012-12-31,PHOENIX_SUNS,OKLAHOMA_CITY_THUNDER,96,114,456,18
456,2013-01-01,2012-12-31,DALLAS_MAVERICKS,WASHINGTON_WIZARDS,103,94,457,9
457,2013-01-02,2013-01-01,SACRAMENTO_KINGS,DETROIT_PISTONS,97,103,458,6
458,2013-01-02,2013-01-01,PORTLAND_TRAIL_BLAZERS,NEW_YORK_KNICKS,105,100,459,5
459,2013-01-02,2013-01-01,ATLANTA_HAWKS,NEW_ORLEANS_HORNETS,95,86,460,9
460,2013-01-02,2013-01-01,LOS_ANGELES_CLIPPERS,DENVER_NUGGETS,78,92,461,14
461,2013-01-02,2013-01-01,PHILADELPHIA_76ERS,LOS_ANGELES_LAKERS,103,99,462,4
462,2013-01-03,2013-01-02,SACRAMENTO_KINGS,CLEVELAND_CAVALIERS,97,94,463,3
463,2013-01-03,2013-01-02,WASHINGTON_WIZARDS,INDIANA_PACERS,81,89,464,8
464,2013-01-03,2013-01-02,CHICAGO_BULLS,ORLANDO_MAGIC,96,94,465,2
465,2013-01-03,2013-01-02,PORTLAND_TRAIL_BLAZERS,TORONTO_RAPTORS,79,102,466,23
466,2013-01-03,2013-01-02,MEMPHIS_GRIZZLIES,BOSTON_CELTICS,93,83,467,10
467,2013-01-03,2013-01-02,DALLAS_MAVERICKS,MIAMI_HEAT,109,119,468,10
468,2013-01-03,2013-01-02,NEW_ORLEANS_HORNETS,HOUSTON_ROCKETS,92,104,469,12
469,2013-01-03,2013-01-02,SAN_ANTONIO_SPURS,MILWAUKEE_BUCKS,117,110,470,7
470,2013-01-03,2013-01-02,BROOKLYN_NETS,OKLAHOMA_CITY_THUNDER,110,93,471,17
471,2013-01-03,2013-01-02,PHILADELPHIA_76ERS,PHOENIX_SUNS,89,95,472,6
472,2013-01-03,2013-01-02,MINNESOTA_TIMBERWOLVES,UTAH_JAZZ,84,106,473,22
473,2013-01-03,2013-01-02,LOS_ANGELES_CLIPPERS,GOLDEN_STATE_WARRIORS,94,115,474,21
474,2013-01-04,2013-01-03,SAN_ANTONIO_SPURS,NEW_YORK_KNICKS,83,100,475,17
475,2013-01-04,2013-01-03,MINNESOTA_TIMBERWOLVES,DENVER_NUGGETS,101,97,476,4
476,2013-01-05,2013-01-04,CLEVELAND_CAVALIERS,CHARLOTTE_BOBCATS,106,104,477,2
477,2013-01-05,2013-01-04,SACRAMENTO_KINGS,TORONTO_RAPTORS,105,96,478,9
478,2013-01-05,2013-01-04,BROOKLYN_NETS,WASHINGTON_WIZARDS,115,113,479,2
479,2013-01-05,2013-01-04,ATLANTA_HAWKS,DETROIT_PISTONS,84,85,480,1
480,2013-01-05,2013-01-04,INDIANA_PACERS,BOSTON_CELTICS,75,94,481,19
481,2013-01-05,2013-01-04,PORTLAND_TRAIL_BLAZERS,MEMPHIS_GRIZZLIES,86,84,482,2
482,2013-01-05,2013-01-04,CHICAGO_BULLS,MIAMI_HEAT,96,89,483,7
483,2013-01-05,2013-01-04,PHILADELPHIA_76ERS,OKLAHOMA_CITY_THUNDER,85,109,484,24
484,2013-01-05,2013-01-04,HOUSTON_ROCKETS,MILWAUKEE_BUCKS,115,101,485,14
485,2013-01-05,2013-01-04,UTAH_JAZZ,PHOENIX_SUNS,87,80,486,7
486,2013-01-05,2013-01-04,LOS_ANGELES_LAKERS,LOS_ANGELES_CLIPPERS,102,107,487,5
487,2013-01-06,2013-01-05,BOSTON_CELTICS,ATLANTA_HAWKS,89,81,488,8
488,2013-01-06,2013-01-05,MILWAUKEE_BUCKS,INDIANA_PACERS,80,95,489,15
489,2013-01-06,2013-01-05,NEW_YORK_KNICKS,ORLANDO_MAGIC,114,106,490,8
490,2013-01-06,2013-01-05,SACRAMENTO_KINGS,BROOKLYN_NETS,93,113,491,20
491,2013-01-06,2013-01-05,HOUSTON_ROCKETS,CLEVELAND_CAVALIERS,112,104,492,8
492,2013-01-06,2013-01-05,PORTLAND_TRAIL_BLAZERS,MINNESOTA_TIMBERWOLVES,102,97,493,5
493,2013-01-06,2013-01-05,NEW_ORLEANS_HORNETS,DALLAS_MAVERICKS,99,96,494,3
494,2013-01-06,2013-01-05,PHILADELPHIA_76ERS,SAN_ANTONIO_SPURS,86,109,495,23
495,2013-01-06,2013-01-05,UTAH_JAZZ,DENVER_NUGGETS,91,110,496,19
496,2013-01-06,2013-01-05,GOLDEN_STATE_WARRIORS,LOS_ANGELES_CLIPPERS,89,115,497,26
497,2013-01-06,2013-01-05,OKLAHOMA_CITY_THUNDER,TORONTO_RAPTORS,104,92,498,12
498,2013-01-06,2013-01-05,WASHINGTON_WIZARDS,MIAMI_HEAT,71,99,499,28
499,2013-01-07,2013-01-06,CHARLOTTE_BOBCATS,DETROIT_PISTONS,108,101,500,7
500,2013-01-07,2013-01-06,MEMPHIS_GRIZZLIES,PHOENIX_SUNS,92,81,501,11
501,2013-01-07,2013-01-06,DENVER_NUGGETS,LOS_ANGELES_LAKERS,112,105,502,7
502,2013-01-08,2013-01-07,OKLAHOMA_CITY_THUNDER,WASHINGTON_WIZARDS,99,101,503,2
503,2013-01-08,2013-01-07,BOSTON_CELTICS,NEW_YORK_KNICKS,102,96,504,6
504,2013-01-08,2013-01-07,CLEVELAND_CAVALIERS,CHICAGO_BULLS,92,118,505,26
505,2013-01-08,2013-01-07,SAN_ANTONIO_SPURS,NEW_ORLEANS_HORNETS,88,95,506,7
506,2013-01-08,2013-01-07,DALLAS_MAVERICKS,UTAH_JAZZ,94,100,507,6
507,2013-01-08,2013-01-07,ORLANDO_MAGIC,PORTLAND_TRAIL_BLAZERS,119,125,508,6
508,2013-01-08,2013-01-07,MEMPHIS_GRIZZLIES,SACRAMENTO_KINGS,113,81,509,32
509,2013-01-09,2013-01-08,MIAMI_HEAT,INDIANA_PACERS,77,87,510,10
510,2013-01-09,2013-01-08,BROOKLYN_NETS,PHILADELPHIA_76ERS,109,89,511,20
511,2013-01-09,2013-01-08,LOS_ANGELES_LAKERS,HOUSTON_ROCKETS,112,125,512,13
512,2013-01-09,2013-01-08,PHOENIX_SUNS,MILWAUKEE_BUCKS,99,108,513,9
513,2013-01-09,2013-01-08,ATLANTA_HAWKS,MINNESOTA_TIMBERWOLVES,103,108,514,5
514,2013-01-10,2013-01-09,UTAH_JAZZ,CHARLOTTE_BOBCATS,112,102,515,10
515,2013-01-10,2013-01-09,ATLANTA_HAWKS,CLEVELAND_CAVALIERS,83,99,516,16
516,2013-01-10,2013-01-09,PHILADELPHIA_76ERS,TORONTO_RAPTORS,72,90,517,18
517,2013-01-10,2013-01-09,PHOENIX_SUNS,BOSTON_CELTICS,79,87,518,8
518,2013-01-10,2013-01-09,MILWAUKEE_BUCKS,CHICAGO_BULLS,104,96,519,8
519,2013-01-10,2013-01-09,HOUSTON_ROCKETS,NEW_ORLEANS_HORNETS,79,88,520,9
520,2013-01-10,2013-01-09,MINNESOTA_TIMBERWOLVES,OKLAHOMA_CITY_THUNDER,84,106,521,22
521,2013-01-10,2013-01-09,LOS_ANGELES_LAKERS,SAN_ANTONIO_SPURS,105,108,522,3
522,2013-01-10,2013-01-09,ORLANDO_MAGIC,DENVER_NUGGETS,105,108,523,3
523,2013-01-10,2013-01-09,MEMPHIS_GRIZZLIES,GOLDEN_STATE_WARRIORS,94,87,524,7
524,2013-01-10,2013-01-09,DALLAS_MAVERICKS,LOS_ANGELES_CLIPPERS,93,99,525,6
525,2013-01-11,2013-01-10,NEW_YORK_KNICKS,INDIANA_PACERS,76,81,526,5
526,2013-01-11,2013-01-10,DALLAS_MAVERICKS,SACRAMENTO_KINGS,117,112,527,5
527,2013-01-11,2013-01-10,MIAMI_HEAT,PORTLAND_TRAIL_BLAZERS,90,92,528,2
528,2013-01-12,2013-01-11,CHARLOTTE_BOBCATS,TORONTO_RAPTORS,78,99,529,21
529,2013-01-12,2013-01-11,UTAH_JAZZ,ATLANTA_HAWKS,95,103,530,8
530,2013-01-12,2013-01-11,HOUSTON_ROCKETS,BOSTON_CELTICS,91,103,531,12
531,2013-01-12,2013-01-11,PHOENIX_SUNS,BROOKLYN_NETS,79,99,532,20
532,2013-01-12,2013-01-11,SAN_ANTONIO_SPURS,MEMPHIS_GRIZZLIES,98,101,533,3
533,2013-01-12,2013-01-11,MINNESOTA_TIMBERWOLVES,NEW_ORLEANS_HORNETS,92,104,534,12
534,2013-01-12,2013-01-11,CHICAGO_BULLS,NEW_YORK_KNICKS,108,101,535,7
535,2013-01-12,2013-01-11,DETROIT_PISTONS,MILWAUKEE_BUCKS,103,87,536,16
536,2013-01-12,2013-01-11,CLEVELAND_CAVALIERS,DENVER_NUGGETS,91,98,537,7
537,2013-01-12,2013-01-11,PORTLAND_TRAIL_BLAZERS,GOLDEN_STATE_WARRIORS,97,103,538,6
538,2013-01-12,2013-01-11,OKLAHOMA_CITY_THUNDER,LOS_ANGELES_LAKERS,116,101,539,15
539,2013-01-12,2013-01-11,ORLANDO_MAGIC,LOS_ANGELES_CLIPPERS,104,101,540,3
540,2013-01-13,2013-01-12,CHARLOTTE_BOBCATS,INDIANA_PACERS,88,96,541,8
541,2013-01-13,2013-01-12,ATLANTA_HAWKS,WASHINGTON_WIZARDS,83,93,542,10
542,2013-01-13,2013-01-12,UTAH_JAZZ,DETROIT_PISTONS,90,87,543,3
543,2013-01-13,2013-01-12,HOUSTON_ROCKETS,PHILADELPHIA_76ERS,100,107,544,7
544,2013-01-13,2013-01-12,PHOENIX_SUNS,CHICAGO_BULLS,97,81,545,16
545,2013-01-13,2013-01-12,MEMPHIS_GRIZZLIES,DALLAS_MAVERICKS,83,104,546,21
546,2013-01-13,2013-01-12,MIAMI_HEAT,SACRAMENTO_KINGS,128,99,547,29
547,2013-01-13,2013-01-12,NEW_ORLEANS_HORNETS,NEW_YORK_KNICKS,87,100,548,13
548,2013-01-13,2013-01-12,MILWAUKEE_BUCKS,TORONTO_RAPTORS,107,96,549,11
549,2013-01-13,2013-01-12,INDIANA_PACERS,BROOKLYN_NETS,86,97,550,11
550,2013-01-14,2013-01-13,MINNESOTA_TIMBERWOLVES,SAN_ANTONIO_SPURS,88,106,551,18
551,2013-01-14,2013-01-13,GOLDEN_STATE_WARRIORS,DENVER_NUGGETS,105,116,552,11
552,2013-01-14,2013-01-13,OKLAHOMA_CITY_THUNDER,PORTLAND_TRAIL_BLAZERS,87,83,553,4
553,2013-01-14,2013-01-13,CLEVELAND_CAVALIERS,LOS_ANGELES_LAKERS,93,113,554,20
554,2013-01-15,2013-01-14,ORLANDO_MAGIC,WASHINGTON_WIZARDS,91,120,555,29
555,2013-01-15,2013-01-14,CHARLOTTE_BOBCATS,BOSTON_CELTICS,89,100,556,11
556,2013-01-15,2013-01-14,ATLANTA_HAWKS,CHICAGO_BULLS,58,97,557,39
557,2013-01-15,2013-01-14,LOS_ANGELES_CLIPPERS,MEMPHIS_GRIZZLIES,99,73,558,26
558,2013-01-15,2013-01-14,MINNESOTA_TIMBERWOLVES,DALLAS_MAVERICKS,98,113,559,15
559,2013-01-15,2013-01-14,OKLAHOMA_CITY_THUNDER,PHOENIX_SUNS,102,90,560,12
560,2013-01-15,2013-01-14,MIAMI_HEAT,UTAH_JAZZ,97,104,561,7
561,2013-01-15,2013-01-14,CLEVELAND_CAVALIERS,SACRAMENTO_KINGS,118,124,562,6
562,2013-01-16,2013-01-15,INDIANA_PACERS,CHARLOTTE_BOBCATS,103,76,563,27
563,2013-01-16,2013-01-15,NEW_ORLEANS_HORNETS,PHILADELPHIA_76ERS,111,99,564,12
564,2013-01-16,2013-01-15,TORONTO_RAPTORS,BROOKLYN_NETS,106,113,565,7
565,2013-01-16,2013-01-15,LOS_ANGELES_CLIPPERS,HOUSTON_ROCKETS,117,109,566,8
566,2013-01-16,2013-01-15,PORTLAND_TRAIL_BLAZERS,DENVER_NUGGETS,111,115,567,4
567,2013-01-16,2013-01-15,MILWAUKEE_BUCKS,LOS_ANGELES_LAKERS,88,104,568,16
568,2013-01-17,2013-01-16,INDIANA_PACERS,ORLANDO_MAGIC,86,97,569,11
569,2013-01-17,2013-01-16,CHICAGO_BULLS,TORONTO_RAPTORS,107,105,570,2
570,2013-01-17,2013-01-16,BROOKLYN_NETS,ATLANTA_HAWKS,95,109,571,14
571,2013-01-17,2013-01-16,NEW_ORLEANS_HORNETS,BOSTON_CELTICS,90,78,572,12
572,2013-01-17,2013-01-16,HOUSTON_ROCKETS,DALLAS_MAVERICKS,100,105,573,5
573,2013-01-17,2013-01-16,DENVER_NUGGETS,OKLAHOMA_CITY_THUNDER,97,117,574,20
574,2013-01-17,2013-01-16,MEMPHIS_GRIZZLIES,SAN_ANTONIO_SPURS,82,103,575,21
575,2013-01-17,2013-01-16,CLEVELAND_CAVALIERS,PORTLAND_TRAIL_BLAZERS,93,88,576,5
576,2013-01-17,2013-01-16,WASHINGTON_WIZARDS,SACRAMENTO_KINGS,94,95,577,1
577,2013-01-17,2013-01-16,MIAMI_HEAT,GOLDEN_STATE_WARRIORS,92,75,578,17
578,2013-01-17,2013-01-16,NEW_YORK_KNICKS,DETROIT_PISTONS,102,87,579,15
579,2013-01-18,2013-01-17,LOS_ANGELES_CLIPPERS,MINNESOTA_TIMBERWOLVES,90,77,580,13
580,2013-01-18,2013-01-17,MILWAUKEE_BUCKS,PHOENIX_SUNS,98,94,581,4
581,2013-01-18,2013-01-17,MIAMI_HEAT,LOS_ANGELES_LAKERS,99,90,582,9
582,2013-01-19,2013-01-18,CHICAGO_BULLS,BOSTON_CELTICS,100,99,583,1
583,2013-01-19,2013-01-18,HOUSTON_ROCKETS,INDIANA_PACERS,95,105,584,10
584,2013-01-19,2013-01-18,CHARLOTTE_BOBCATS,ORLANDO_MAGIC,106,100,585,6
585,2013-01-19,2013-01-18,TORONTO_RAPTORS,PHILADELPHIA_76ERS,101,108,586,7
586,2013-01-19,2013-01-18,ATLANTA_HAWKS,BROOKLYN_NETS,89,94,587,5
587,2013-01-19,2013-01-18,SACRAMENTO_KINGS,MEMPHIS_GRIZZLIES,69,85,588,16
588,2013-01-19,2013-01-18,GOLDEN_STATE_WARRIORS,SAN_ANTONIO_SPURS,88,95,589,7
589,2013-01-19,2013-01-18,WASHINGTON_WIZARDS,DENVER_NUGGETS,112,108,590,4
590,2013-01-19,2013-01-18,OKLAHOMA_CITY_THUNDER,DALLAS_MAVERICKS,117,114,591,3
591,2013-01-20,2013-01-19,SAN_ANTONIO_SPURS,ATLANTA_HAWKS,98,93,592,5
592,2013-01-20,2013-01-19,SACRAMENTO_KINGS,CHARLOTTE_BOBCATS,97,93,593,4
593,2013-01-20,2013-01-19,MEMPHIS_GRIZZLIES,CHICAGO_BULLS,85,82,594,3
594,2013-01-20,2013-01-19,HOUSTON_ROCKETS,MINNESOTA_TIMBERWOLVES,79,92,595,13
595,2013-01-20,2013-01-19,GOLDEN_STATE_WARRIORS,NEW_ORLEANS_HORNETS,116,112,596,4
596,2013-01-20,2013-01-19,CLEVELAND_CAVALIERS,UTAH_JAZZ,98,109,597,11
597,2013-01-20,2013-01-19,MILWAUKEE_BUCKS,PORTLAND_TRAIL_BLAZERS,110,104,598,6
598,2013-01-20,2013-01-19,WASHINGTON_WIZARDS,LOS_ANGELES_CLIPPERS,87,94,599,7
599,2013-01-20,2013-01-19,LOS_ANGELES_LAKERS,TORONTO_RAPTORS,103,108,600,5
600,2013-01-20,2013-01-19,DALLAS_MAVERICKS,ORLANDO_MAGIC,111,105,601,6
601,2013-01-21,2013-01-20,BOSTON_CELTICS,DETROIT_PISTONS,88,103,602,15
602,2013-01-21,2013-01-20,OKLAHOMA_CITY_THUNDER,DENVER_NUGGETS,118,121,603,3
603,2013-01-21,2013-01-20,INDIANA_PACERS,MEMPHIS_GRIZZLIES,82,81,604,1
604,2013-01-21,2013-01-20,SACRAMENTO_KINGS,NEW_ORLEANS_HORNETS,105,114,605,9
605,2013-01-21,2013-01-20,MINNESOTA_TIMBERWOLVES,ATLANTA_HAWKS,96,104,606,8
606,2013-01-21,2013-01-20,HOUSTON_ROCKETS,CHARLOTTE_BOBCATS,100,94,607,6
607,2013-01-21,2013-01-20,BROOKLYN_NETS,NEW_YORK_KNICKS,88,85,608,3
608,2013-01-21,2013-01-20,LOS_ANGELES_CLIPPERS,GOLDEN_STATE_WARRIORS,99,106,609,7
609,2013-01-22,2013-01-21,SAN_ANTONIO_SPURS,PHILADELPHIA_76ERS,90,85,610,5
610,2013-01-22,2013-01-21,LOS_ANGELES_LAKERS,CHICAGO_BULLS,83,95,611,12
611,2013-01-22,2013-01-21,WASHINGTON_WIZARDS,PORTLAND_TRAIL_BLAZERS,98,95,612,3
612,2013-01-23,2013-01-22,BOSTON_CELTICS,CLEVELAND_CAVALIERS,90,95,613,5
613,2013-01-23,2013-01-22,ORLANDO_MAGIC,DETROIT_PISTONS,90,105,614,15
614,2013-01-23,2013-01-22,PHILADELPHIA_76ERS,MILWAUKEE_BUCKS,102,110,615,8
615,2013-01-23,2013-01-22,OKLAHOMA_CITY_THUNDER,LOS_ANGELES_CLIPPERS,109,97,616,12
616,2013-01-24,2013-01-23,ATLANTA_HAWKS,CHARLOTTE_BOBCATS,104,92,617,12
617,2013-01-24,2013-01-23,TORONTO_RAPTORS,MIAMI_HEAT,116,123,618,7
618,2013-01-24,2013-01-23,DETROIT_PISTONS,CHICAGO_BULLS,82,85,619,3
619,2013-01-24,2013-01-23,DENVER_NUGGETS,HOUSTON_ROCKETS,105,95,620,10
620,2013-01-24,2013-01-23,LOS_ANGELES_LAKERS,MEMPHIS_GRIZZLIES,93,106,621,13
621,2013-01-24,2013-01-23,BROOKLYN_NETS,MINNESOTA_TIMBERWOLVES,91,83,622,8
622,2013-01-24,2013-01-23,NEW_ORLEANS_HORNETS,SAN_ANTONIO_SPURS,102,106,623,4
623,2013-01-24,2013-01-23,WASHINGTON_WIZARDS,UTAH_JAZZ,88,92,624,4
624,2013-01-24,2013-01-23,INDIANA_PACERS,PORTLAND_TRAIL_BLAZERS,80,100,625,20
625,2013-01-24,2013-01-23,PHOENIX_SUNS,SACRAMENTO_KINGS,106,96,626,10
626,2013-01-24,2013-01-23,OKLAHOMA_CITY_THUNDER,GOLDEN_STATE_WARRIORS,99,104,627,5
627,2013-01-25,2013-01-24,TORONTO_RAPTORS,ORLANDO_MAGIC,97,95,628,2
628,2013-01-25,2013-01-24,NEW_YORK_KNICKS,BOSTON_CELTICS,89,86,629,3
629,2013-01-25,2013-01-24,LOS_ANGELES_CLIPPERS,PHOENIX_SUNS,88,93,630,5
630,2013-01-26,2013-01-25,MINNESOTA_TIMBERWOLVES,WASHINGTON_WIZARDS,101,114,631,13
631,2013-01-26,2013-01-25,BOSTON_CELTICS,ATLANTA_HAWKS,111,123,632,12
632,2013-01-26,2013-01-25,MILWAUKEE_BUCKS,CLEVELAND_CAVALIERS,108,113,633,5
633,2013-01-26,2013-01-25,DETROIT_PISTONS,MIAMI_HEAT,88,110,634,22
634,2013-01-26,2013-01-25,GOLDEN_STATE_WARRIORS,CHICAGO_BULLS,87,103,635,16
635,2013-01-26,2013-01-25,SAN_ANTONIO_SPURS,DALLAS_MAVERICKS,113,107,636,6
636,2013-01-26,2013-01-25,BROOKLYN_NETS,MEMPHIS_GRIZZLIES,77,101,637,24
637,2013-01-26,2013-01-25,HOUSTON_ROCKETS,NEW_ORLEANS_HORNETS,100,82,638,18
638,2013-01-26,2013-01-25,OKLAHOMA_CITY_THUNDER,SACRAMENTO_KINGS,105,95,639,10
639,2013-01-26,2013-01-25,UTAH_JAZZ,LOS_ANGELES_LAKERS,84,102,640,18
640,2013-01-27,2013-01-26,NEW_YORK_KNICKS,PHILADELPHIA_76ERS,80,97,641,17
641,2013-01-27,2013-01-26,CLEVELAND_CAVALIERS,TORONTO_RAPTORS,99,98,642,1
642,2013-01-27,2013-01-26,CHICAGO_BULLS,WASHINGTON_WIZARDS,73,86,643,13
643,2013-01-27,2013-01-26,MINNESOTA_TIMBERWOLVES,CHARLOTTE_BOBCATS,101,102,644,1
644,2013-01-27,2013-01-26,BROOKLYN_NETS,HOUSTON_ROCKETS,106,119,645,13
645,2013-01-27,2013-01-26,GOLDEN_STATE_WARRIORS,MILWAUKEE_BUCKS,102,109,646,7
646,2013-01-27,2013-01-26,PHOENIX_SUNS,SAN_ANTONIO_SPURS,99,108,647,9
647,2013-01-27,2013-01-26,SACRAMENTO_KINGS,DENVER_NUGGETS,93,121,648,28
648,2013-01-27,2013-01-26,INDIANA_PACERS,UTAH_JAZZ,110,114,649,4
649,2013-01-27,2013-01-26,LOS_ANGELES_CLIPPERS,PORTLAND_TRAIL_BLAZERS,100,101,650,1
650,2013-01-27,2013-01-26,MIAMI_HEAT,BOSTON_CELTICS,98,100,651,2
651,2013-01-27,2013-01-26,OKLAHOMA_CITY_THUNDER,LOS_ANGELES_LAKERS,96,105,652,9
652,2013-01-27,2013-01-26,NEW_ORLEANS_HORNETS,MEMPHIS_GRIZZLIES,91,83,653,8
653,2013-01-27,2013-01-26,DETROIT_PISTONS,ORLANDO_MAGIC,104,102,654,2
654,2013-01-27,2013-01-26,ATLANTA_HAWKS,NEW_YORK_KNICKS,104,106,655,2
655,2013-01-28,2013-01-27,PHOENIX_SUNS,DALLAS_MAVERICKS,95,110,656,15
656,2013-01-28,2013-01-27,PORTLAND_TRAIL_BLAZERS,LOS_ANGELES_CLIPPERS,83,96,657,13
657,2013-01-29,2013-01-28,MEMPHIS_GRIZZLIES,PHILADELPHIA_76ERS,103,100,658,3
658,2013-01-29,2013-01-28,GOLDEN_STATE_WARRIORS,TORONTO_RAPTORS,114,102,659,12
659,2013-01-29,2013-01-28,SACRAMENTO_KINGS,WASHINGTON_WIZARDS,96,94,660,2
660,2013-01-29,2013-01-28,ORLANDO_MAGIC,BROOKLYN_NETS,77,97,661,20
661,2013-01-29,2013-01-28,CHARLOTTE_BOBCATS,CHICAGO_BULLS,85,93,662,8
662,2013-01-29,2013-01-28,INDIANA_PACERS,DENVER_NUGGETS,101,102,663,1
663,2013-01-29,2013-01-28,HOUSTON_ROCKETS,UTAH_JAZZ,125,80,664,45
664,2013-01-30,2013-01-29,GOLDEN_STATE_WARRIORS,CLEVELAND_CAVALIERS,108,95,665,13
665,2013-01-30,2013-01-29,MILWAUKEE_BUCKS,DETROIT_PISTONS,117,90,666,27
666,2013-01-30,2013-01-29,DALLAS_MAVERICKS,PORTLAND_TRAIL_BLAZERS,104,106,667,2
667,2013-01-30,2013-01-29,NEW_ORLEANS_HORNETS,LOS_ANGELES_LAKERS,106,111,668,5
668,2013-01-31,2013-01-30,DETROIT_PISTONS,INDIANA_PACERS,79,98,669,19
669,2013-01-31,2013-01-30,WASHINGTON_WIZARDS,PHILADELPHIA_76ERS,84,92,670,8
670,2013-01-31,2013-01-30,TORONTO_RAPTORS,ATLANTA_HAWKS,92,93,671,1
671,2013-01-31,2013-01-30,SACRAMENTO_KINGS,BOSTON_CELTICS,81,99,672,18
672,2013-01-31,2013-01-30,ORLANDO_MAGIC,NEW_YORK_KNICKS,97,113,673,16
673,2013-01-31,2013-01-30,MIAMI_HEAT,BROOKLYN_NETS,105,85,674,20
674,2013-01-31,2013-01-30,CHICAGO_BULLS,MILWAUKEE_BUCKS,104,88,675,16
675,2013-01-31,2013-01-30,LOS_ANGELES_CLIPPERS,MINNESOTA_TIMBERWOLVES,96,90,676,6
676,2013-01-31,2013-01-30,CHARLOTTE_BOBCATS,SAN_ANTONIO_SPURS,78,102,677,24
677,2013-01-31,2013-01-30,HOUSTON_ROCKETS,DENVER_NUGGETS,110,118,678,8
678,2013-01-31,2013-01-30,NEW_ORLEANS_HORNETS,UTAH_JAZZ,99,104,679,5
679,2013-01-31,2013-01-30,LOS_ANGELES_LAKERS,PHOENIX_SUNS,86,92,680,6
680,2013-02-01,2013-01-31,MEMPHIS_GRIZZLIES,OKLAHOMA_CITY_THUNDER,89,106,681,17
681,2013-02-01,2013-01-31,DALLAS_MAVERICKS,GOLDEN_STATE_WARRIORS,97,100,682,3
682,2013-02-02,2013-02-01,MIAMI_HEAT,INDIANA_PACERS,89,102,683,13
683,2013-02-02,2013-02-01,LOS_ANGELES_CLIPPERS,TORONTO_RAPTORS,73,98,684,25
684,2013-02-02,2013-02-01,ORLANDO_MAGIC,BOSTON_CELTICS,84,97,685,13
685,2013-02-02,2013-02-01,CHICAGO_BULLS,BROOKLYN_NETS,89,93,686,4
686,2013-02-02,2013-02-01,CLEVELAND_CAVALIERS,DETROIT_PISTONS,99,117,687,18
687,2013-02-02,2013-02-01,MILWAUKEE_BUCKS,NEW_YORK_KNICKS,86,96,688,10
688,2013-02-02,2013-02-01,SACRAMENTO_KINGS,PHILADELPHIA_76ERS,80,89,689,9
689,2013-02-02,2013-02-01,WASHINGTON_WIZARDS,MEMPHIS_GRIZZLIES,76,85,690,9
690,2013-02-02,2013-02-01,NEW_ORLEANS_HORNETS,DENVER_NUGGETS,98,113,691,15
691,2013-02-02,2013-02-01,DALLAS_MAVERICKS,PHOENIX_SUNS,109,99,692,10
692,2013-02-02,2013-02-01,PORTLAND_TRAIL_BLAZERS,UTAH_JAZZ,77,86,693,9
693,2013-02-02,2013-02-01,LOS_ANGELES_LAKERS,MINNESOTA_TIMBERWOLVES,111,100,694,11
694,2013-02-03,2013-02-02,CHICAGO_BULLS,ATLANTA_HAWKS,93,76,695,17
695,2013-02-03,2013-02-02,OKLAHOMA_CITY_THUNDER,CLEVELAND_CAVALIERS,110,115,696,5
696,2013-02-03,2013-02-02,SACRAMENTO_KINGS,NEW_YORK_KNICKS,81,120,697,39
697,2013-02-03,2013-02-02,CHARLOTTE_BOBCATS,HOUSTON_ROCKETS,95,109,698,14
698,2013-02-03,2013-02-02,NEW_ORLEANS_HORNETS,MINNESOTA_TIMBERWOLVES,86,115,699,29
699,2013-02-03,2013-02-02,ORLANDO_MAGIC,MILWAUKEE_BUCKS,98,107,700,9
700,2013-02-03,2013-02-02,WASHINGTON_WIZARDS,SAN_ANTONIO_SPURS,86,96,701,10
701,2013-02-03,2013-02-02,UTAH_JAZZ,PORTLAND_TRAIL_BLAZERS,99,105,702,6
702,2013-02-03,2013-02-02,PHOENIX_SUNS,GOLDEN_STATE_WARRIORS,93,113,703,20
703,2013-02-03,2013-02-02,LOS_ANGELES_CLIPPERS,BOSTON_CELTICS,104,106,704,2
704,2013-02-03,2013-02-02,LOS_ANGELES_LAKERS,DETROIT_PISTONS,98,97,705,1
705,2013-02-03,2013-02-02,MIAMI_HEAT,TORONTO_RAPTORS,100,85,706,15
706,2013-02-05,2013-02-04,CHICAGO_BULLS,INDIANA_PACERS,101,111,707,10
707,2013-02-05,2013-02-04,ORLANDO_MAGIC,PHILADELPHIA_76ERS,61,78,708,17
708,2013-02-05,2013-02-04,LOS_ANGELES_CLIPPERS,WASHINGTON_WIZARDS,90,98,709,8
709,2013-02-05,2013-02-04,CHARLOTTE_BOBCATS,MIAMI_HEAT,94,99,710,5
710,2013-02-05,2013-02-04,DETROIT_PISTONS,NEW_YORK_KNICKS,85,99,711,14
711,2013-02-05,2013-02-04,PORTLAND_TRAIL_BLAZERS,MINNESOTA_TIMBERWOLVES,100,98,712,2
712,2013-02-05,2013-02-04,DALLAS_MAVERICKS,OKLAHOMA_CITY_THUNDER,91,112,713,21
713,2013-02-05,2013-02-04,SACRAMENTO_KINGS,UTAH_JAZZ,91,98,714,7
714,2013-02-06,2013-02-05,ATLANTA_HAWKS,INDIANA_PACERS,103,114,715,11
715,2013-02-06,2013-02-05,LOS_ANGELES_LAKERS,BROOKLYN_NETS,92,83,716,9
716,2013-02-06,2013-02-05,GOLDEN_STATE_WARRIORS,HOUSTON_ROCKETS,109,140,717,31
717,2013-02-06,2013-02-05,PHOENIX_SUNS,MEMPHIS_GRIZZLIES,96,90,718,6
718,2013-02-06,2013-02-05,MILWAUKEE_BUCKS,DENVER_NUGGETS,104,112,719,8
719,2013-02-07,2013-02-06,CHARLOTTE_BOBCATS,CLEVELAND_CAVALIERS,95,122,720,27
720,2013-02-07,2013-02-06,LOS_ANGELES_CLIPPERS,ORLANDO_MAGIC,86,76,721,10
721,2013-02-07,2013-02-06,INDIANA_PACERS,PHILADELPHIA_76ERS,88,69,722,19
722,2013-02-07,2013-02-06,BOSTON_CELTICS,TORONTO_RAPTORS,99,95,723,4
723,2013-02-07,2013-02-06,NEW_YORK_KNICKS,WASHINGTON_WIZARDS,96,106,724,10
724,2013-02-07,2013-02-06,MEMPHIS_GRIZZLIES,ATLANTA_HAWKS,92,103,725,11
725,2013-02-07,2013-02-06,BROOKLYN_NETS,DETROIT_PISTONS,93,90,726,3
726,2013-02-07,2013-02-06,HOUSTON_ROCKETS,MIAMI_HEAT,108,114,727,6
727,2013-02-07,2013-02-06,PHOENIX_SUNS,NEW_ORLEANS_HORNETS,84,93,728,9
728,2013-02-07,2013-02-06,GOLDEN_STATE_WARRIORS,OKLAHOMA_CITY_THUNDER,98,119,729,21
729,2013-02-07,2013-02-06,PORTLAND_TRAIL_BLAZERS,DALLAS_MAVERICKS,99,105,730,6
730,2013-02-07,2013-02-06,SAN_ANTONIO_SPURS,MINNESOTA_TIMBERWOLVES,104,94,731,10
731,2013-02-07,2013-02-06,MILWAUKEE_BUCKS,UTAH_JAZZ,86,100,732,14
732,2013-02-08,2013-02-07,LOS_ANGELES_LAKERS,BOSTON_CELTICS,95,116,733,21
733,2013-02-08,2013-02-07,CHICAGO_BULLS,DENVER_NUGGETS,96,128,734,32
734,2013-02-09,2013-02-08,LOS_ANGELES_LAKERS,CHARLOTTE_BOBCATS,100,93,735,7
735,2013-02-09,2013-02-08,TORONTO_RAPTORS,INDIANA_PACERS,100,98,736,2
736,2013-02-09,2013-02-08,BROOKLYN_NETS,WASHINGTON_WIZARDS,74,89,737,15
737,2013-02-09,2013-02-08,NEW_ORLEANS_HORNETS,ATLANTA_HAWKS,111,100,738,11
738,2013-02-09,2013-02-08,ORLANDO_MAGIC,CLEVELAND_CAVALIERS,108,119,739,11
739,2013-02-09,2013-02-08,SAN_ANTONIO_SPURS,DETROIT_PISTONS,109,119,740,10
740,2013-02-09,2013-02-08,PORTLAND_TRAIL_BLAZERS,HOUSTON_ROCKETS,103,118,741,15
741,2013-02-09,2013-02-08,GOLDEN_STATE_WARRIORS,MEMPHIS_GRIZZLIES,93,99,742,6
742,2013-02-09,2013-02-08,LOS_ANGELES_CLIPPERS,MIAMI_HEAT,89,111,743,22
743,2013-02-09,2013-02-08,NEW_YORK_KNICKS,MINNESOTA_TIMBERWOLVES,100,94,744,6
744,2013-02-09,2013-02-08,PHOENIX_SUNS,OKLAHOMA_CITY_THUNDER,96,127,745,31
745,2013-02-09,2013-02-08,CHICAGO_BULLS,UTAH_JAZZ,93,89,746,4
746,2013-02-10,2013-02-09,DENVER_NUGGETS,CLEVELAND_CAVALIERS,111,103,747,8
747,2013-02-10,2013-02-09,CHARLOTTE_BOBCATS,PHILADELPHIA_76ERS,76,87,748,11
748,2013-02-10,2013-02-09,GOLDEN_STATE_WARRIORS,DALLAS_MAVERICKS,91,116,749,25
749,2013-02-10,2013-02-09,DETROIT_PISTONS,MILWAUKEE_BUCKS,105,100,750,5
750,2013-02-10,2013-02-09,UTAH_JAZZ,SACRAMENTO_KINGS,109,120,751,11
751,2013-02-10,2013-02-09,LOS_ANGELES_CLIPPERS,NEW_YORK_KNICKS,102,88,752,14
752,2013-02-10,2013-02-09,LOS_ANGELES_LAKERS,MIAMI_HEAT,97,107,753,10
753,2013-02-10,2013-02-09,DENVER_NUGGETS,BOSTON_CELTICS,114,118,754,4
754,2013-02-10,2013-02-09,MINNESOTA_TIMBERWOLVES,MEMPHIS_GRIZZLIES,88,105,755,17
755,2013-02-10,2013-02-09,PORTLAND_TRAIL_BLAZERS,ORLANDO_MAGIC,104,110,756,6
756,2013-02-10,2013-02-09,NEW_ORLEANS_HORNETS,TORONTO_RAPTORS,89,102,757,13
757,2013-02-11,2013-02-10,SAN_ANTONIO_SPURS,BROOKLYN_NETS,111,86,758,25
758,2013-02-11,2013-02-10,OKLAHOMA_CITY_THUNDER,PHOENIX_SUNS,97,69,759,28
759,2013-02-11,2013-02-10,HOUSTON_ROCKETS,SACRAMENTO_KINGS,111,117,760,6
760,2013-02-12,2013-02-11,BOSTON_CELTICS,CHARLOTTE_BOBCATS,91,94,761,3
761,2013-02-12,2013-02-11,MINNESOTA_TIMBERWOLVES,CLEVELAND_CAVALIERS,100,92,762,8
762,2013-02-12,2013-02-11,BROOKLYN_NETS,INDIANA_PACERS,89,84,763,5
763,2013-02-12,2013-02-11,LOS_ANGELES_CLIPPERS,PHILADELPHIA_76ERS,107,90,764,17
764,2013-02-12,2013-02-11,NEW_ORLEANS_HORNETS,DETROIT_PISTONS,105,86,765,19
765,2013-02-12,2013-02-11,SAN_ANTONIO_SPURS,CHICAGO_BULLS,103,89,766,14
766,2013-02-12,2013-02-11,WASHINGTON_WIZARDS,MILWAUKEE_BUCKS,102,90,767,12
767,2013-02-12,2013-02-11,ATLANTA_HAWKS,DALLAS_MAVERICKS,105,101,768,4
768,2013-02-13,2013-02-12,DENVER_NUGGETS,TORONTO_RAPTORS,108,109,769,1
769,2013-02-13,2013-02-12,PORTLAND_TRAIL_BLAZERS,MIAMI_HEAT,104,117,770,13
770,2013-02-13,2013-02-12,SACRAMENTO_KINGS,MEMPHIS_GRIZZLIES,101,108,771,7
771,2013-02-13,2013-02-12,OKLAHOMA_CITY_THUNDER,UTAH_JAZZ,94,109,772,15
772,2013-02-13,2013-02-12,HOUSTON_ROCKETS,GOLDEN_STATE_WARRIORS,116,107,773,9
773,2013-02-13,2013-02-12,PHOENIX_SUNS,LOS_ANGELES_LAKERS,85,91,774,6
774,2013-02-14,2013-02-13,SAN_ANTONIO_SPURS,CLEVELAND_CAVALIERS,96,95,775,1
775,2013-02-14,2013-02-13,CHARLOTTE_BOBCATS,INDIANA_PACERS,77,101,776,24
776,2013-02-14,2013-02-13,ATLANTA_HAWKS,ORLANDO_MAGIC,108,76,777,32
777,2013-02-14,2013-02-13,CHICAGO_BULLS,BOSTON_CELTICS,69,71,778,2
778,2013-02-14,2013-02-13,DENVER_NUGGETS,BROOKLYN_NETS,108,119,779,11
779,2013-02-14,2013-02-13,WASHINGTON_WIZARDS,DETROIT_PISTONS,85,96,780,11
780,2013-02-14,2013-02-13,TORONTO_RAPTORS,NEW_YORK_KNICKS,92,88,781,4
781,2013-02-14,2013-02-13,PHILADELPHIA_76ERS,MILWAUKEE_BUCKS,92,94,782,2
782,2013-02-14,2013-02-13,UTAH_JAZZ,MINNESOTA_TIMBERWOLVES,97,93,783,4
783,2013-02-14,2013-02-13,PORTLAND_TRAIL_BLAZERS,NEW_ORLEANS_HORNETS,63,99,784,36
784,2013-02-14,2013-02-13,SACRAMENTO_KINGS,DALLAS_MAVERICKS,100,123,785,23
785,2013-02-14,2013-02-13,HOUSTON_ROCKETS,LOS_ANGELES_CLIPPERS,96,106,786,10
786,2013-02-15,2013-02-14,MIAMI_HEAT,OKLAHOMA_CITY_THUNDER,110,100,787,10
787,2013-02-15,2013-02-14,LOS_ANGELES_CLIPPERS,LOS_ANGELES_LAKERS,125,101,788,24
788,2013-02-20,2013-02-19,CHARLOTTE_BOBCATS,ORLANDO_MAGIC,105,92,789,13
789,2013-02-20,2013-02-19,TORONTO_RAPTORS,WASHINGTON_WIZARDS,96,88,790,8
790,2013-02-20,2013-02-19,MILWAUKEE_BUCKS,BROOKLYN_NETS,111,113,791,2
791,2013-02-20,2013-02-19,MEMPHIS_GRIZZLIES,DETROIT_PISTONS,105,91,792,14
792,2013-02-20,2013-02-19,CHICAGO_BULLS,NEW_ORLEANS_HORNETS,96,87,793,9
793,2013-02-20,2013-02-19,BOSTON_CELTICS,DENVER_NUGGETS,90,97,794,7
794,2013-02-20,2013-02-19,GOLDEN_STATE_WARRIORS,UTAH_JAZZ,101,115,795,14
795,2013-02-20,2013-02-19,PHOENIX_SUNS,PORTLAND_TRAIL_BLAZERS,102,98,796,4
796,2013-02-20,2013-02-19,SAN_ANTONIO_SPURS,SACRAMENTO_KINGS,108,102,797,6
797,2013-02-21,2013-02-20,DETROIT_PISTONS,CHARLOTTE_BOBCATS,105,99,798,6
798,2013-02-21,2013-02-20,NEW_YORK_KNICKS,INDIANA_PACERS,91,125,799,34
799,2013-02-21,2013-02-20,MEMPHIS_GRIZZLIES,TORONTO_RAPTORS,88,82,800,6
800,2013-02-21,2013-02-20,MIAMI_HEAT,ATLANTA_HAWKS,103,90,801,13
801,2013-02-21,2013-02-20,NEW_ORLEANS_HORNETS,CLEVELAND_CAVALIERS,100,105,802,5
802,2013-02-21,2013-02-20,OKLAHOMA_CITY_THUNDER,HOUSTON_ROCKETS,119,122,803,3
803,2013-02-21,2013-02-20,BROOKLYN_NETS,MILWAUKEE_BUCKS,97,94,804,3
804,2013-02-21,2013-02-20,PHILADELPHIA_76ERS,MINNESOTA_TIMBERWOLVES,87,94,805,7
805,2013-02-21,2013-02-20,ORLANDO_MAGIC,DALLAS_MAVERICKS,96,111,806,15
806,2013-02-21,2013-02-20,PHOENIX_SUNS,GOLDEN_STATE_WARRIORS,98,108,807,10
807,2013-02-21,2013-02-20,BOSTON_CELTICS,LOS_ANGELES_LAKERS,99,113,808,14
808,2013-02-22,2013-02-21,MIAMI_HEAT,CHICAGO_BULLS,86,67,809,19
809,2013-02-22,2013-02-21,SAN_ANTONIO_SPURS,LOS_ANGELES_CLIPPERS,116,90,810,26
810,2013-02-23,2013-02-22,CHICAGO_BULLS,CHARLOTTE_BOBCATS,105,75,811,30
811,2013-02-23,2013-02-22,DETROIT_PISTONS,INDIANA_PACERS,82,114,812,32
812,2013-02-23,2013-02-22,NEW_YORK_KNICKS,TORONTO_RAPTORS,98,100,813,2
813,2013-02-23,2013-02-22,DENVER_NUGGETS,WASHINGTON_WIZARDS,113,119,814,6
814,2013-02-23,2013-02-22,SACRAMENTO_KINGS,ATLANTA_HAWKS,108,122,815,14
815,2013-02-23,2013-02-22,HOUSTON_ROCKETS,BROOKLYN_NETS,106,96,816,10
816,2013-02-23,2013-02-22,ORLANDO_MAGIC,MEMPHIS_GRIZZLIES,82,88,817,6
817,2013-02-23,2013-02-22,DALLAS_MAVERICKS,NEW_ORLEANS_HORNETS,104,100,818,4
818,2013-02-23,2013-02-22,MINNESOTA_TIMBERWOLVES,OKLAHOMA_CITY_THUNDER,111,127,819,16
819,2013-02-23,2013-02-22,BOSTON_CELTICS,PHOENIX_SUNS,113,88,820,25
820,2013-02-23,2013-02-22,SAN_ANTONIO_SPURS,GOLDEN_STATE_WARRIORS,101,107,821,6
821,2013-02-23,2013-02-22,PORTLAND_TRAIL_BLAZERS,LOS_ANGELES_LAKERS,107,111,822,4
822,2013-02-24,2013-02-23,DENVER_NUGGETS,CHARLOTTE_BOBCATS,113,99,823,14
823,2013-02-24,2013-02-23,CLEVELAND_CAVALIERS,ORLANDO_MAGIC,118,94,824,24
824,2013-02-24,2013-02-23,HOUSTON_ROCKETS,WASHINGTON_WIZARDS,103,105,825,2
825,2013-02-24,2013-02-23,INDIANA_PACERS,DETROIT_PISTONS,90,72,826,18
826,2013-02-24,2013-02-23,MIAMI_HEAT,PHILADELPHIA_76ERS,114,90,827,24
827,2013-02-24,2013-02-23,ATLANTA_HAWKS,MILWAUKEE_BUCKS,103,102,828,1
828,2013-02-24,2013-02-23,UTAH_JAZZ,LOS_ANGELES_CLIPPERS,94,107,829,13
829,2013-02-24,2013-02-23,LOS_ANGELES_LAKERS,DALLAS_MAVERICKS,103,99,830,4
830,2013-02-24,2013-02-23,GOLDEN_STATE_WARRIORS,MINNESOTA_TIMBERWOLVES,100,99,831,1
831,2013-02-24,2013-02-23,CLEVELAND_CAVALIERS,MIAMI_HEAT,105,109,832,4
832,2013-02-24,2013-02-23,SACRAMENTO_KINGS,NEW_ORLEANS_HORNETS,95,110,833,15
833,2013-02-25,2013-02-24,MEMPHIS_GRIZZLIES,BROOKLYN_NETS,76,72,834,4
834,2013-02-25,2013-02-24,PHILADELPHIA_76ERS,NEW_YORK_KNICKS,93,99,835,6
835,2013-02-25,2013-02-24,SAN_ANTONIO_SPURS,PHOENIX_SUNS,97,87,836,10
836,2013-02-25,2013-02-24,BOSTON_CELTICS,PORTLAND_TRAIL_BLAZERS,86,92,837,6
837,2013-02-25,2013-02-24,CHICAGO_BULLS,OKLAHOMA_CITY_THUNDER,72,102,838,30
838,2013-02-26,2013-02-25,WASHINGTON_WIZARDS,TORONTO_RAPTORS,90,84,839,6
839,2013-02-26,2013-02-25,ATLANTA_HAWKS,DETROIT_PISTONS,114,103,840,11
840,2013-02-26,2013-02-25,LOS_ANGELES_LAKERS,DENVER_NUGGETS,108,119,841,11
841,2013-02-26,2013-02-25,BOSTON_CELTICS,UTAH_JAZZ,110,107,842,3
842,2013-02-27,2013-02-26,GOLDEN_STATE_WARRIORS,INDIANA_PACERS,97,108,843,11
843,2013-02-27,2013-02-26,ORLANDO_MAGIC,PHILADELPHIA_76ERS,98,84,844,14
844,2013-02-27,2013-02-26,SACRAMENTO_KINGS,MIAMI_HEAT,129,141,845,12
845,2013-02-27,2013-02-26,CLEVELAND_CAVALIERS,CHICAGO_BULLS,101,98,846,3
846,2013-02-27,2013-02-26,BROOKLYN_NETS,NEW_ORLEANS_HORNETS,101,97,847,4
847,2013-02-27,2013-02-26,MILWAUKEE_BUCKS,DALLAS_MAVERICKS,95,90,848,5
848,2013-02-27,2013-02-26,MINNESOTA_TIMBERWOLVES,PHOENIX_SUNS,83,84,849,1
849,2013-02-27,2013-02-26,CHARLOTTE_BOBCATS,LOS_ANGELES_CLIPPERS,84,106,850,22
850,2013-02-28,2013-02-27,TORONTO_RAPTORS,CLEVELAND_CAVALIERS,92,103,851,11
851,2013-02-28,2013-02-27,SACRAMENTO_KINGS,ORLANDO_MAGIC,125,101,852,24
852,2013-02-28,2013-02-27,DETROIT_PISTONS,WASHINGTON_WIZARDS,96,95,853,1
853,2013-02-28,2013-02-27,MILWAUKEE_BUCKS,HOUSTON_ROCKETS,110,107,854,3
854,2013-02-28,2013-02-27,DALLAS_MAVERICKS,MEMPHIS_GRIZZLIES,84,90,855,6
855,2013-02-28,2013-02-27,GOLDEN_STATE_WARRIORS,NEW_YORK_KNICKS,105,109,856,4
856,2013-02-28,2013-02-27,NEW_ORLEANS_HORNETS,OKLAHOMA_CITY_THUNDER,74,119,857,45
857,2013-02-28,2013-02-27,PHOENIX_SUNS,SAN_ANTONIO_SPURS,105,101,858,4
858,2013-02-28,2013-02-27,ATLANTA_HAWKS,UTAH_JAZZ,102,91,859,11
859,2013-02-28,2013-02-27,DENVER_NUGGETS,PORTLAND_TRAIL_BLAZERS,111,109,860,2
860,2013-03-01,2013-02-28,LOS_ANGELES_CLIPPERS,INDIANA_PACERS,99,91,861,8
861,2013-03-01,2013-02-28,PHILADELPHIA_76ERS,CHICAGO_BULLS,82,93,862,11
862,2013-03-01,2013-02-28,MINNESOTA_TIMBERWOLVES,LOS_ANGELES_LAKERS,94,116,863,22
863,2013-03-02,2013-03-01,HOUSTON_ROCKETS,ORLANDO_MAGIC,118,110,864,8
864,2013-03-02,2013-03-01,INDIANA_PACERS,TORONTO_RAPTORS,93,81,865,12
865,2013-03-02,2013-03-01,NEW_YORK_KNICKS,WASHINGTON_WIZARDS,96,88,866,8
866,2013-03-02,2013-03-01,GOLDEN_STATE_WARRIORS,BOSTON_CELTICS,86,94,867,8
867,2013-03-02,2013-03-01,LOS_ANGELES_CLIPPERS,CLEVELAND_CAVALIERS,105,89,868,16
868,2013-03-02,2013-03-01,DALLAS_MAVERICKS,BROOKLYN_NETS,98,90,869,8
869,2013-03-02,2013-03-01,MEMPHIS_GRIZZLIES,MIAMI_HEAT,91,98,870,7
870,2013-03-02,2013-03-01,DETROIT_PISTONS,NEW_ORLEANS_HORNETS,95,100,871,5
871,2013-03-02,2013-03-01,SACRAMENTO_KINGS,SAN_ANTONIO_SPURS,102,130,872,28
872,2013-03-02,2013-03-01,ATLANTA_HAWKS,PHOENIX_SUNS,87,92,873,5
873,2013-03-02,2013-03-01,CHARLOTTE_BOBCATS,UTAH_JAZZ,68,98,874,30
874,2013-03-02,2013-03-01,OKLAHOMA_CITY_THUNDER,DENVER_NUGGETS,103,105,875,2
875,2013-03-03,2013-03-02,GOLDEN_STATE_WARRIORS,PHILADELPHIA_76ERS,97,104,876,7
876,2013-03-03,2013-03-02,BROOKLYN_NETS,CHICAGO_BULLS,85,96,877,11
877,2013-03-03,2013-03-02,TORONTO_RAPTORS,MILWAUKEE_BUCKS,114,122,878,8
878,2013-03-03,2013-03-02,MINNESOTA_TIMBERWOLVES,PORTLAND_TRAIL_BLAZERS,94,109,879,15
879,2013-03-03,2013-03-02,MIAMI_HEAT,NEW_YORK_KNICKS,99,93,880,6
880,2013-03-03,2013-03-02,OKLAHOMA_CITY_THUNDER,LOS_ANGELES_CLIPPERS,108,104,881,4
881,2013-03-03,2013-03-02,MEMPHIS_GRIZZLIES,ORLANDO_MAGIC,108,82,882,26
882,2013-03-03,2013-03-02,CHARLOTTE_BOBCATS,SACRAMENTO_KINGS,83,119,883,36
883,2013-03-03,2013-03-02,PHILADELPHIA_76ERS,WASHINGTON_WIZARDS,87,90,884,3
884,2013-03-04,2013-03-03,DALLAS_MAVERICKS,HOUSTON_ROCKETS,103,136,885,33
885,2013-03-04,2013-03-03,DETROIT_PISTONS,SAN_ANTONIO_SPURS,75,114,886,39
886,2013-03-04,2013-03-03,CHICAGO_BULLS,INDIANA_PACERS,92,97,887,5
887,2013-03-04,2013-03-03,ATLANTA_HAWKS,LOS_ANGELES_LAKERS,98,99,888,1
888,2013-03-05,2013-03-04,NEW_YORK_KNICKS,CLEVELAND_CAVALIERS,102,97,889,5
889,2013-03-05,2013-03-04,UTAH_JAZZ,MILWAUKEE_BUCKS,108,109,890,1
890,2013-03-05,2013-03-04,MIAMI_HEAT,MINNESOTA_TIMBERWOLVES,97,81,891,16
891,2013-03-05,2013-03-04,ORLANDO_MAGIC,NEW_ORLEANS_HORNETS,105,102,892,3
892,2013-03-05,2013-03-04,ATLANTA_HAWKS,DENVER_NUGGETS,88,104,893,16
893,2013-03-05,2013-03-04,CHARLOTTE_BOBCATS,PORTLAND_TRAIL_BLAZERS,105,122,894,17
894,2013-03-05,2013-03-04,TORONTO_RAPTORS,GOLDEN_STATE_WARRIORS,118,125,895,7
895,2013-03-06,2013-03-05,BOSTON_CELTICS,PHILADELPHIA_76ERS,109,101,896,8
896,2013-03-06,2013-03-05,LOS_ANGELES_LAKERS,OKLAHOMA_CITY_THUNDER,105,122,897,17
897,2013-03-06,2013-03-05,DENVER_NUGGETS,SACRAMENTO_KINGS,120,113,898,7
898,2013-03-07,2013-03-06,BROOKLYN_NETS,CHARLOTTE_BOBCATS,99,78,899,21
899,2013-03-07,2013-03-06,UTAH_JAZZ,CLEVELAND_CAVALIERS,101,104,900,3
900,2013-03-07,2013-03-06,BOSTON_CELTICS,INDIANA_PACERS,83,81,901,2
901,2013-03-07,2013-03-06,PHILADELPHIA_76ERS,ATLANTA_HAWKS,96,107,902,11
902,2013-03-07,2013-03-06,NEW_YORK_KNICKS,DETROIT_PISTONS,87,77,903,10
903,2013-03-07,2013-03-06,ORLANDO_MAGIC,MIAMI_HEAT,96,97,904,1
904,2013-03-07,2013-03-06,PORTLAND_TRAIL_BLAZERS,MEMPHIS_GRIZZLIES,85,91,905,6
905,2013-03-07,2013-03-06,WASHINGTON_WIZARDS,MINNESOTA_TIMBERWOLVES,82,87,906,5
906,2013-03-07,2013-03-06,LOS_ANGELES_LAKERS,NEW_ORLEANS_HORNETS,108,102,907,6
907,2013-03-07,2013-03-06,HOUSTON_ROCKETS,DALLAS_MAVERICKS,108,112,908,4
908,2013-03-07,2013-03-06,TORONTO_RAPTORS,PHOENIX_SUNS,98,71,909,27
909,2013-03-07,2013-03-06,CHICAGO_BULLS,SAN_ANTONIO_SPURS,83,101,910,18
910,2013-03-07,2013-03-06,SACRAMENTO_KINGS,GOLDEN_STATE_WARRIORS,83,87,911,4
911,2013-03-07,2013-03-06,MILWAUKEE_BUCKS,LOS_ANGELES_CLIPPERS,101,117,912,16
912,2013-03-08,2013-03-07,OKLAHOMA_CITY_THUNDER,NEW_YORK_KNICKS,95,94,913,1
913,2013-03-08,2013-03-07,LOS_ANGELES_CLIPPERS,DENVER_NUGGETS,92,107,914,15
914,2013-03-09,2013-03-08,OKLAHOMA_CITY_THUNDER,CHARLOTTE_BOBCATS,116,94,915,22
915,2013-03-09,2013-03-08,INDIANA_PACERS,ORLANDO_MAGIC,115,86,916,29
916,2013-03-09,2013-03-08,WASHINGTON_WIZARDS,BROOKLYN_NETS,78,95,917,17
917,2013-03-09,2013-03-08,MEMPHIS_GRIZZLIES,CLEVELAND_CAVALIERS,103,92,918,11
918,2013-03-09,2013-03-08,DALLAS_MAVERICKS,DETROIT_PISTONS,102,99,919,3
919,2013-03-09,2013-03-08,ATLANTA_HAWKS,BOSTON_CELTICS,102,107,920,5
920,2013-03-09,2013-03-08,UTAH_JAZZ,CHICAGO_BULLS,88,89,921,1
921,2013-03-09,2013-03-08,PHILADELPHIA_76ERS,MIAMI_HEAT,93,102,922,9
922,2013-03-09,2013-03-08,PORTLAND_TRAIL_BLAZERS,SAN_ANTONIO_SPURS,136,106,923,30
923,2013-03-09,2013-03-08,PHOENIX_SUNS,SACRAMENTO_KINGS,112,121,924,9
924,2013-03-09,2013-03-08,HOUSTON_ROCKETS,GOLDEN_STATE_WARRIORS,94,88,925,6
925,2013-03-09,2013-03-08,TORONTO_RAPTORS,LOS_ANGELES_LAKERS,116,118,926,2
926,2013-03-10,2013-03-09,BROOKLYN_NETS,ATLANTA_HAWKS,93,80,927,13
927,2013-03-10,2013-03-09,UTAH_JAZZ,NEW_YORK_KNICKS,84,113,928,29
928,2013-03-10,2013-03-09,NEW_ORLEANS_HORNETS,MEMPHIS_GRIZZLIES,85,96,929,11
929,2013-03-10,2013-03-09,CHARLOTTE_BOBCATS,WASHINGTON_WIZARDS,87,104,930,17
930,2013-03-10,2013-03-09,MINNESOTA_TIMBERWOLVES,DENVER_NUGGETS,88,111,931,23
931,2013-03-10,2013-03-09,HOUSTON_ROCKETS,PHOENIX_SUNS,105,107,932,2
932,2013-03-10,2013-03-09,MILWAUKEE_BUCKS,GOLDEN_STATE_WARRIORS,103,93,933,10
933,2013-03-10,2013-03-09,BOSTON_CELTICS,OKLAHOMA_CITY_THUNDER,79,91,934,12
934,2013-03-10,2013-03-09,CHICAGO_BULLS,LOS_ANGELES_LAKERS,81,90,935,9
935,2013-03-10,2013-03-09,INDIANA_PACERS,MIAMI_HEAT,91,105,936,14
936,2013-03-10,2013-03-09,PHILADELPHIA_76ERS,ORLANDO_MAGIC,91,99,937,8
937,2013-03-10,2013-03-09,CLEVELAND_CAVALIERS,TORONTO_RAPTORS,96,100,938,4
938,2013-03-10,2013-03-09,DALLAS_MAVERICKS,MINNESOTA_TIMBERWOLVES,100,77,939,23
939,2013-03-10,2013-03-09,PORTLAND_TRAIL_BLAZERS,NEW_ORLEANS_HORNETS,96,98,940,2
940,2013-03-11,2013-03-10,MILWAUKEE_BUCKS,SACRAMENTO_KINGS,115,113,941,2
941,2013-03-11,2013-03-10,DETROIT_PISTONS,LOS_ANGELES_CLIPPERS,97,129,942,32
942,2013-03-11,2013-03-10,BROOKLYN_NETS,PHILADELPHIA_76ERS,97,106,943,9
943,2013-03-12,2013-03-11,OKLAHOMA_CITY_THUNDER,SAN_ANTONIO_SPURS,93,105,944,12
944,2013-03-12,2013-03-11,DETROIT_PISTONS,UTAH_JAZZ,90,103,945,13
945,2013-03-12,2013-03-11,DENVER_NUGGETS,PHOENIX_SUNS,108,93,946,15
946,2013-03-12,2013-03-11,NEW_YORK_KNICKS,GOLDEN_STATE_WARRIORS,63,92,947,29
947,2013-03-12,2013-03-11,BOSTON_CELTICS,CHARLOTTE_BOBCATS,74,100,948,26
948,2013-03-12,2013-03-11,WASHINGTON_WIZARDS,CLEVELAND_CAVALIERS,90,95,949,5
949,2013-03-12,2013-03-11,LOS_ANGELES_LAKERS,ORLANDO_MAGIC,106,97,950,9
950,2013-03-12,2013-03-11,NEW_ORLEANS_HORNETS,BROOKLYN_NETS,98,108,951,10
951,2013-03-12,2013-03-11,ATLANTA_HAWKS,MIAMI_HEAT,81,98,952,17
952,2013-03-13,2013-03-12,DALLAS_MAVERICKS,MILWAUKEE_BUCKS,115,108,953,7
953,2013-03-13,2013-03-12,SAN_ANTONIO_SPURS,MINNESOTA_TIMBERWOLVES,83,107,954,24
954,2013-03-13,2013-03-12,MEMPHIS_GRIZZLIES,PORTLAND_TRAIL_BLAZERS,102,97,955,5
955,2013-03-13,2013-03-12,MINNESOTA_TIMBERWOLVES,INDIANA_PACERS,91,107,956,16
956,2013-03-13,2013-03-12,MIAMI_HEAT,PHILADELPHIA_76ERS,98,94,957,4
957,2013-03-13,2013-03-12,MILWAUKEE_BUCKS,WASHINGTON_WIZARDS,93,106,958,13
958,2013-03-13,2013-03-12,LOS_ANGELES_LAKERS,ATLANTA_HAWKS,92,96,959,4
959,2013-03-13,2013-03-12,TORONTO_RAPTORS,BOSTON_CELTICS,88,112,960,24
960,2013-03-14,2013-03-13,PHOENIX_SUNS,HOUSTON_ROCKETS,81,111,961,30
961,2013-03-14,2013-03-13,UTAH_JAZZ,OKLAHOMA_CITY_THUNDER,87,110,962,23
962,2013-03-14,2013-03-13,CHICAGO_BULLS,SACRAMENTO_KINGS,79,121,963,42
963,2013-03-14,2013-03-13,NEW_YORK_KNICKS,DENVER_NUGGETS,94,117,964,23
964,2013-03-14,2013-03-13,DETROIT_PISTONS,GOLDEN_STATE_WARRIORS,97,105,965,8
965,2013-03-14,2013-03-13,MEMPHIS_GRIZZLIES,LOS_ANGELES_CLIPPERS,96,85,966,11
966,2013-03-15,2013-03-14,DALLAS_MAVERICKS,SAN_ANTONIO_SPURS,91,92,967,1
967,2013-03-15,2013-03-14,NEW_YORK_KNICKS,PORTLAND_TRAIL_BLAZERS,90,105,968,15
968,2013-03-15,2013-03-14,LOS_ANGELES_LAKERS,INDIANA_PACERS,99,93,969,6
969,2013-03-15,2013-03-14,CHARLOTTE_BOBCATS,TORONTO_RAPTORS,78,92,970,14
970,2013-03-15,2013-03-14,NEW_ORLEANS_HORNETS,WASHINGTON_WIZARDS,87,96,971,9
971,2013-03-15,2013-03-14,PHOENIX_SUNS,ATLANTA_HAWKS,94,107,972,13
972,2013-03-16,2013-03-15,MINNESOTA_TIMBERWOLVES,HOUSTON_ROCKETS,100,108,973,8
973,2013-03-16,2013-03-15,ORLANDO_MAGIC,OKLAHOMA_CITY_THUNDER,104,117,974,13
974,2013-03-16,2013-03-15,CLEVELAND_CAVALIERS,DALLAS_MAVERICKS,86,96,975,10
975,2013-03-16,2013-03-15,MIAMI_HEAT,MILWAUKEE_BUCKS,107,94,976,13
976,2013-03-16,2013-03-15,MEMPHIS_GRIZZLIES,DENVER_NUGGETS,80,87,977,7
977,2013-03-16,2013-03-15,CHICAGO_BULLS,GOLDEN_STATE_WARRIORS,113,95,978,18
978,2013-03-16,2013-03-15,PHOENIX_SUNS,WASHINGTON_WIZARDS,105,127,979,22
979,2013-03-16,2013-03-15,CHARLOTTE_BOBCATS,BOSTON_CELTICS,88,105,980,17
980,2013-03-16,2013-03-15,INDIANA_PACERS,PHILADELPHIA_76ERS,91,98,981,7
981,2013-03-17,2013-03-16,CLEVELAND_CAVALIERS,SAN_ANTONIO_SPURS,113,119,982,6
982,2013-03-17,2013-03-16,DETROIT_PISTONS,PORTLAND_TRAIL_BLAZERS,101,112,983,11
983,2013-03-17,2013-03-16,MEMPHIS_GRIZZLIES,UTAH_JAZZ,84,90,984,6
984,2013-03-17,2013-03-16,ORLANDO_MAGIC,MILWAUKEE_BUCKS,109,115,985,6
985,2013-03-17,2013-03-16,MIAMI_HEAT,TORONTO_RAPTORS,108,91,986,17
986,2013-03-17,2013-03-16,NEW_YORK_KNICKS,LOS_ANGELES_CLIPPERS,80,93,987,13
987,2013-03-17,2013-03-16,GOLDEN_STATE_WARRIORS,HOUSTON_ROCKETS,108,78,988,30
988,2013-03-17,2013-03-16,NEW_ORLEANS_HORNETS,MINNESOTA_TIMBERWOLVES,95,97,989,2
989,2013-03-17,2013-03-16,OKLAHOMA_CITY_THUNDER,DALLAS_MAVERICKS,107,101,990,6
990,2013-03-18,2013-03-17,ATLANTA_HAWKS,BROOKLYN_NETS,105,93,991,12
991,2013-03-18,2013-03-17,SACRAMENTO_KINGS,LOS_ANGELES_LAKERS,102,113,992,11
992,2013-03-18,2013-03-17,WASHINGTON_WIZARDS,CHARLOTTE_BOBCATS,114,119,993,5
993,2013-03-18,2013-03-17,INDIANA_PACERS,CLEVELAND_CAVALIERS,111,90,994,21
994,2013-03-18,2013-03-17,PORTLAND_TRAIL_BLAZERS,PHILADELPHIA_76ERS,100,101,995,1
995,2013-03-18,2013-03-17,DALLAS_MAVERICKS,ATLANTA_HAWKS,127,113,996,14
996,2013-03-18,2013-03-17,BROOKLYN_NETS,DETROIT_PISTONS,119,82,997,37
997,2013-03-19,2013-03-18,MIAMI_HEAT,BOSTON_CELTICS,105,103,998,2
998,2013-03-19,2013-03-18,DENVER_NUGGETS,CHICAGO_BULLS,119,118,999,1
999,2013-03-19,2013-03-18,MINNESOTA_TIMBERWOLVES,MEMPHIS_GRIZZLIES,77,92,1000,15
1000,2013-03-19,2013-03-18,GOLDEN_STATE_WARRIORS,NEW_ORLEANS_HORNETS,93,72,1001,21
1001,2013-03-19,2013-03-18,LOS_ANGELES_LAKERS,PHOENIX_SUNS,76,99,1002,23
1002,2013-03-19,2013-03-18,NEW_YORK_KNICKS,UTAH_JAZZ,90,83,1003,7
1003,2013-03-19,2013-03-18,ORLANDO_MAGIC,INDIANA_PACERS,73,95,1004,22
1004,2013-03-20,2013-03-19,PORTLAND_TRAIL_BLAZERS,MILWAUKEE_BUCKS,95,102,1005,7
1005,2013-03-20,2013-03-19,DENVER_NUGGETS,OKLAHOMA_CITY_THUNDER,114,104,1006,10
1006,2013-03-20,2013-03-19,LOS_ANGELES_CLIPPERS,SACRAMENTO_KINGS,101,116,1007,15
1007,2013-03-20,2013-03-19,TORONTO_RAPTORS,CHARLOTTE_BOBCATS,101,107,1008,6
1008,2013-03-20,2013-03-19,MIAMI_HEAT,CLEVELAND_CAVALIERS,98,95,1009,3
1009,2013-03-20,2013-03-19,MILWAUKEE_BUCKS,ATLANTA_HAWKS,90,98,1010,8
1010,2013-03-20,2013-03-19,ORLANDO_MAGIC,NEW_YORK_KNICKS,94,106,1011,12
1011,2013-03-21,2013-03-20,BROOKLYN_NETS,DALLAS_MAVERICKS,113,96,1012,17
1012,2013-03-21,2013-03-20,UTAH_JAZZ,HOUSTON_ROCKETS,93,100,1013,7
1013,2013-03-21,2013-03-20,OKLAHOMA_CITY_THUNDER,MEMPHIS_GRIZZLIES,89,90,1014,1
1014,2013-03-21,2013-03-20,BOSTON_CELTICS,NEW_ORLEANS_HORNETS,86,87,1015,1
1015,2013-03-21,2013-03-20,GOLDEN_STATE_WARRIORS,SAN_ANTONIO_SPURS,93,104,1016,11
1016,2013-03-21,2013-03-20,WASHINGTON_WIZARDS,PHOENIX_SUNS,88,79,1017,9
1017,2013-03-21,2013-03-20,PHILADELPHIA_76ERS,LOS_ANGELES_CLIPPERS,72,101,1018,29
1018,2013-03-22,2013-03-21,PORTLAND_TRAIL_BLAZERS,CHICAGO_BULLS,99,89,1019,10
1019,2013-03-22,2013-03-21,PHILADELPHIA_76ERS,DENVER_NUGGETS,100,101,1020,1
1020,2013-03-22,2013-03-21,MINNESOTA_TIMBERWOLVES,SACRAMENTO_KINGS,98,101,1021,3
1021,2013-03-22,2013-03-21,MILWAUKEE_BUCKS,INDIANA_PACERS,78,102,1022,24
1022,2013-03-22,2013-03-21,OKLAHOMA_CITY_THUNDER,ORLANDO_MAGIC,97,89,1023,8
1023,2013-03-22,2013-03-21,NEW_YORK_KNICKS,TORONTO_RAPTORS,99,94,1024,5
1024,2013-03-22,2013-03-21,PORTLAND_TRAIL_BLAZERS,ATLANTA_HAWKS,104,93,1025,11
1025,2013-03-22,2013-03-21,DETROIT_PISTONS,MIAMI_HEAT,89,103,1026,14
1026,2013-03-23,2013-03-22,CLEVELAND_CAVALIERS,HOUSTON_ROCKETS,78,116,1027,38
1027,2013-03-23,2013-03-22,MEMPHIS_GRIZZLIES,NEW_ORLEANS_HORNETS,83,90,1028,7
1028,2013-03-23,2013-03-22,BOSTON_CELTICS,DALLAS_MAVERICKS,94,104,1029,10
1029,2013-03-23,2013-03-22,UTAH_JAZZ,SAN_ANTONIO_SPURS,97,104,1030,7
1030,2013-03-23,2013-03-22,MINNESOTA_TIMBERWOLVES,PHOENIX_SUNS,117,86,1031,31
1031,2013-03-23,2013-03-22,WASHINGTON_WIZARDS,LOS_ANGELES_LAKERS,103,100,1032,3
1032,2013-03-23,2013-03-22,DETROIT_PISTONS,CHARLOTTE_BOBCATS,92,91,1033,1
1033,2013-03-23,2013-03-22,TORONTO_RAPTORS,NEW_YORK_KNICKS,84,110,1034,26
1034,2013-03-24,2013-03-23,INDIANA_PACERS,CHICAGO_BULLS,84,87,1035,3
1035,2013-03-24,2013-03-23,BOSTON_CELTICS,MEMPHIS_GRIZZLIES,106,110,1036,4
1036,2013-03-24,2013-03-23,SACRAMENTO_KINGS,DENVER_NUGGETS,95,101,1037,6
1037,2013-03-24,2013-03-23,WASHINGTON_WIZARDS,GOLDEN_STATE_WARRIORS,92,101,1038,9
1038,2013-03-24,2013-03-23,BROOKLYN_NETS,LOS_ANGELES_CLIPPERS,95,101,1039,6
1039,2013-03-24,2013-03-23,ATLANTA_HAWKS,MILWAUKEE_BUCKS,104,99,1040,5
1040,2013-03-24,2013-03-23,CHARLOTTE_BOBCATS,MIAMI_HEAT,77,109,1041,32
1041,2013-03-24,2013-03-23,SAN_ANTONIO_SPURS,HOUSTON_ROCKETS,95,96,1042,1
1042,2013-03-24,2013-03-23,CHICAGO_BULLS,MINNESOTA_TIMBERWOLVES,104,97,1043,7
1043,2013-03-24,2013-03-23,PORTLAND_TRAIL_BLAZERS,OKLAHOMA_CITY_THUNDER,83,103,1044,20
1044,2013-03-24,2013-03-23,UTAH_JAZZ,DALLAS_MAVERICKS,108,113,1045,5
1045,2013-03-25,2013-03-24,BROOKLYN_NETS,PHOENIX_SUNS,102,100,1046,2
1046,2013-03-25,2013-03-24,PHILADELPHIA_76ERS,SACRAMENTO_KINGS,117,103,1047,14
1047,2013-03-25,2013-03-24,ATLANTA_HAWKS,INDIANA_PACERS,94,100,1048,6
1048,2013-03-25,2013-03-24,MIAMI_HEAT,ORLANDO_MAGIC,108,94,1049,14
1049,2013-03-25,2013-03-24,MEMPHIS_GRIZZLIES,WASHINGTON_WIZARDS,94,107,1050,13
1050,2013-03-26,2013-03-25,DENVER_NUGGETS,NEW_ORLEANS_HORNETS,86,110,1051,24
1051,2013-03-26,2013-03-25,PHILADELPHIA_76ERS,UTAH_JAZZ,91,107,1052,16
1052,2013-03-26,2013-03-25,LOS_ANGELES_LAKERS,GOLDEN_STATE_WARRIORS,103,109,1053,6
1053,2013-03-26,2013-03-25,NEW_YORK_KNICKS,BOSTON_CELTICS,100,85,1054,15
1054,2013-03-26,2013-03-25,MINNESOTA_TIMBERWOLVES,DETROIT_PISTONS,105,82,1055,23
1055,2013-03-27,2013-03-26,LOS_ANGELES_CLIPPERS,DALLAS_MAVERICKS,102,109,1056,7
1056,2013-03-27,2013-03-26,ORLANDO_MAGIC,CHARLOTTE_BOBCATS,108,114,1057,6
1057,2013-03-27,2013-03-26,BOSTON_CELTICS,CLEVELAND_CAVALIERS,93,92,1058,1
1058,2013-03-27,2013-03-26,MILWAUKEE_BUCKS,PHILADELPHIA_76ERS,92,100,1059,8
1059,2013-03-27,2013-03-26,ATLANTA_HAWKS,TORONTO_RAPTORS,107,88,1060,19
1060,2013-03-27,2013-03-26,MEMPHIS_GRIZZLIES,NEW_YORK_KNICKS,101,108,1061,7
1061,2013-03-28,2013-03-27,MIAMI_HEAT,CHICAGO_BULLS,97,101,1062,4
1062,2013-03-28,2013-03-27,INDIANA_PACERS,HOUSTON_ROCKETS,100,91,1063,9
1063,2013-03-28,2013-03-27,LOS_ANGELES_LAKERS,MINNESOTA_TIMBERWOLVES,120,117,1064,3
1064,2013-03-28,2013-03-27,LOS_ANGELES_CLIPPERS,NEW_ORLEANS_HORNETS,105,91,1065,14
1065,2013-03-28,2013-03-27,WASHINGTON_WIZARDS,OKLAHOMA_CITY_THUNDER,80,103,1066,23
1066,2013-03-28,2013-03-27,DENVER_NUGGETS,SAN_ANTONIO_SPURS,99,100,1067,1
1067,2013-03-28,2013-03-27,PHOENIX_SUNS,UTAH_JAZZ,88,103,1068,15
1068,2013-03-28,2013-03-27,SACRAMENTO_KINGS,GOLDEN_STATE_WARRIORS,105,98,1069,7
1069,2013-03-28,2013-03-27,BROOKLYN_NETS,PORTLAND_TRAIL_BLAZERS,111,93,1070,18
1070,2013-03-29,2013-03-28,LOS_ANGELES_LAKERS,MILWAUKEE_BUCKS,103,113,1071,10
1071,2013-03-29,2013-03-28,INDIANA_PACERS,DALLAS_MAVERICKS,103,78,1072,25
1072,2013-03-29,2013-03-28,SACRAMENTO_KINGS,PHOENIX_SUNS,117,103,1073,14
1073,2013-03-29,2013-03-28,WASHINGTON_WIZARDS,ORLANDO_MAGIC,92,97,1074,5
1074,2013-03-29,2013-03-28,ATLANTA_HAWKS,BOSTON_CELTICS,107,118,1075,11
1075,2013-03-29,2013-03-28,PHILADELPHIA_76ERS,CLEVELAND_CAVALIERS,97,87,1076,10
1076,2013-03-29,2013-03-28,TORONTO_RAPTORS,DETROIT_PISTONS,99,82,1077,17
1077,2013-03-29,2013-03-28,CHARLOTTE_BOBCATS,NEW_YORK_KNICKS,102,111,1078,9
1078,2013-03-30,2013-03-29,HOUSTON_ROCKETS,MEMPHIS_GRIZZLIES,94,103,1079,9
1079,2013-03-30,2013-03-29,OKLAHOMA_CITY_THUNDER,MINNESOTA_TIMBERWOLVES,93,101,1080,8
1080,2013-03-30,2013-03-29,MIAMI_HEAT,NEW_ORLEANS_HORNETS,108,89,1081,19
1081,2013-03-30,2013-03-29,LOS_ANGELES_CLIPPERS,SAN_ANTONIO_SPURS,102,104,1082,2
1082,2013-03-30,2013-03-29,BROOKLYN_NETS,DENVER_NUGGETS,87,109,1083,22
1083,2013-03-30,2013-03-29,UTAH_JAZZ,PORTLAND_TRAIL_BLAZERS,105,95,1084,10
1084,2013-03-30,2013-03-29,CHICAGO_BULLS,DALLAS_MAVERICKS,98,100,1085,2
1085,2013-03-30,2013-03-29,ORLANDO_MAGIC,ATLANTA_HAWKS,88,97,1086,9
1086,2013-03-31,2013-03-30,LOS_ANGELES_CLIPPERS,HOUSTON_ROCKETS,81,98,1087,17
1087,2013-03-31,2013-03-30,MEMPHIS_GRIZZLIES,MINNESOTA_TIMBERWOLVES,99,86,1088,13
1088,2013-03-31,2013-03-30,CHARLOTTE_BOBCATS,PHILADELPHIA_76ERS,92,100,1089,8
1089,2013-03-31,2013-03-30,OKLAHOMA_CITY_THUNDER,MILWAUKEE_BUCKS,109,99,1090,10
1090,2013-03-31,2013-03-30,BROOKLYN_NETS,UTAH_JAZZ,107,116,1091,9
1091,2013-03-31,2013-03-30,INDIANA_PACERS,PHOENIX_SUNS,112,104,1092,8
1092,2013-03-31,2013-03-30,LOS_ANGELES_LAKERS,SACRAMENTO_KINGS,103,98,1093,5
1093,2013-03-31,2013-03-30,PORTLAND_TRAIL_BLAZERS,GOLDEN_STATE_WARRIORS,98,125,1094,27
1094,2013-03-31,2013-03-30,CLEVELAND_CAVALIERS,NEW_ORLEANS_HORNETS,92,112,1095,20
1095,2013-03-31,2013-03-30,TORONTO_RAPTORS,WASHINGTON_WIZARDS,92,109,1096,17
1096,2013-03-31,2013-03-30,DETROIT_PISTONS,CHICAGO_BULLS,94,95,1097,1
1097,2013-03-31,2013-03-30,MIAMI_HEAT,SAN_ANTONIO_SPURS,88,86,1098,2
1098,2013-03-31,2013-03-30,BOSTON_CELTICS,NEW_YORK_KNICKS,89,108,1099,19
1099,2013-04-01,2013-03-31,DETROIT_PISTONS,TORONTO_RAPTORS,108,98,1100,10
1100,2013-04-01,2013-03-31,CLEVELAND_CAVALIERS,ATLANTA_HAWKS,94,102,1101,8
1101,2013-04-02,2013-04-01,ORLANDO_MAGIC,HOUSTON_ROCKETS,103,111,1102,8
1102,2013-04-02,2013-04-01,SAN_ANTONIO_SPURS,MEMPHIS_GRIZZLIES,90,92,1103,2
1103,2013-04-02,2013-04-01,CHARLOTTE_BOBCATS,MILWAUKEE_BUCKS,102,131,1104,29
1104,2013-04-02,2013-04-01,BOSTON_CELTICS,MINNESOTA_TIMBERWOLVES,100,110,1105,10
1105,2013-04-02,2013-04-01,PORTLAND_TRAIL_BLAZERS,UTAH_JAZZ,102,112,1106,10
1106,2013-04-02,2013-04-01,INDIANA_PACERS,LOS_ANGELES_CLIPPERS,109,106,1107,3
1107,2013-04-02,2013-04-01,CHICAGO_BULLS,WASHINGTON_WIZARDS,86,90,1108,4
1108,2013-04-03,2013-04-02,NEW_YORK_KNICKS,MIAMI_HEAT,102,90,1109,12
1109,2013-04-03,2013-04-02,DALLAS_MAVERICKS,LOS_ANGELES_LAKERS,81,101,1110,20
1110,2013-04-03,2013-04-02,NEW_YORK_KNICKS,ATLANTA_HAWKS,95,82,1111,13
1111,2013-04-03,2013-04-02,PHILADELPHIA_76ERS,CHARLOTTE_BOBCATS,83,88,1112,5
1112,2013-04-03,2013-04-02,BROOKLYN_NETS,CLEVELAND_CAVALIERS,113,95,1113,18
1113,2013-04-03,2013-04-02,WASHINGTON_WIZARDS,TORONTO_RAPTORS,78,88,1114,10
1114,2013-04-03,2013-04-02,DETROIT_PISTONS,BOSTON_CELTICS,93,98,1115,5
1115,2013-04-04,2013-04-03,MINNESOTA_TIMBERWOLVES,MILWAUKEE_BUCKS,107,98,1116,9
1116,2013-04-04,2013-04-03,ORLANDO_MAGIC,SAN_ANTONIO_SPURS,84,98,1117,14
1117,2013-04-04,2013-04-03,DENVER_NUGGETS,UTAH_JAZZ,113,96,1118,17
1118,2013-04-04,2013-04-03,MEMPHIS_GRIZZLIES,PORTLAND_TRAIL_BLAZERS,94,76,1119,18
1119,2013-04-04,2013-04-03,HOUSTON_ROCKETS,SACRAMENTO_KINGS,112,102,1120,10
1120,2013-04-04,2013-04-03,NEW_ORLEANS_HORNETS,GOLDEN_STATE_WARRIORS,88,98,1121,10
1121,2013-04-04,2013-04-03,PHOENIX_SUNS,LOS_ANGELES_CLIPPERS,101,126,1122,25
1122,2013-04-04,2013-04-03,CHICAGO_BULLS,BROOKLYN_NETS,92,90,1123,2
1123,2013-04-05,2013-04-04,DALLAS_MAVERICKS,DENVER_NUGGETS,94,95,1124,1
1124,2013-04-05,2013-04-04,SAN_ANTONIO_SPURS,OKLAHOMA_CITY_THUNDER,88,100,1125,12
1125,2013-04-05,2013-04-04,PHILADELPHIA_76ERS,ATLANTA_HAWKS,101,90,1126,11
1126,2013-04-05,2013-04-04,CLEVELAND_CAVALIERS,BOSTON_CELTICS,97,91,1127,6
1127,2013-04-05,2013-04-04,MILWAUKEE_BUCKS,NEW_YORK_KNICKS,83,101,1128,18
1128,2013-04-06,2013-04-05,MIAMI_HEAT,CHARLOTTE_BOBCATS,89,79,1129,10
1129,2013-04-06,2013-04-05,ORLANDO_MAGIC,CHICAGO_BULLS,86,87,1130,1
1130,2013-04-06,2013-04-05,OKLAHOMA_CITY_THUNDER,INDIANA_PACERS,97,75,1131,22
1131,2013-04-06,2013-04-05,TORONTO_RAPTORS,MINNESOTA_TIMBERWOLVES,95,93,1132,2
1132,2013-04-06,2013-04-05,NEW_ORLEANS_HORNETS,UTAH_JAZZ,83,95,1133,12
1133,2013-04-06,2013-04-05,GOLDEN_STATE_WARRIORS,PHOENIX_SUNS,111,107,1134,4
1134,2013-04-06,2013-04-05,DALLAS_MAVERICKS,SACRAMENTO_KINGS,117,108,1135,9
1135,2013-04-06,2013-04-05,MEMPHIS_GRIZZLIES,LOS_ANGELES_LAKERS,84,86,1136,2
1136,2013-04-06,2013-04-05,HOUSTON_ROCKETS,PORTLAND_TRAIL_BLAZERS,116,98,1137,18
1137,2013-04-06,2013-04-05,INDIANA_PACERS,WASHINGTON_WIZARDS,85,104,1138,19
1138,2013-04-06,2013-04-05,CHARLOTTE_BOBCATS,BROOKLYN_NETS,96,105,1139,9
1139,2013-04-06,2013-04-05,PHILADELPHIA_76ERS,MIAMI_HEAT,87,106,1140,19
1140,2013-04-07,2013-04-06,DETROIT_PISTONS,MINNESOTA_TIMBERWOLVES,101,107,1141,6
1141,2013-04-07,2013-04-06,TORONTO_RAPTORS,MILWAUKEE_BUCKS,83,100,1142,17
1142,2013-04-07,2013-04-06,ATLANTA_HAWKS,SAN_ANTONIO_SPURS,97,99,1143,2
1143,2013-04-07,2013-04-06,HOUSTON_ROCKETS,DENVER_NUGGETS,114,132,1144,18
1144,2013-04-07,2013-04-06,NEW_YORK_KNICKS,OKLAHOMA_CITY_THUNDER,125,120,1145,5
1145,2013-04-07,2013-04-06,LOS_ANGELES_LAKERS,LOS_ANGELES_CLIPPERS,95,109,1146,14
1146,2013-04-07,2013-04-06,WASHINGTON_WIZARDS,BOSTON_CELTICS,96,107,1147,11
1147,2013-04-07,2013-04-06,ORLANDO_MAGIC,CLEVELAND_CAVALIERS,85,91,1148,6
1148,2013-04-07,2013-04-06,MEMPHIS_GRIZZLIES,SACRAMENTO_KINGS,89,87,1149,2
1149,2013-04-07,2013-04-06,CHICAGO_BULLS,DETROIT_PISTONS,85,99,1150,14
1150,2013-04-08,2013-04-07,UTAH_JAZZ,GOLDEN_STATE_WARRIORS,97,90,1151,7
1151,2013-04-08,2013-04-07,NEW_ORLEANS_HORNETS,PHOENIX_SUNS,95,92,1152,3
1152,2013-04-08,2013-04-07,DALLAS_MAVERICKS,PORTLAND_TRAIL_BLAZERS,96,91,1153,5
1153,2013-04-09,2013-04-08,CLEVELAND_CAVALIERS,INDIANA_PACERS,94,99,1154,5
1154,2013-04-09,2013-04-08,PHILADELPHIA_76ERS,BROOKLYN_NETS,83,104,1155,21
1155,2013-04-09,2013-04-08,MILWAUKEE_BUCKS,MIAMI_HEAT,83,94,1156,11
1156,2013-04-09,2013-04-08,WASHINGTON_WIZARDS,NEW_YORK_KNICKS,99,120,1157,21
1157,2013-04-10,2013-04-09,TORONTO_RAPTORS,CHICAGO_BULLS,101,98,1158,3
1158,2013-04-10,2013-04-09,PHOENIX_SUNS,HOUSTON_ROCKETS,98,101,1159,3
1159,2013-04-10,2013-04-09,CHARLOTTE_BOBCATS,MEMPHIS_GRIZZLIES,75,94,1160,19
1160,2013-04-10,2013-04-09,OKLAHOMA_CITY_THUNDER,UTAH_JAZZ,90,80,1161,10
1161,2013-04-10,2013-04-09,MINNESOTA_TIMBERWOLVES,GOLDEN_STATE_WARRIORS,89,105,1162,16
1162,2013-04-10,2013-04-09,NEW_ORLEANS_HORNETS,LOS_ANGELES_LAKERS,96,104,1163,8
1163,2013-04-10,2013-04-09,DETROIT_PISTONS,CLEVELAND_CAVALIERS,111,104,1164,7
1164,2013-04-10,2013-04-09,MILWAUKEE_BUCKS,ORLANDO_MAGIC,103,113,1165,10
1165,2013-04-10,2013-04-09,ATLANTA_HAWKS,PHILADELPHIA_76ERS,124,101,1166,23
1166,2013-04-10,2013-04-09,MIAMI_HEAT,WASHINGTON_WIZARDS,103,98,1167,5
1167,2013-04-11,2013-04-10,BROOKLYN_NETS,BOSTON_CELTICS,101,93,1168,8
1168,2013-04-11,2013-04-10,PHOENIX_SUNS,DALLAS_MAVERICKS,102,91,1169,11
1169,2013-04-11,2013-04-10,LOS_ANGELES_LAKERS,PORTLAND_TRAIL_BLAZERS,113,106,1170,7
1170,2013-04-11,2013-04-10,NEW_ORLEANS_HORNETS,SACRAMENTO_KINGS,110,121,1171,11
1171,2013-04-11,2013-04-10,SAN_ANTONIO_SPURS,DENVER_NUGGETS,86,96,1172,10
1172,2013-04-11,2013-04-10,MINNESOTA_TIMBERWOLVES,LOS_ANGELES_CLIPPERS,95,111,1173,16
1173,2013-04-12,2013-04-11,NEW_YORK_KNICKS,CHICAGO_BULLS,111,118,1174,7
1174,2013-04-12,2013-04-11,OKLAHOMA_CITY_THUNDER,GOLDEN_STATE_WARRIORS,116,97,1175,19
1175,2013-04-12,2013-04-11,BROOKLYN_NETS,INDIANA_PACERS,117,109,1176,8
1176,2013-04-12,2013-04-11,CHICAGO_BULLS,TORONTO_RAPTORS,88,97,1177,9
1177,2013-04-12,2013-04-11,PHILADELPHIA_76ERS,WASHINGTON_WIZARDS,97,86,1178,11
1178,2013-04-12,2013-04-11,MILWAUKEE_BUCKS,ATLANTA_HAWKS,104,109,1179,5
1179,2013-04-12,2013-04-11,NEW_YORK_KNICKS,CLEVELAND_CAVALIERS,101,91,1180,10
1180,2013-04-12,2013-04-11,CHARLOTTE_BOBCATS,DETROIT_PISTONS,93,113,1181,20
1181,2013-04-12,2013-04-11,BOSTON_CELTICS,MIAMI_HEAT,101,109,1182,8
1182,2013-04-13,2013-04-12,MEMPHIS_GRIZZLIES,HOUSTON_ROCKETS,82,78,1183,4
1183,2013-04-13,2013-04-12,LOS_ANGELES_CLIPPERS,NEW_ORLEANS_HORNETS,96,93,1184,3
1184,2013-04-13,2013-04-12,DENVER_NUGGETS,DALLAS_MAVERICKS,105,108,1185,3
1185,2013-04-13,2013-04-12,SACRAMENTO_KINGS,SAN_ANTONIO_SPURS,101,108,1186,7
1186,2013-04-13,2013-04-12,MINNESOTA_TIMBERWOLVES,UTAH_JAZZ,100,107,1187,7
1187,2013-04-13,2013-04-12,OKLAHOMA_CITY_THUNDER,PORTLAND_TRAIL_BLAZERS,106,90,1188,16
1188,2013-04-13,2013-04-12,GOLDEN_STATE_WARRIORS,LOS_ANGELES_LAKERS,116,118,1189,2
1189,2013-04-13,2013-04-12,MILWAUKEE_BUCKS,CHARLOTTE_BOBCATS,85,95,1190,10
1190,2013-04-13,2013-04-12,BOSTON_CELTICS,ORLANDO_MAGIC,120,88,1191,32
1191,2013-04-14,2013-04-13,LOS_ANGELES_CLIPPERS,MEMPHIS_GRIZZLIES,91,87,1192,4
1192,2013-04-14,2013-04-13,PHOENIX_SUNS,MINNESOTA_TIMBERWOLVES,93,105,1193,12
1193,2013-04-14,2013-04-13,CHICAGO_BULLS,MIAMI_HEAT,93,105,1194,12
1194,2013-04-14,2013-04-13,INDIANA_PACERS,NEW_YORK_KNICKS,80,90,1195,10
1195,2013-04-14,2013-04-13,CLEVELAND_CAVALIERS,PHILADELPHIA_76ERS,77,91,1196,14
1196,2013-04-14,2013-04-13,BROOKLYN_NETS,TORONTO_RAPTORS,87,93,1197,6
1197,2013-04-14,2013-04-13,PORTLAND_TRAIL_BLAZERS,DENVER_NUGGETS,109,118,1198,9
1198,2013-04-14,2013-04-13,DALLAS_MAVERICKS,NEW_ORLEANS_HORNETS,107,89,1199,18
1199,2013-04-14,2013-04-13,SACRAMENTO_KINGS,HOUSTON_ROCKETS,100,121,1200,21
1200,2013-04-15,2013-04-14,SAN_ANTONIO_SPURS,LOS_ANGELES_LAKERS,86,91,1201,5
1201,2013-04-15,2013-04-14,NEW_YORK_KNICKS,CHARLOTTE_BOBCATS,95,106,1202,11
1202,2013-04-15,2013-04-14,MIAMI_HEAT,CLEVELAND_CAVALIERS,96,95,1203,1
1203,2013-04-15,2013-04-14,CHICAGO_BULLS,ORLANDO_MAGIC,102,84,1204,18
1204,2013-04-15,2013-04-14,WASHINGTON_WIZARDS,BROOKLYN_NETS,101,106,1205,5
1205,2013-04-15,2013-04-14,PHILADELPHIA_76ERS,DETROIT_PISTONS,101,109,1206,8
1206,2013-04-16,2013-04-15,MEMPHIS_GRIZZLIES,DALLAS_MAVERICKS,103,97,1207,6
1207,2013-04-16,2013-04-15,DENVER_NUGGETS,MILWAUKEE_BUCKS,112,111,1208,1
1208,2013-04-16,2013-04-15,UTAH_JAZZ,MINNESOTA_TIMBERWOLVES,96,80,1209,16
1209,2013-04-16,2013-04-15,SACRAMENTO_KINGS,OKLAHOMA_CITY_THUNDER,95,104,1210,9
1210,2013-04-16,2013-04-15,HOUSTON_ROCKETS,PHOENIX_SUNS,112,119,1211,7
1211,2013-04-16,2013-04-15,SAN_ANTONIO_SPURS,GOLDEN_STATE_WARRIORS,106,116,1212,10
1212,2013-04-17,2013-04-16,TORONTO_RAPTORS,ATLANTA_HAWKS,113,96,1213,17
1213,2013-04-17,2013-04-16,PORTLAND_TRAIL_BLAZERS,LOS_ANGELES_CLIPPERS,77,93,1214,16
1214,2013-04-18,2013-04-17,DETROIT_PISTONS,BROOKLYN_NETS,99,103,1215,4
1215,2013-04-18,2013-04-17,CLEVELAND_CAVALIERS,CHARLOTTE_BOBCATS,98,105,1216,7
1216,2013-04-18,2013-04-17,WASHINGTON_WIZARDS,CHICAGO_BULLS,92,95,1217,3
1217,2013-04-18,2013-04-17,NEW_ORLEANS_HORNETS,DALLAS_MAVERICKS,87,99,1218,12
1218,2013-04-18,2013-04-17,PHOENIX_SUNS,DENVER_NUGGETS,98,118,1219,20
1219,2013-04-18,2013-04-17,PHILADELPHIA_76ERS,INDIANA_PACERS,105,95,1220,10
1220,2013-04-18,2013-04-17,UTAH_JAZZ,MEMPHIS_GRIZZLIES,70,86,1221,16
1221,2013-04-18,2013-04-17,ORLANDO_MAGIC,MIAMI_HEAT,93,105,1222,12
1222,2013-04-18,2013-04-17,ATLANTA_HAWKS,NEW_YORK_KNICKS,92,98,1223,6
1223,2013-04-18,2013-04-17,MILWAUKEE_BUCKS,OKLAHOMA_CITY_THUNDER,95,89,1224,6
1224,2013-04-18,2013-04-17,MINNESOTA_TIMBERWOLVES,SAN_ANTONIO_SPURS,108,95,1225,13
1225,2013-04-18,2013-04-17,BOSTON_CELTICS,TORONTO_RAPTORS,90,114,1226,24
1226,2013-04-18,2013-04-17,HOUSTON_ROCKETS,LOS_ANGELES_LAKERS,95,99,1227,4
1227,2013-04-18,2013-04-17,GOLDEN_STATE_WARRIORS,PORTLAND_TRAIL_BLAZERS,99,88,1228,11
1228,2013-04-18,2013-04-17,LOS_ANGELES_CLIPPERS,SACRAMENTO_KINGS,112,108,1229,4
1229,2013-04-20,2013-04-19,BOSTON_CELTICS,NEW_YORK_KNICKS,78,85,1230,7
1230,2013-04-20,2013-04-19,GOLDEN_STATE_WARRIORS,DENVER_NUGGETS,95,97,1231,2
1231,2013-04-21,2013-04-20,CHICAGO_BULLS,BROOKLYN_NETS,89,106,1232,17
1232,2013-04-20,2013-04-19,MEMPHIS_GRIZZLIES,LOS_ANGELES_CLIPPERS,91,112,1233,21
1233,2013-04-21,2013-04-20,ATLANTA_HAWKS,INDIANA_PACERS,90,107,1234,17
1234,2013-04-21,2013-04-20,LOS_ANGELES_LAKERS,SAN_ANTONIO_SPURS,79,91,1235,12
1235,2013-04-21,2013-04-20,MILWAUKEE_BUCKS,MIAMI_HEAT,87,110,1236,23
1236,2013-04-22,2013-04-21,HOUSTON_ROCKETS,OKLAHOMA_CITY_THUNDER,91,120,1237,29
1237,2013-04-23,2013-04-22,CHICAGO_BULLS,BROOKLYN_NETS,90,82,1238,8
1238,2013-04-22,2013-04-21,MEMPHIS_GRIZZLIES,LOS_ANGELES_CLIPPERS,91,93,1239,2
1239,2013-04-23,2013-04-22,MILWAUKEE_BUCKS,MIAMI_HEAT,86,98,1240,12
1240,2013-04-24,2013-04-23,BOSTON_CELTICS,NEW_YORK_KNICKS,71,87,1241,16
1241,2013-04-23,2013-04-22,GOLDEN_STATE_WARRIORS,DENVER_NUGGETS,131,117,1242,14
1242,2013-04-24,2013-04-23,ATLANTA_HAWKS,INDIANA_PACERS,98,113,1243,15
1243,2013-04-25,2013-04-24,HOUSTON_ROCKETS,OKLAHOMA_CITY_THUNDER,102,105,1244,3
1244,2013-04-25,2013-04-24,LOS_ANGELES_LAKERS,SAN_ANTONIO_SPURS,91,102,1245,11
1245,2013-04-26,2013-04-25,MIAMI_HEAT,MILWAUKEE_BUCKS,104,91,1246,13
1246,2013-04-26,2013-04-25,BROOKLYN_NETS,CHICAGO_BULLS,76,79,1247,3
1247,2013-04-26,2013-04-25,LOS_ANGELES_CLIPPERS,MEMPHIS_GRIZZLIES,82,94,1248,12
1248,2013-04-27,2013-04-26,NEW_YORK_KNICKS,BOSTON_CELTICS,90,76,1249,14
1249,2013-04-26,2013-04-25,DENVER_NUGGETS,GOLDEN_STATE_WARRIORS,108,110,1250,2
1250,2013-04-26,2013-04-25,SAN_ANTONIO_SPURS,LOS_ANGELES_LAKERS,120,89,1251,31
1251,2013-04-27,2013-04-26,BROOKLYN_NETS,CHICAGO_BULLS,134,142,1252,8
1252,2013-04-27,2013-04-26,LOS_ANGELES_CLIPPERS,MEMPHIS_GRIZZLIES,83,104,1253,21
1253,2013-04-27,2013-04-26,INDIANA_PACERS,ATLANTA_HAWKS,69,90,1254,21
1254,2013-04-28,2013-04-27,OKLAHOMA_CITY_THUNDER,HOUSTON_ROCKETS,104,101,1255,3
1255,2013-04-28,2013-04-27,NEW_YORK_KNICKS,BOSTON_CELTICS,90,97,1256,7
1256,2013-04-28,2013-04-27,MIAMI_HEAT,MILWAUKEE_BUCKS,88,77,1257,11
1257,2013-04-29,2013-04-28,SAN_ANTONIO_SPURS,LOS_ANGELES_LAKERS,103,82,1258,21
1258,2013-04-28,2013-04-27,DENVER_NUGGETS,GOLDEN_STATE_WARRIORS,101,115,1259,14
1259,2013-04-29,2013-04-28,CHICAGO_BULLS,BROOKLYN_NETS,91,110,1260,19
1260,2013-04-29,2013-04-28,INDIANA_PACERS,ATLANTA_HAWKS,91,102,1261,11
1261,2013-04-30,2013-04-29,OKLAHOMA_CITY_THUNDER,HOUSTON_ROCKETS,103,105,1262,2
1262,2013-05-01,2013-04-30,GOLDEN_STATE_WARRIORS,DENVER_NUGGETS,100,107,1263,7
1263,2013-04-30,2013-04-29,MEMPHIS_GRIZZLIES,LOS_ANGELES_CLIPPERS,103,93,1264,10
1264,2013-05-01,2013-04-30,BOSTON_CELTICS,NEW_YORK_KNICKS,92,86,1265,6
1265,2013-05-02,2013-05-01,ATLANTA_HAWKS,INDIANA_PACERS,83,106,1266,23
1266,2013-05-02,2013-05-01,HOUSTON_ROCKETS,OKLAHOMA_CITY_THUNDER,107,100,1267,7
1267,2013-05-03,2013-05-02,BROOKLYN_NETS,CHICAGO_BULLS,95,92,1268,3
1268,2013-05-02,2013-05-01,DENVER_NUGGETS,GOLDEN_STATE_WARRIORS,88,92,1269,4
1269,2013-05-03,2013-05-02,NEW_YORK_KNICKS,BOSTON_CELTICS,88,80,1270,8
1270,2013-05-03,2013-05-02,INDIANA_PACERS,ATLANTA_HAWKS,81,73,1271,8
1271,2013-05-04,2013-05-03,OKLAHOMA_CITY_THUNDER,HOUSTON_ROCKETS,103,94,1272,9
1272,2013-05-04,2013-05-03,LOS_ANGELES_CLIPPERS,MEMPHIS_GRIZZLIES,105,118,1273,13
1273,2013-05-05,2013-05-04,CHICAGO_BULLS,BROOKLYN_NETS,99,93,1274,6
1274,2013-05-05,2013-05-04,MEMPHIS_GRIZZLIES,OKLAHOMA_CITY_THUNDER,91,93,1275,2
1275,2013-05-05,2013-05-04,INDIANA_PACERS,NEW_YORK_KNICKS,102,95,1276,7
1276,2013-05-06,2013-05-05,CHICAGO_BULLS,MIAMI_HEAT,93,86,1277,7
1277,2013-05-07,2013-05-06,GOLDEN_STATE_WARRIORS,SAN_ANTONIO_SPURS,127,129,1278,2
1278,2013-05-07,2013-05-06,INDIANA_PACERS,NEW_YORK_KNICKS,79,105,1279,26
1279,2013-05-08,2013-05-07,MEMPHIS_GRIZZLIES,OKLAHOMA_CITY_THUNDER,99,93,1280,6
1280,2013-05-08,2013-05-07,CHICAGO_BULLS,MIAMI_HEAT,78,115,1281,37
1281,2013-05-09,2013-05-08,GOLDEN_STATE_WARRIORS,SAN_ANTONIO_SPURS,100,91,1282,9
1282,2013-05-11,2013-05-10,MIAMI_HEAT,CHICAGO_BULLS,104,94,1283,10
1283,2013-05-10,2013-05-09,SAN_ANTONIO_SPURS,GOLDEN_STATE_WARRIORS,102,92,1284,10
1284,2013-05-11,2013-05-10,OKLAHOMA_CITY_THUNDER,MEMPHIS_GRIZZLIES,81,87,1285,6
1285,2013-05-12,2013-05-11,NEW_YORK_KNICKS,INDIANA_PACERS,71,82,1286,11
1286,2013-05-12,2013-05-11,SAN_ANTONIO_SPURS,GOLDEN_STATE_WARRIORS,87,97,1287,10
1287,2013-05-14,2013-05-13,MIAMI_HEAT,CHICAGO_BULLS,88,65,1288,23
1288,2013-05-14,2013-05-13,OKLAHOMA_CITY_THUNDER,MEMPHIS_GRIZZLIES,97,103,1289,6
1289,2013-05-14,2013-05-13,NEW_YORK_KNICKS,INDIANA_PACERS,82,93,1290,11
1290,2013-05-15,2013-05-14,GOLDEN_STATE_WARRIORS,SAN_ANTONIO_SPURS,91,109,1291,18
1291,2013-05-15,2013-05-14,CHICAGO_BULLS,MIAMI_HEAT,91,94,1292,3
1292,2013-05-16,2013-05-15,MEMPHIS_GRIZZLIES,OKLAHOMA_CITY_THUNDER,88,84,1293,4
1293,2013-05-17,2013-05-16,INDIANA_PACERS,NEW_YORK_KNICKS,75,85,1294,10
1294,2013-05-16,2013-05-15,SAN_ANTONIO_SPURS,GOLDEN_STATE_WARRIORS,94,82,1295,12
1295,2013-05-19,2013-05-18,NEW_YORK_KNICKS,INDIANA_PACERS,99,106,1296,7
1296,2013-05-19,2013-05-18,MEMPHIS_GRIZZLIES,SAN_ANTONIO_SPURS,83,105,1297,22
1297,2013-05-22,2013-05-21,MEMPHIS_GRIZZLIES,SAN_ANTONIO_SPURS,89,93,1298,4
1298,2013-05-23,2013-05-22,INDIANA_PACERS,MIAMI_HEAT,102,103,1299,1
1299,2013-05-25,2013-05-24,INDIANA_PACERS,MIAMI_HEAT,97,93,1300,4
1300,2013-05-26,2013-05-25,SAN_ANTONIO_SPURS,MEMPHIS_GRIZZLIES,104,93,1301,11
1301,2013-05-27,2013-05-26,MIAMI_HEAT,INDIANA_PACERS,114,96,1302,18
1302,2013-05-28,2013-05-27,SAN_ANTONIO_SPURS,MEMPHIS_GRIZZLIES,93,86,1303,7
1303,2013-05-29,2013-05-28,MIAMI_HEAT,INDIANA_PACERS,92,99,1304,7
1304,2013-05-31,2013-05-30,INDIANA_PACERS,MIAMI_HEAT,79,90,1305,11
1305,2013-06-02,2013-06-01,MIAMI_HEAT,INDIANA_PACERS,77,91,1306,14
1306,2013-06-04,2013-06-03,INDIANA_PACERS,MIAMI_HEAT,76,99,1307,23
1307,2013-06-07,2013-06-06,SAN_ANTONIO_SPURS,MIAMI_HEAT,92,88,1308,4
1308,2013-06-10,2013-06-09,SAN_ANTONIO_SPURS,MIAMI_HEAT,84,103,1309,19
1309,2013-06-12,2013-06-11,MIAMI_HEAT,SAN_ANTONIO_SPURS,77,113,1310,36
1310,2013-06-14,2013-06-13,MIAMI_HEAT,SAN_ANTONIO_SPURS,109,93,1311,16
1311,2013-06-17,2013-06-16,MIAMI_HEAT,SAN_ANTONIO_SPURS,104,114,1312,10
1312,2013-06-19,2013-06-18,SAN_ANTONIO_SPURS,MIAMI_HEAT,100,103,1313,3
1313,2013-06-21,2013-06-20,SAN_ANTONIO_SPURS,MIAMI_HEAT,88,95,1314,7
1314,2013-10-29,2013-10-28,ORLANDO_MAGIC,INDIANA_PACERS,87,97,1315,10
1315,2013-10-30,2013-10-29,CHICAGO_BULLS,MIAMI_HEAT,95,107,1316,12
1316,2013-10-30,2013-10-29,LOS_ANGELES_CLIPPERS,LOS_ANGELES_LAKERS,103,116,1317,13
1317,2013-10-30,2013-10-29,BROOKLYN_NETS,CLEVELAND_CAVALIERS,94,98,1318,4
1318,2013-10-30,2013-10-29,BOSTON_CELTICS,TORONTO_RAPTORS,87,93,1319,6
1319,2013-10-30,2013-10-29,MIAMI_HEAT,PHILADELPHIA_76ERS,110,114,1320,4
1320,2013-10-30,2013-10-29,WASHINGTON_WIZARDS,DETROIT_PISTONS,102,113,1321,11
1321,2013-10-30,2013-10-29,MILWAUKEE_BUCKS,NEW_YORK_KNICKS,83,90,1322,7
1322,2013-10-31,2013-10-30,INDIANA_PACERS,NEW_ORLEANS_PELICANS,95,90,1323,5
1323,2013-10-31,2013-10-30,ORLANDO_MAGIC,MINNESOTA_TIMBERWOLVES,115,120,1324,5
1324,2013-10-31,2013-10-30,CHARLOTTE_BOBCATS,HOUSTON_ROCKETS,83,96,1325,13
1325,2013-10-31,2013-10-30,ATLANTA_HAWKS,DALLAS_MAVERICKS,109,118,1326,9
1326,2013-10-31,2013-10-30,MEMPHIS_GRIZZLIES,SAN_ANTONIO_SPURS,94,101,1327,7
1327,2013-10-31,2013-10-30,OKLAHOMA_CITY_THUNDER,UTAH_JAZZ,101,98,1328,3
1328,2013-10-31,2013-10-30,DENVER_NUGGETS,SACRAMENTO_KINGS,88,90,1329,2
1329,2013-10-31,2013-10-30,PORTLAND_TRAIL_BLAZERS,PHOENIX_SUNS,91,104,1330,13
1330,2013-10-31,2013-10-30,LOS_ANGELES_LAKERS,GOLDEN_STATE_WARRIORS,94,125,1331,31
1331,2013-11-01,2013-10-31,NEW_YORK_KNICKS,CHICAGO_BULLS,81,82,1332,1
1332,2013-11-01,2013-10-31,GOLDEN_STATE_WARRIORS,LOS_ANGELES_CLIPPERS,115,126,1333,11
1333,2013-11-01,2013-10-31,CLEVELAND_CAVALIERS,CHARLOTTE_BOBCATS,84,90,1334,6
1334,2013-11-01,2013-10-31,NEW_ORLEANS_PELICANS,ORLANDO_MAGIC,90,110,1335,20
1335,2013-11-01,2013-10-31,PHILADELPHIA_76ERS,WASHINGTON_WIZARDS,109,102,1336,7
1336,2013-11-01,2013-10-31,TORONTO_RAPTORS,ATLANTA_HAWKS,95,102,1337,7
1337,2013-11-01,2013-10-31,MILWAUKEE_BUCKS,BOSTON_CELTICS,105,98,1338,7
1338,2013-11-02,2013-11-01,MIAMI_HEAT,BROOKLYN_NETS,100,101,1339,1
1339,2013-11-02,2013-11-01,DALLAS_MAVERICKS,HOUSTON_ROCKETS,105,113,1340,8
1340,2013-11-02,2013-11-01,DETROIT_PISTONS,MEMPHIS_GRIZZLIES,108,111,1341,3
1341,2013-11-02,2013-11-01,OKLAHOMA_CITY_THUNDER,MINNESOTA_TIMBERWOLVES,81,100,1342,19
1342,2013-11-02,2013-11-01,PORTLAND_TRAIL_BLAZERS,DENVER_NUGGETS,113,98,1343,15
1343,2013-11-02,2013-11-01,UTAH_JAZZ,PHOENIX_SUNS,84,87,1344,3
1344,2013-11-02,2013-11-01,LOS_ANGELES_CLIPPERS,SACRAMENTO_KINGS,110,101,1345,9
1345,2013-11-02,2013-11-01,SAN_ANTONIO_SPURS,LOS_ANGELES_LAKERS,91,85,1346,6
1346,2013-11-02,2013-11-01,CLEVELAND_CAVALIERS,INDIANA_PACERS,74,89,1347,15
1347,2013-11-02,2013-11-01,CHICAGO_BULLS,PHILADELPHIA_76ERS,104,107,1348,3
1348,2013-11-03,2013-11-02,CHARLOTTE_BOBCATS,NEW_ORLEANS_PELICANS,84,105,1349,21
1349,2013-11-03,2013-11-02,MEMPHIS_GRIZZLIES,DALLAS_MAVERICKS,99,111,1350,12
1350,2013-11-03,2013-11-02,TORONTO_RAPTORS,MILWAUKEE_BUCKS,97,90,1351,7
1351,2013-11-03,2013-11-02,HOUSTON_ROCKETS,UTAH_JAZZ,104,93,1352,11
1352,2013-11-03,2013-11-02,SAN_ANTONIO_SPURS,PORTLAND_TRAIL_BLAZERS,105,115,1353,10
1353,2013-11-03,2013-11-02,SACRAMENTO_KINGS,GOLDEN_STATE_WARRIORS,87,98,1354,11
1354,2013-11-03,2013-11-02,BOSTON_CELTICS,DETROIT_PISTONS,77,87,1355,10
1355,2013-11-03,2013-11-02,WASHINGTON_WIZARDS,MIAMI_HEAT,93,103,1356,10
1356,2013-11-03,2013-11-02,BROOKLYN_NETS,ORLANDO_MAGIC,86,107,1357,21
1357,2013-11-04,2013-11-03,PHOENIX_SUNS,OKLAHOMA_CITY_THUNDER,96,103,1358,7
1358,2013-11-04,2013-11-03,MINNESOTA_TIMBERWOLVES,NEW_YORK_KNICKS,109,100,1359,9
1359,2013-11-04,2013-11-03,ATLANTA_HAWKS,LOS_ANGELES_LAKERS,103,105,1360,2
1360,2013-11-05,2013-11-04,MINNESOTA_TIMBERWOLVES,CLEVELAND_CAVALIERS,92,93,1361,1
1361,2013-11-05,2013-11-04,GOLDEN_STATE_WARRIORS,PHILADELPHIA_76ERS,110,90,1362,20
1362,2013-11-05,2013-11-04,BOSTON_CELTICS,MEMPHIS_GRIZZLIES,88,95,1363,7
1363,2013-11-05,2013-11-04,HOUSTON_ROCKETS,LOS_ANGELES_CLIPPERS,118,137,1364,19
1364,2013-11-06,2013-11-05,MIAMI_HEAT,TORONTO_RAPTORS,104,95,1365,9
1365,2013-11-06,2013-11-05,UTAH_JAZZ,BROOKLYN_NETS,88,104,1366,16
1366,2013-11-06,2013-11-05,INDIANA_PACERS,DETROIT_PISTONS,99,91,1367,8
1367,2013-11-06,2013-11-05,CHARLOTTE_BOBCATS,NEW_YORK_KNICKS,102,97,1368,5
1368,2013-11-06,2013-11-05,PHOENIX_SUNS,NEW_ORLEANS_PELICANS,104,98,1369,6
1369,2013-11-06,2013-11-05,LOS_ANGELES_LAKERS,DALLAS_MAVERICKS,104,123,1370,19
1370,2013-11-06,2013-11-05,SAN_ANTONIO_SPURS,DENVER_NUGGETS,102,94,1371,8
1371,2013-11-06,2013-11-05,HOUSTON_ROCKETS,PORTLAND_TRAIL_BLAZERS,116,101,1372,15
1372,2013-11-06,2013-11-05,ATLANTA_HAWKS,SACRAMENTO_KINGS,105,100,1373,5
1373,2013-11-07,2013-11-06,TORONTO_RAPTORS,CHARLOTTE_BOBCATS,90,92,1374,2
1374,2013-11-07,2013-11-06,CHICAGO_BULLS,INDIANA_PACERS,80,97,1375,17
1375,2013-11-07,2013-11-06,LOS_ANGELES_CLIPPERS,ORLANDO_MAGIC,90,98,1376,8
1376,2013-11-07,2013-11-06,WASHINGTON_WIZARDS,PHILADELPHIA_76ERS,116,102,1377,14
1377,2013-11-07,2013-11-06,UTAH_JAZZ,BOSTON_CELTICS,87,97,1378,10
1378,2013-11-07,2013-11-06,NEW_ORLEANS_PELICANS,MEMPHIS_GRIZZLIES,99,84,1379,15
1379,2013-11-07,2013-11-06,CLEVELAND_CAVALIERS,MILWAUKEE_BUCKS,104,109,1380,5
1380,2013-11-07,2013-11-06,GOLDEN_STATE_WARRIORS,MINNESOTA_TIMBERWOLVES,106,93,1381,13
1381,2013-11-07,2013-11-06,PHOENIX_SUNS,SAN_ANTONIO_SPURS,96,99,1382,3
1382,2013-11-07,2013-11-06,DALLAS_MAVERICKS,OKLAHOMA_CITY_THUNDER,93,107,1383,14
1383,2013-11-08,2013-11-07,LOS_ANGELES_CLIPPERS,MIAMI_HEAT,97,102,1384,5
1384,2013-11-08,2013-11-07,ATLANTA_HAWKS,DENVER_NUGGETS,107,109,1385,2
1385,2013-11-08,2013-11-07,LOS_ANGELES_LAKERS,HOUSTON_ROCKETS,99,98,1386,1
1386,2013-11-09,2013-11-08,NEW_YORK_KNICKS,CHARLOTTE_BOBCATS,101,91,1387,10
1387,2013-11-09,2013-11-08,TORONTO_RAPTORS,INDIANA_PACERS,84,91,1388,7
1388,2013-11-09,2013-11-08,BOSTON_CELTICS,ORLANDO_MAGIC,91,89,1389,2
1389,2013-11-09,2013-11-08,CLEVELAND_CAVALIERS,PHILADELPHIA_76ERS,79,94,1390,15
1390,2013-11-09,2013-11-08,BROOKLYN_NETS,WASHINGTON_WIZARDS,108,112,1391,4
1391,2013-11-09,2013-11-08,OKLAHOMA_CITY_THUNDER,DETROIT_PISTONS,119,110,1392,9
1392,2013-11-09,2013-11-08,UTAH_JAZZ,CHICAGO_BULLS,73,97,1393,24
1393,2013-11-09,2013-11-08,DALLAS_MAVERICKS,MINNESOTA_TIMBERWOLVES,108,116,1394,8
1394,2013-11-09,2013-11-08,LOS_ANGELES_LAKERS,NEW_ORLEANS_PELICANS,85,96,1395,11
1395,2013-11-09,2013-11-08,GOLDEN_STATE_WARRIORS,SAN_ANTONIO_SPURS,74,76,1396,2
1396,2013-11-09,2013-11-08,DENVER_NUGGETS,PHOENIX_SUNS,103,114,1397,11
1397,2013-11-09,2013-11-08,SACRAMENTO_KINGS,PORTLAND_TRAIL_BLAZERS,91,104,1398,13
1398,2013-11-10,2013-11-09,UTAH_JAZZ,TORONTO_RAPTORS,91,115,1399,24
1399,2013-11-10,2013-11-09,ORLANDO_MAGIC,ATLANTA_HAWKS,94,104,1400,10
1400,2013-11-10,2013-11-09,INDIANA_PACERS,BROOKLYN_NETS,96,91,1401,5
1401,2013-11-10,2013-11-09,PHILADELPHIA_76ERS,CLEVELAND_CAVALIERS,125,127,1402,2
1402,2013-11-10,2013-11-09,BOSTON_CELTICS,MIAMI_HEAT,111,110,1403,1
1403,2013-11-10,2013-11-09,LOS_ANGELES_CLIPPERS,HOUSTON_ROCKETS,107,94,1404,13
1404,2013-11-10,2013-11-09,GOLDEN_STATE_WARRIORS,MEMPHIS_GRIZZLIES,90,108,1405,18
1405,2013-11-10,2013-11-09,DALLAS_MAVERICKS,MILWAUKEE_BUCKS,91,83,1406,8
1406,2013-11-10,2013-11-09,PORTLAND_TRAIL_BLAZERS,SACRAMENTO_KINGS,96,85,1407,11
1407,2013-11-11,2013-11-10,WASHINGTON_WIZARDS,OKLAHOMA_CITY_THUNDER,105,106,1408,1
1408,2013-11-11,2013-11-10,NEW_ORLEANS_PELICANS,PHOENIX_SUNS,94,101,1409,7
1409,2013-11-11,2013-11-10,MINNESOTA_TIMBERWOLVES,LOS_ANGELES_LAKERS,113,90,1410,23
1410,2013-11-10,2013-11-09,SAN_ANTONIO_SPURS,NEW_YORK_KNICKS,120,89,1411,31
1411,2013-11-12,2013-11-11,ATLANTA_HAWKS,CHARLOTTE_BOBCATS,103,94,1412,9
1412,2013-11-12,2013-11-11,MEMPHIS_GRIZZLIES,INDIANA_PACERS,79,95,1413,16
1413,2013-11-12,2013-11-11,SAN_ANTONIO_SPURS,PHILADELPHIA_76ERS,109,85,1414,24
1414,2013-11-12,2013-11-11,ORLANDO_MAGIC,BOSTON_CELTICS,105,120,1415,15
1415,2013-11-12,2013-11-11,CLEVELAND_CAVALIERS,CHICAGO_BULLS,81,96,1416,15
1416,2013-11-12,2013-11-11,TORONTO_RAPTORS,HOUSTON_ROCKETS,104,110,1417,6
1417,2013-11-12,2013-11-11,DENVER_NUGGETS,UTAH_JAZZ,100,81,1418,19
1418,2013-11-12,2013-11-11,DETROIT_PISTONS,PORTLAND_TRAIL_BLAZERS,103,109,1419,6
1419,2013-11-12,2013-11-11,MINNESOTA_TIMBERWOLVES,LOS_ANGELES_CLIPPERS,107,109,1420,2
1420,2013-11-13,2013-11-12,MILWAUKEE_BUCKS,MIAMI_HEAT,95,118,1421,23
1421,2013-11-13,2013-11-12,WASHINGTON_WIZARDS,DALLAS_MAVERICKS,95,105,1422,10
1422,2013-11-13,2013-11-12,DETROIT_PISTONS,GOLDEN_STATE_WARRIORS,95,113,1423,18
1423,2013-11-13,2013-11-12,NEW_ORLEANS_PELICANS,LOS_ANGELES_LAKERS,95,116,1424,21
1424,2013-11-14,2013-11-13,MILWAUKEE_BUCKS,ORLANDO_MAGIC,91,94,1425,3
1425,2013-11-14,2013-11-13,HOUSTON_ROCKETS,PHILADELPHIA_76ERS,117,123,1426,6
1426,2013-11-14,2013-11-13,CHARLOTTE_BOBCATS,BOSTON_CELTICS,89,83,1427,6
1427,2013-11-14,2013-11-13,NEW_YORK_KNICKS,ATLANTA_HAWKS,95,91,1428,4
1428,2013-11-14,2013-11-13,TORONTO_RAPTORS,MEMPHIS_GRIZZLIES,103,87,1429,16
1429,2013-11-14,2013-11-13,CLEVELAND_CAVALIERS,MINNESOTA_TIMBERWOLVES,95,124,1430,29
1430,2013-11-14,2013-11-13,WASHINGTON_WIZARDS,SAN_ANTONIO_SPURS,79,92,1431,13
1431,2013-11-14,2013-11-13,LOS_ANGELES_LAKERS,DENVER_NUGGETS,99,111,1432,12
1432,2013-11-14,2013-11-13,NEW_ORLEANS_PELICANS,UTAH_JAZZ,105,111,1433,6
1433,2013-11-14,2013-11-13,PHOENIX_SUNS,PORTLAND_TRAIL_BLAZERS,89,90,1434,1
1434,2013-11-14,2013-11-13,BROOKLYN_NETS,SACRAMENTO_KINGS,86,107,1435,21
1435,2013-11-14,2013-11-13,OKLAHOMA_CITY_THUNDER,LOS_ANGELES_CLIPPERS,103,111,1436,8
1436,2013-11-15,2013-11-14,HOUSTON_ROCKETS,NEW_YORK_KNICKS,109,106,1437,3
1437,2013-11-15,2013-11-14,OKLAHOMA_CITY_THUNDER,GOLDEN_STATE_WARRIORS,115,116,1438,1
1438,2013-11-16,2013-11-15,MILWAUKEE_BUCKS,INDIANA_PACERS,77,104,1439,27
1439,2013-11-16,2013-11-15,CHICAGO_BULLS,TORONTO_RAPTORS,96,80,1440,16
1440,2013-11-16,2013-11-15,PHILADELPHIA_76ERS,ATLANTA_HAWKS,103,113,1441,10
1441,2013-11-16,2013-11-15,PORTLAND_TRAIL_BLAZERS,BOSTON_CELTICS,109,96,1442,13
1442,2013-11-16,2013-11-15,CHARLOTTE_BOBCATS,CLEVELAND_CAVALIERS,86,80,1443,6
1443,2013-11-16,2013-11-15,DALLAS_MAVERICKS,MIAMI_HEAT,104,110,1444,6
1444,2013-11-16,2013-11-15,MINNESOTA_TIMBERWOLVES,DENVER_NUGGETS,113,117,1445,4
1445,2013-11-16,2013-11-15,BROOKLYN_NETS,PHOENIX_SUNS,100,98,1446,2
1446,2013-11-16,2013-11-15,SAN_ANTONIO_SPURS,UTAH_JAZZ,91,82,1447,9
1447,2013-11-16,2013-11-15,MEMPHIS_GRIZZLIES,LOS_ANGELES_LAKERS,89,86,1448,3
1448,2013-11-16,2013-11-15,DETROIT_PISTONS,SACRAMENTO_KINGS,97,90,1449,7
1449,2013-11-17,2013-11-16,MIAMI_HEAT,CHARLOTTE_BOBCATS,97,81,1450,16
1450,2013-11-17,2013-11-16,DALLAS_MAVERICKS,ORLANDO_MAGIC,108,100,1451,8
1451,2013-11-17,2013-11-16,CLEVELAND_CAVALIERS,WASHINGTON_WIZARDS,103,96,1452,7
1452,2013-11-17,2013-11-16,ATLANTA_HAWKS,NEW_YORK_KNICKS,110,90,1453,20
1453,2013-11-17,2013-11-16,INDIANA_PACERS,CHICAGO_BULLS,94,110,1454,16
1454,2013-11-17,2013-11-16,DENVER_NUGGETS,HOUSTON_ROCKETS,111,122,1455,11
1455,2013-11-17,2013-11-16,BOSTON_CELTICS,MINNESOTA_TIMBERWOLVES,88,106,1456,18
1456,2013-11-17,2013-11-16,PHILADELPHIA_76ERS,NEW_ORLEANS_PELICANS,98,135,1457,37
1457,2013-11-17,2013-11-16,OKLAHOMA_CITY_THUNDER,MILWAUKEE_BUCKS,92,79,1458,13
1458,2013-11-17,2013-11-16,UTAH_JAZZ,GOLDEN_STATE_WARRIORS,88,102,1459,14
1459,2013-11-17,2013-11-16,BROOKLYN_NETS,LOS_ANGELES_CLIPPERS,103,110,1460,7
1460,2013-11-17,2013-11-16,PORTLAND_TRAIL_BLAZERS,TORONTO_RAPTORS,118,110,1461,8
1461,2013-11-17,2013-11-16,MEMPHIS_GRIZZLIES,SACRAMENTO_KINGS,97,86,1462,11
1462,2013-11-18,2013-11-17,DETROIT_PISTONS,LOS_ANGELES_LAKERS,99,114,1463,15
1463,2013-11-19,2013-11-18,PORTLAND_TRAIL_BLAZERS,BROOKLYN_NETS,108,98,1464,10
1464,2013-11-19,2013-11-18,CHARLOTTE_BOBCATS,CHICAGO_BULLS,81,86,1465,5
1465,2013-11-19,2013-11-18,DENVER_NUGGETS,OKLAHOMA_CITY_THUNDER,113,115,1466,2
1466,2013-11-19,2013-11-18,PHILADELPHIA_76ERS,DALLAS_MAVERICKS,94,97,1467,3
1467,2013-11-19,2013-11-18,GOLDEN_STATE_WARRIORS,UTAH_JAZZ,98,87,1468,11
1468,2013-11-19,2013-11-18,MEMPHIS_GRIZZLIES,LOS_ANGELES_CLIPPERS,106,102,1469,4
1469,2013-11-20,2013-11-19,MINNESOTA_TIMBERWOLVES,WASHINGTON_WIZARDS,100,104,1470,4
1470,2013-11-20,2013-11-19,NEW_YORK_KNICKS,DETROIT_PISTONS,86,92,1471,6
1471,2013-11-20,2013-11-19,ATLANTA_HAWKS,MIAMI_HEAT,88,104,1472,16
1472,2013-11-20,2013-11-19,BOSTON_CELTICS,HOUSTON_ROCKETS,85,109,1473,24
1473,2013-11-20,2013-11-19,PHOENIX_SUNS,SACRAMENTO_KINGS,104,107,1474,3
1474,2013-11-21,2013-11-20,BROOKLYN_NETS,CHARLOTTE_BOBCATS,91,95,1475,4
1475,2013-11-21,2013-11-20,WASHINGTON_WIZARDS,CLEVELAND_CAVALIERS,98,91,1476,7
1476,2013-11-21,2013-11-20,INDIANA_PACERS,NEW_YORK_KNICKS,103,96,1477,7
1477,2013-11-21,2013-11-20,MIAMI_HEAT,ORLANDO_MAGIC,120,92,1478,28
1478,2013-11-21,2013-11-20,TORONTO_RAPTORS,PHILADELPHIA_76ERS,108,98,1479,10
1479,2013-11-21,2013-11-20,DETROIT_PISTONS,ATLANTA_HAWKS,85,93,1480,8
1480,2013-11-21,2013-11-20,PORTLAND_TRAIL_BLAZERS,MILWAUKEE_BUCKS,91,82,1481,9
1481,2013-11-21,2013-11-20,LOS_ANGELES_CLIPPERS,MINNESOTA_TIMBERWOLVES,102,98,1482,4
1482,2013-11-21,2013-11-20,UTAH_JAZZ,NEW_ORLEANS_PELICANS,98,105,1483,7
1483,2013-11-21,2013-11-20,BOSTON_CELTICS,SAN_ANTONIO_SPURS,93,104,1484,11
1484,2013-11-21,2013-11-20,SACRAMENTO_KINGS,PHOENIX_SUNS,113,106,1485,7
1485,2013-11-21,2013-11-20,HOUSTON_ROCKETS,DALLAS_MAVERICKS,120,123,1486,3
1486,2013-11-21,2013-11-20,MEMPHIS_GRIZZLIES,GOLDEN_STATE_WARRIORS,88,81,1487,7
1487,2013-11-22,2013-11-21,LOS_ANGELES_CLIPPERS,OKLAHOMA_CITY_THUNDER,91,105,1488,14
1488,2013-11-22,2013-11-21,CHICAGO_BULLS,DENVER_NUGGETS,87,97,1489,10
1489,2013-11-23,2013-11-22,PHOENIX_SUNS,CHARLOTTE_BOBCATS,98,91,1490,7
1490,2013-11-23,2013-11-22,MILWAUKEE_BUCKS,PHILADELPHIA_76ERS,107,115,1491,8
1491,2013-11-23,2013-11-22,WASHINGTON_WIZARDS,TORONTO_RAPTORS,88,96,1492,8
1492,2013-11-23,2013-11-22,INDIANA_PACERS,BOSTON_CELTICS,97,82,1493,15
1493,2013-11-23,2013-11-22,ATLANTA_HAWKS,DETROIT_PISTONS,96,89,1494,7
1494,2013-11-23,2013-11-22,SAN_ANTONIO_SPURS,MEMPHIS_GRIZZLIES,102,86,1495,16
1495,2013-11-23,2013-11-22,BROOKLYN_NETS,MINNESOTA_TIMBERWOLVES,81,111,1496,30
1496,2013-11-23,2013-11-22,CLEVELAND_CAVALIERS,NEW_ORLEANS_PELICANS,100,104,1497,4
1497,2013-11-23,2013-11-22,UTAH_JAZZ,DALLAS_MAVERICKS,93,103,1498,10
1498,2013-11-23,2013-11-22,CHICAGO_BULLS,PORTLAND_TRAIL_BLAZERS,95,98,1499,3
1499,2013-11-23,2013-11-22,GOLDEN_STATE_WARRIORS,LOS_ANGELES_LAKERS,95,102,1500,7
1500,2013-11-23,2013-11-22,SACRAMENTO_KINGS,LOS_ANGELES_CLIPPERS,102,103,1501,1
1501,2013-11-24,2013-11-23,PHILADELPHIA_76ERS,INDIANA_PACERS,98,106,1502,8
1502,2013-11-24,2013-11-23,NEW_YORK_KNICKS,WASHINGTON_WIZARDS,89,98,1503,9
1503,2013-11-24,2013-11-23,BOSTON_CELTICS,ATLANTA_HAWKS,94,87,1504,7
1504,2013-11-24,2013-11-23,ORLANDO_MAGIC,MIAMI_HEAT,99,101,1505,2
1505,2013-11-24,2013-11-23,MINNESOTA_TIMBERWOLVES,HOUSTON_ROCKETS,101,112,1506,11
1506,2013-11-24,2013-11-23,CHARLOTTE_BOBCATS,MILWAUKEE_BUCKS,96,72,1507,24
1507,2013-11-24,2013-11-23,CLEVELAND_CAVALIERS,SAN_ANTONIO_SPURS,96,126,1508,30
1508,2013-11-24,2013-11-23,DALLAS_MAVERICKS,DENVER_NUGGETS,100,102,1509,2
1509,2013-11-24,2013-11-23,PORTLAND_TRAIL_BLAZERS,GOLDEN_STATE_WARRIORS,113,101,1510,12
1510,2013-11-24,2013-11-23,DETROIT_PISTONS,BROOKLYN_NETS,109,97,1511,12
1511,2013-11-24,2013-11-23,CHICAGO_BULLS,LOS_ANGELES_CLIPPERS,82,121,1512,39
1512,2013-11-24,2013-11-23,PHOENIX_SUNS,ORLANDO_MAGIC,104,96,1513,8
1513,2013-11-25,2013-11-24,UTAH_JAZZ,OKLAHOMA_CITY_THUNDER,73,95,1514,22
1514,2013-11-25,2013-11-24,SACRAMENTO_KINGS,LOS_ANGELES_LAKERS,86,100,1515,14
1515,2013-11-26,2013-11-25,BOSTON_CELTICS,CHARLOTTE_BOBCATS,96,86,1516,10
1516,2013-11-26,2013-11-25,MINNESOTA_TIMBERWOLVES,INDIANA_PACERS,84,98,1517,14
1517,2013-11-26,2013-11-25,MILWAUKEE_BUCKS,DETROIT_PISTONS,94,113,1518,19
1518,2013-11-26,2013-11-25,PHOENIX_SUNS,MIAMI_HEAT,92,107,1519,15
1519,2013-11-26,2013-11-25,HOUSTON_ROCKETS,MEMPHIS_GRIZZLIES,93,86,1520,7
1520,2013-11-26,2013-11-25,DENVER_NUGGETS,DALLAS_MAVERICKS,110,96,1521,14
1521,2013-11-26,2013-11-25,NEW_ORLEANS_PELICANS,SAN_ANTONIO_SPURS,93,112,1522,19
1522,2013-11-26,2013-11-25,CHICAGO_BULLS,UTAH_JAZZ,83,89,1523,6
1523,2013-11-26,2013-11-25,NEW_YORK_KNICKS,PORTLAND_TRAIL_BLAZERS,91,102,1524,11
1524,2013-11-27,2013-11-26,BROOKLYN_NETS,TORONTO_RAPTORS,102,100,1525,2
1525,2013-11-27,2013-11-26,LOS_ANGELES_LAKERS,WASHINGTON_WIZARDS,111,116,1526,5
1526,2013-11-27,2013-11-26,ORLANDO_MAGIC,ATLANTA_HAWKS,109,92,1527,17
1527,2013-11-27,2013-11-26,GOLDEN_STATE_WARRIORS,NEW_ORLEANS_PELICANS,102,101,1528,1
1528,2013-11-28,2013-11-27,INDIANA_PACERS,CHARLOTTE_BOBCATS,99,74,1529,25
1529,2013-11-28,2013-11-27,PHILADELPHIA_76ERS,ORLANDO_MAGIC,94,105,1530,11
1530,2013-11-28,2013-11-27,MEMPHIS_GRIZZLIES,BOSTON_CELTICS,100,93,1531,7
1531,2013-11-28,2013-11-27,LOS_ANGELES_LAKERS,BROOKLYN_NETS,99,94,1532,5
1532,2013-11-28,2013-11-27,MIAMI_HEAT,CLEVELAND_CAVALIERS,95,84,1533,11
1533,2013-11-28,2013-11-27,CHICAGO_BULLS,DETROIT_PISTONS,99,79,1534,20
1534,2013-11-28,2013-11-27,ATLANTA_HAWKS,HOUSTON_ROCKETS,84,113,1535,29
1535,2013-11-28,2013-11-27,WASHINGTON_WIZARDS,MILWAUKEE_BUCKS,100,92,1536,8
1536,2013-11-28,2013-11-27,DENVER_NUGGETS,MINNESOTA_TIMBERWOLVES,117,110,1537,7
1537,2013-11-28,2013-11-27,SAN_ANTONIO_SPURS,OKLAHOMA_CITY_THUNDER,88,94,1538,6
1538,2013-11-28,2013-11-27,GOLDEN_STATE_WARRIORS,DALLAS_MAVERICKS,99,103,1539,4
1539,2013-11-28,2013-11-27,PORTLAND_TRAIL_BLAZERS,PHOENIX_SUNS,106,120,1540,14
1540,2013-11-28,2013-11-27,NEW_YORK_KNICKS,LOS_ANGELES_CLIPPERS,80,93,1541,13
1541,2013-11-30,2013-11-29,MILWAUKEE_BUCKS,CHARLOTTE_BOBCATS,76,92,1542,16
1542,2013-11-30,2013-11-29,SAN_ANTONIO_SPURS,ORLANDO_MAGIC,109,91,1543,18
1543,2013-11-30,2013-11-29,MIAMI_HEAT,TORONTO_RAPTORS,90,83,1544,7
1544,2013-11-30,2013-11-29,DALLAS_MAVERICKS,ATLANTA_HAWKS,87,88,1545,1
1545,2013-11-30,2013-11-29,CLEVELAND_CAVALIERS,BOSTON_CELTICS,86,103,1546,17
1546,2013-11-30,2013-11-29,LOS_ANGELES_LAKERS,DETROIT_PISTONS,106,102,1547,4
1547,2013-11-30,2013-11-29,BROOKLYN_NETS,HOUSTON_ROCKETS,95,114,1548,19
1548,2013-11-30,2013-11-29,WASHINGTON_WIZARDS,INDIANA_PACERS,73,93,1549,20
1549,2013-11-30,2013-11-29,GOLDEN_STATE_WARRIORS,OKLAHOMA_CITY_THUNDER,112,113,1550,1
1550,2013-11-30,2013-11-29,NEW_ORLEANS_PELICANS,PHILADELPHIA_76ERS,121,105,1551,16
1551,2013-11-30,2013-11-29,NEW_YORK_KNICKS,DENVER_NUGGETS,95,97,1552,2
1552,2013-11-30,2013-11-29,PHOENIX_SUNS,UTAH_JAZZ,112,101,1553,11
1553,2013-11-30,2013-11-29,LOS_ANGELES_CLIPPERS,SACRAMENTO_KINGS,104,98,1554,6
1554,2013-12-01,2013-11-30,ATLANTA_HAWKS,WASHINGTON_WIZARDS,101,108,1555,7
1555,2013-12-01,2013-11-30,CHICAGO_BULLS,CLEVELAND_CAVALIERS,93,97,1556,4
1556,2013-12-01,2013-11-30,BROOKLYN_NETS,MEMPHIS_GRIZZLIES,97,88,1557,9
1557,2013-12-01,2013-11-30,MINNESOTA_TIMBERWOLVES,DALLAS_MAVERICKS,112,106,1558,6
1558,2013-12-01,2013-11-30,HOUSTON_ROCKETS,SAN_ANTONIO_SPURS,112,106,1559,6
1559,2013-12-01,2013-11-30,BOSTON_CELTICS,MILWAUKEE_BUCKS,85,92,1560,7
1560,2013-12-01,2013-11-30,UTAH_JAZZ,PHOENIX_SUNS,112,104,1561,8
1561,2013-12-01,2013-11-30,DENVER_NUGGETS,TORONTO_RAPTORS,112,98,1562,14
1562,2013-12-01,2013-11-30,PHILADELPHIA_76ERS,DETROIT_PISTONS,100,115,1563,15
1563,2013-12-01,2013-11-30,INDIANA_PACERS,LOS_ANGELES_CLIPPERS,105,100,1564,5
1564,2013-12-01,2013-11-30,CHARLOTTE_BOBCATS,MIAMI_HEAT,98,99,1565,1
1565,2013-12-01,2013-11-30,GOLDEN_STATE_WARRIORS,SACRAMENTO_KINGS,115,113,1566,2
1566,2013-12-02,2013-12-01,MINNESOTA_TIMBERWOLVES,OKLAHOMA_CITY_THUNDER,103,113,1567,10
1567,2013-12-02,2013-12-01,NEW_ORLEANS_PELICANS,NEW_YORK_KNICKS,103,99,1568,4
1568,2013-12-02,2013-12-01,PORTLAND_TRAIL_BLAZERS,LOS_ANGELES_LAKERS,114,108,1569,6
1569,2013-12-03,2013-12-02,ORLANDO_MAGIC,WASHINGTON_WIZARDS,80,98,1570,18
1570,2013-12-03,2013-12-02,NEW_ORLEANS_PELICANS,CHICAGO_BULLS,131,128,1571,3
1571,2013-12-03,2013-12-02,ATLANTA_HAWKS,SAN_ANTONIO_SPURS,100,102,1572,2
1572,2013-12-03,2013-12-02,HOUSTON_ROCKETS,UTAH_JAZZ,103,109,1573,6
1573,2013-12-03,2013-12-02,INDIANA_PACERS,PORTLAND_TRAIL_BLAZERS,102,106,1574,4
1574,2013-12-04,2013-12-03,ORLANDO_MAGIC,PHILADELPHIA_76ERS,125,126,1575,1
1575,2013-12-04,2013-12-03,MILWAUKEE_BUCKS,BOSTON_CELTICS,100,108,1576,8
1576,2013-12-04,2013-12-03,DENVER_NUGGETS,BROOKLYN_NETS,111,87,1577,24
1577,2013-12-04,2013-12-03,DETROIT_PISTONS,MIAMI_HEAT,107,97,1578,10
1578,2013-12-04,2013-12-03,PHOENIX_SUNS,MEMPHIS_GRIZZLIES,91,110,1579,19
1579,2013-12-04,2013-12-03,CHARLOTTE_BOBCATS,DALLAS_MAVERICKS,82,89,1580,7
1580,2013-12-04,2013-12-03,OKLAHOMA_CITY_THUNDER,SACRAMENTO_KINGS,97,95,1581,2
1581,2013-12-04,2013-12-03,TORONTO_RAPTORS,GOLDEN_STATE_WARRIORS,103,112,1582,9
1582,2013-12-05,2013-12-04,DENVER_NUGGETS,CLEVELAND_CAVALIERS,88,98,1583,10
1583,2013-12-05,2013-12-04,LOS_ANGELES_CLIPPERS,ATLANTA_HAWKS,97,107,1584,10
1584,2013-12-05,2013-12-04,PHOENIX_SUNS,HOUSTON_ROCKETS,97,88,1585,9
1585,2013-12-05,2013-12-04,DETROIT_PISTONS,MILWAUKEE_BUCKS,105,98,1586,7
1586,2013-12-05,2013-12-04,DALLAS_MAVERICKS,NEW_ORLEANS_PELICANS,100,97,1587,3
1587,2013-12-05,2013-12-04,INDIANA_PACERS,UTAH_JAZZ,95,86,1588,9
1588,2013-12-05,2013-12-04,OKLAHOMA_CITY_THUNDER,PORTLAND_TRAIL_BLAZERS,104,111,1589,7
1589,2013-12-06,2013-12-05,NEW_YORK_KNICKS,BROOKLYN_NETS,113,83,1590,30
1590,2013-12-06,2013-12-05,LOS_ANGELES_CLIPPERS,MEMPHIS_GRIZZLIES,101,81,1591,20
1591,2013-12-06,2013-12-05,MIAMI_HEAT,CHICAGO_BULLS,87,107,1592,20
1592,2013-12-07,2013-12-06,PHILADELPHIA_76ERS,CHARLOTTE_BOBCATS,88,105,1593,17
1593,2013-12-07,2013-12-06,MILWAUKEE_BUCKS,WASHINGTON_WIZARDS,109,105,1594,4
1594,2013-12-07,2013-12-06,CLEVELAND_CAVALIERS,ATLANTA_HAWKS,89,108,1595,19
1595,2013-12-07,2013-12-06,DENVER_NUGGETS,BOSTON_CELTICS,98,106,1596,8
1596,2013-12-07,2013-12-06,ORLANDO_MAGIC,NEW_YORK_KNICKS,83,121,1597,38
1597,2013-12-07,2013-12-06,GOLDEN_STATE_WARRIORS,HOUSTON_ROCKETS,83,105,1598,22
1598,2013-12-07,2013-12-06,OKLAHOMA_CITY_THUNDER,NEW_ORLEANS_PELICANS,109,95,1599,14
1599,2013-12-07,2013-12-06,TORONTO_RAPTORS,PHOENIX_SUNS,97,106,1600,9
1600,2013-12-07,2013-12-06,UTAH_JAZZ,PORTLAND_TRAIL_BLAZERS,98,130,1601,32
1601,2013-12-07,2013-12-06,LOS_ANGELES_LAKERS,SACRAMENTO_KINGS,106,100,1602,6
1602,2013-12-08,2013-12-07,DENVER_NUGGETS,PHILADELPHIA_76ERS,103,92,1603,11
1603,2013-12-08,2013-12-07,LOS_ANGELES_CLIPPERS,CLEVELAND_CAVALIERS,82,88,1604,6
1604,2013-12-08,2013-12-07,DETROIT_PISTONS,CHICAGO_BULLS,92,75,1605,17
1605,2013-12-08,2013-12-07,GOLDEN_STATE_WARRIORS,MEMPHIS_GRIZZLIES,108,82,1606,26
1606,2013-12-08,2013-12-07,MIAMI_HEAT,MINNESOTA_TIMBERWOLVES,103,82,1607,21
1607,2013-12-08,2013-12-07,BROOKLYN_NETS,MILWAUKEE_BUCKS,90,82,1608,8
1608,2013-12-08,2013-12-07,INDIANA_PACERS,SAN_ANTONIO_SPURS,111,100,1609,11
1609,2013-12-08,2013-12-07,SACRAMENTO_KINGS,UTAH_JAZZ,112,102,1610,10
1610,2013-12-08,2013-12-07,DALLAS_MAVERICKS,PORTLAND_TRAIL_BLAZERS,108,106,1611,2
1611,2013-12-08,2013-12-07,MIAMI_HEAT,DETROIT_PISTONS,110,95,1612,15
1612,2013-12-09,2013-12-08,ORLANDO_MAGIC,HOUSTON_ROCKETS,88,98,1613,10
1613,2013-12-09,2013-12-08,INDIANA_PACERS,OKLAHOMA_CITY_THUNDER,94,118,1614,24
1614,2013-12-09,2013-12-08,TORONTO_RAPTORS,LOS_ANGELES_LAKERS,106,94,1615,12
1615,2013-12-08,2013-12-07,BOSTON_CELTICS,NEW_YORK_KNICKS,114,73,1616,41
1616,2013-12-10,2013-12-09,GOLDEN_STATE_WARRIORS,CHARLOTTE_BOBCATS,111,115,1617,4
1617,2013-12-10,2013-12-09,LOS_ANGELES_CLIPPERS,PHILADELPHIA_76ERS,94,83,1618,11
1618,2013-12-10,2013-12-09,DENVER_NUGGETS,WASHINGTON_WIZARDS,75,74,1619,1
1619,2013-12-10,2013-12-09,ORLANDO_MAGIC,MEMPHIS_GRIZZLIES,85,94,1620,9
1620,2013-12-10,2013-12-09,PORTLAND_TRAIL_BLAZERS,UTAH_JAZZ,105,94,1621,11
1621,2013-12-10,2013-12-09,DALLAS_MAVERICKS,SACRAMENTO_KINGS,97,112,1622,15
1622,2013-12-11,2013-12-10,NEW_YORK_KNICKS,CLEVELAND_CAVALIERS,94,109,1623,15
1623,2013-12-11,2013-12-10,MIAMI_HEAT,INDIANA_PACERS,84,90,1624,6
1624,2013-12-11,2013-12-10,SAN_ANTONIO_SPURS,TORONTO_RAPTORS,116,103,1625,13
1625,2013-12-11,2013-12-10,OKLAHOMA_CITY_THUNDER,ATLANTA_HAWKS,101,92,1626,9
1626,2013-12-11,2013-12-10,BOSTON_CELTICS,BROOKLYN_NETS,96,104,1627,8
1627,2013-12-11,2013-12-10,MINNESOTA_TIMBERWOLVES,DETROIT_PISTONS,121,94,1628,27
1628,2013-12-11,2013-12-10,MILWAUKEE_BUCKS,CHICAGO_BULLS,78,74,1629,4
1629,2013-12-11,2013-12-10,PHOENIX_SUNS,LOS_ANGELES_LAKERS,114,108,1630,6
1630,2013-12-12,2013-12-11,ORLANDO_MAGIC,CHARLOTTE_BOBCATS,92,83,1631,9
1631,2013-12-12,2013-12-11,LOS_ANGELES_CLIPPERS,BOSTON_CELTICS,96,88,1632,8
1632,2013-12-12,2013-12-11,OKLAHOMA_CITY_THUNDER,MEMPHIS_GRIZZLIES,116,100,1633,16
1633,2013-12-12,2013-12-11,SAN_ANTONIO_SPURS,MILWAUKEE_BUCKS,109,77,1634,32
1634,2013-12-12,2013-12-11,PHILADELPHIA_76ERS,MINNESOTA_TIMBERWOLVES,99,106,1635,7
1635,2013-12-12,2013-12-11,DETROIT_PISTONS,NEW_ORLEANS_PELICANS,106,111,1636,5
1636,2013-12-12,2013-12-11,CHICAGO_BULLS,NEW_YORK_KNICKS,78,83,1637,5
1637,2013-12-12,2013-12-11,UTAH_JAZZ,SACRAMENTO_KINGS,122,101,1638,21
1638,2013-12-12,2013-12-11,DALLAS_MAVERICKS,GOLDEN_STATE_WARRIORS,93,95,1639,2
1639,2013-12-13,2013-12-12,LOS_ANGELES_CLIPPERS,BROOKLYN_NETS,93,102,1640,9
1640,2013-12-13,2013-12-12,HOUSTON_ROCKETS,PORTLAND_TRAIL_BLAZERS,104,111,1641,7
1641,2013-12-14,2013-12-13,CHARLOTTE_BOBCATS,INDIANA_PACERS,94,99,1642,5
1642,2013-12-14,2013-12-13,CLEVELAND_CAVALIERS,ORLANDO_MAGIC,109,100,1643,9
1643,2013-12-14,2013-12-13,PHILADELPHIA_76ERS,TORONTO_RAPTORS,100,108,1644,8
1644,2013-12-14,2013-12-13,WASHINGTON_WIZARDS,ATLANTA_HAWKS,99,101,1645,2
1645,2013-12-14,2013-12-13,NEW_YORK_KNICKS,BOSTON_CELTICS,86,90,1646,4
1646,2013-12-14,2013-12-13,BROOKLYN_NETS,DETROIT_PISTONS,99,103,1647,4
1647,2013-12-14,2013-12-13,MEMPHIS_GRIZZLIES,NEW_ORLEANS_PELICANS,98,104,1648,6
1648,2013-12-14,2013-12-13,LOS_ANGELES_LAKERS,OKLAHOMA_CITY_THUNDER,97,122,1649,25
1649,2013-12-14,2013-12-13,CHICAGO_BULLS,MILWAUKEE_BUCKS,91,90,1650,1
1650,2013-12-14,2013-12-13,MINNESOTA_TIMBERWOLVES,SAN_ANTONIO_SPURS,110,117,1651,7
1651,2013-12-14,2013-12-13,UTAH_JAZZ,DENVER_NUGGETS,103,93,1652,10
1652,2013-12-14,2013-12-13,SACRAMENTO_KINGS,PHOENIX_SUNS,107,116,1653,9
1653,2013-12-14,2013-12-13,HOUSTON_ROCKETS,GOLDEN_STATE_WARRIORS,116,112,1654,4
1654,2013-12-15,2013-12-14,LOS_ANGELES_LAKERS,CHARLOTTE_BOBCATS,88,85,1655,3
1655,2013-12-15,2013-12-14,LOS_ANGELES_CLIPPERS,WASHINGTON_WIZARDS,113,97,1656,16
1656,2013-12-15,2013-12-14,CLEVELAND_CAVALIERS,MIAMI_HEAT,107,114,1657,7
1657,2013-12-15,2013-12-14,ATLANTA_HAWKS,NEW_YORK_KNICKS,106,111,1658,5
1658,2013-12-15,2013-12-14,TORONTO_RAPTORS,CHICAGO_BULLS,99,77,1659,22
1659,2013-12-15,2013-12-14,PORTLAND_TRAIL_BLAZERS,PHILADELPHIA_76ERS,139,105,1660,34
1660,2013-12-15,2013-12-14,MILWAUKEE_BUCKS,DALLAS_MAVERICKS,93,106,1661,13
1661,2013-12-15,2013-12-14,SAN_ANTONIO_SPURS,UTAH_JAZZ,100,84,1662,16
1662,2013-12-15,2013-12-14,PORTLAND_TRAIL_BLAZERS,DETROIT_PISTONS,111,109,1663,2
1663,2013-12-15,2013-12-14,MINNESOTA_TIMBERWOLVES,MEMPHIS_GRIZZLIES,101,93,1664,8
1664,2013-12-15,2013-12-14,HOUSTON_ROCKETS,SACRAMENTO_KINGS,91,106,1665,15
1665,2013-12-16,2013-12-15,ORLANDO_MAGIC,OKLAHOMA_CITY_THUNDER,98,101,1666,3
1666,2013-12-16,2013-12-15,NEW_ORLEANS_PELICANS,DENVER_NUGGETS,93,102,1667,9
1667,2013-12-16,2013-12-15,GOLDEN_STATE_WARRIORS,PHOENIX_SUNS,102,106,1668,4
1668,2013-12-17,2013-12-16,DETROIT_PISTONS,INDIANA_PACERS,101,96,1669,5
1669,2013-12-17,2013-12-16,LOS_ANGELES_LAKERS,ATLANTA_HAWKS,100,114,1670,14
1670,2013-12-17,2013-12-16,MINNESOTA_TIMBERWOLVES,BOSTON_CELTICS,97,101,1671,4
1671,2013-12-17,2013-12-16,PHILADELPHIA_76ERS,BROOKLYN_NETS,94,130,1672,36
1672,2013-12-17,2013-12-16,UTAH_JAZZ,MIAMI_HEAT,94,117,1673,23
1673,2013-12-17,2013-12-16,WASHINGTON_WIZARDS,NEW_YORK_KNICKS,102,101,1674,1
1674,2013-12-17,2013-12-16,ORLANDO_MAGIC,CHICAGO_BULLS,83,82,1675,1
1675,2013-12-17,2013-12-16,SAN_ANTONIO_SPURS,LOS_ANGELES_CLIPPERS,92,115,1676,23
1676,2013-12-18,2013-12-17,SACRAMENTO_KINGS,CHARLOTTE_BOBCATS,87,95,1677,8
1677,2013-12-18,2013-12-17,PORTLAND_TRAIL_BLAZERS,CLEVELAND_CAVALIERS,119,116,1678,3
1678,2013-12-18,2013-12-17,LOS_ANGELES_LAKERS,MEMPHIS_GRIZZLIES,96,92,1679,4
1679,2013-12-18,2013-12-17,OKLAHOMA_CITY_THUNDER,DENVER_NUGGETS,105,93,1680,12
1680,2013-12-18,2013-12-17,NEW_ORLEANS_PELICANS,GOLDEN_STATE_WARRIORS,93,104,1681,11
1681,2013-12-19,2013-12-18,INDIANA_PACERS,MIAMI_HEAT,94,97,1682,3
1682,2013-12-19,2013-12-18,UTAH_JAZZ,ORLANDO_MAGIC,86,82,1683,4
1683,2013-12-19,2013-12-18,CHARLOTTE_BOBCATS,TORONTO_RAPTORS,104,102,1684,2
1684,2013-12-19,2013-12-18,SACRAMENTO_KINGS,ATLANTA_HAWKS,107,124,1685,17
1685,2013-12-19,2013-12-18,DETROIT_PISTONS,BOSTON_CELTICS,107,106,1686,1
1686,2013-12-19,2013-12-18,WASHINGTON_WIZARDS,BROOKLYN_NETS,113,107,1687,6
1687,2013-12-19,2013-12-18,NEW_YORK_KNICKS,MILWAUKEE_BUCKS,107,101,1688,6
1688,2013-12-19,2013-12-18,PORTLAND_TRAIL_BLAZERS,MINNESOTA_TIMBERWOLVES,109,120,1689,11
1689,2013-12-19,2013-12-18,MEMPHIS_GRIZZLIES,DALLAS_MAVERICKS,91,105,1690,14
1690,2013-12-19,2013-12-18,SAN_ANTONIO_SPURS,PHOENIX_SUNS,108,101,1691,7
1691,2013-12-19,2013-12-18,CHICAGO_BULLS,HOUSTON_ROCKETS,94,109,1692,15
1692,2013-12-19,2013-12-18,NEW_ORLEANS_PELICANS,LOS_ANGELES_CLIPPERS,95,108,1693,13
1693,2013-12-20,2013-12-19,CHICAGO_BULLS,OKLAHOMA_CITY_THUNDER,95,107,1694,12
1694,2013-12-20,2013-12-19,SAN_ANTONIO_SPURS,GOLDEN_STATE_WARRIORS,104,102,1695,2
1695,2013-12-21,2013-12-20,BROOKLYN_NETS,PHILADELPHIA_76ERS,120,121,1696,1
1696,2013-12-21,2013-12-20,UTAH_JAZZ,ATLANTA_HAWKS,85,118,1697,33
1697,2013-12-21,2013-12-20,MILWAUKEE_BUCKS,CLEVELAND_CAVALIERS,111,114,1698,3
1698,2013-12-21,2013-12-20,CHARLOTTE_BOBCATS,DETROIT_PISTONS,116,106,1699,10
1699,2013-12-21,2013-12-20,SACRAMENTO_KINGS,MIAMI_HEAT,103,122,1700,19
1700,2013-12-21,2013-12-20,HOUSTON_ROCKETS,INDIANA_PACERS,81,114,1701,33
1701,2013-12-21,2013-12-20,TORONTO_RAPTORS,DALLAS_MAVERICKS,109,108,1702,1
1702,2013-12-21,2013-12-20,PHOENIX_SUNS,DENVER_NUGGETS,103,99,1703,4
1703,2013-12-21,2013-12-20,MINNESOTA_TIMBERWOLVES,LOS_ANGELES_LAKERS,91,104,1704,13
1704,2013-12-21,2013-12-20,WASHINGTON_WIZARDS,BOSTON_CELTICS,106,99,1705,7
1705,2013-12-22,2013-12-21,SACRAMENTO_KINGS,ORLANDO_MAGIC,105,100,1706,5
1706,2013-12-22,2013-12-21,UTAH_JAZZ,CHARLOTTE_BOBCATS,88,85,1707,3
1707,2013-12-22,2013-12-21,HOUSTON_ROCKETS,DETROIT_PISTONS,114,97,1708,17
1708,2013-12-22,2013-12-21,CLEVELAND_CAVALIERS,CHICAGO_BULLS,84,100,1709,16
1709,2013-12-22,2013-12-21,PHILADELPHIA_76ERS,MILWAUKEE_BUCKS,106,116,1710,10
1710,2013-12-22,2013-12-21,OKLAHOMA_CITY_THUNDER,SAN_ANTONIO_SPURS,113,100,1711,13
1711,2013-12-22,2013-12-21,DALLAS_MAVERICKS,PHOENIX_SUNS,108,123,1712,15
1712,2013-12-22,2013-12-21,NEW_ORLEANS_PELICANS,PORTLAND_TRAIL_BLAZERS,107,110,1713,3
1713,2013-12-22,2013-12-21,LOS_ANGELES_LAKERS,GOLDEN_STATE_WARRIORS,83,102,1714,19
1714,2013-12-22,2013-12-21,DENVER_NUGGETS,LOS_ANGELES_CLIPPERS,91,112,1715,21
1715,2013-12-21,2013-12-20,MEMPHIS_GRIZZLIES,NEW_YORK_KNICKS,95,87,1716,8
1716,2013-12-22,2013-12-21,BOSTON_CELTICS,INDIANA_PACERS,79,106,1717,27
1717,2013-12-23,2013-12-22,TORONTO_RAPTORS,OKLAHOMA_CITY_THUNDER,104,98,1718,6
1718,2013-12-23,2013-12-22,MINNESOTA_TIMBERWOLVES,LOS_ANGELES_CLIPPERS,116,120,1719,4
1719,2013-12-24,2013-12-23,MILWAUKEE_BUCKS,CHARLOTTE_BOBCATS,110,111,1720,1
1720,2013-12-24,2013-12-23,DETROIT_PISTONS,CLEVELAND_CAVALIERS,115,92,1721,23
1721,2013-12-24,2013-12-23,NEW_YORK_KNICKS,ORLANDO_MAGIC,103,98,1722,5
1722,2013-12-24,2013-12-23,INDIANA_PACERS,BROOKLYN_NETS,103,86,1723,17
1723,2013-12-24,2013-12-23,ATLANTA_HAWKS,MIAMI_HEAT,119,121,1724,2
1724,2013-12-24,2013-12-23,DALLAS_MAVERICKS,HOUSTON_ROCKETS,111,104,1725,7
1725,2013-12-24,2013-12-23,UTAH_JAZZ,MEMPHIS_GRIZZLIES,94,104,1726,10
1726,2013-12-24,2013-12-23,TORONTO_RAPTORS,SAN_ANTONIO_SPURS,99,112,1727,13
1727,2013-12-24,2013-12-23,GOLDEN_STATE_WARRIORS,DENVER_NUGGETS,89,81,1728,8
1728,2013-12-24,2013-12-23,LOS_ANGELES_LAKERS,PHOENIX_SUNS,90,117,1729,27
1729,2013-12-24,2013-12-23,NEW_ORLEANS_PELICANS,SACRAMENTO_KINGS,113,100,1730,13
1730,2013-12-25,2013-12-24,OKLAHOMA_CITY_THUNDER,NEW_YORK_KNICKS,123,94,1731,29
1731,2013-12-25,2013-12-24,MIAMI_HEAT,LOS_ANGELES_LAKERS,101,95,1732,6
1732,2013-12-26,2013-12-25,HOUSTON_ROCKETS,SAN_ANTONIO_SPURS,111,98,1733,13
1733,2013-12-26,2013-12-25,LOS_ANGELES_CLIPPERS,GOLDEN_STATE_WARRIORS,103,105,1734,2
1734,2013-12-25,2013-12-24,CHICAGO_BULLS,BROOKLYN_NETS,95,78,1735,17
1735,2013-12-27,2013-12-26,ATLANTA_HAWKS,CLEVELAND_CAVALIERS,127,125,1736,2
1736,2013-12-27,2013-12-26,MEMPHIS_GRIZZLIES,HOUSTON_ROCKETS,92,100,1737,8
1737,2013-12-27,2013-12-26,SAN_ANTONIO_SPURS,DALLAS_MAVERICKS,116,107,1738,9
1738,2013-12-27,2013-12-26,LOS_ANGELES_CLIPPERS,PORTLAND_TRAIL_BLAZERS,112,116,1739,4
1739,2013-12-28,2013-12-27,OKLAHOMA_CITY_THUNDER,CHARLOTTE_BOBCATS,89,85,1740,4
1740,2013-12-28,2013-12-27,DETROIT_PISTONS,ORLANDO_MAGIC,92,109,1741,17
1741,2013-12-28,2013-12-27,MILWAUKEE_BUCKS,BROOKLYN_NETS,93,104,1742,11
1742,2013-12-28,2013-12-27,TORONTO_RAPTORS,NEW_YORK_KNICKS,95,83,1743,12
1743,2013-12-28,2013-12-27,WASHINGTON_WIZARDS,MINNESOTA_TIMBERWOLVES,98,120,1744,22
1744,2013-12-28,2013-12-27,DENVER_NUGGETS,NEW_ORLEANS_PELICANS,89,105,1745,16
1745,2013-12-28,2013-12-27,LOS_ANGELES_LAKERS,UTAH_JAZZ,103,105,1746,2
1746,2013-12-28,2013-12-27,MIAMI_HEAT,SACRAMENTO_KINGS,103,108,1747,5
1747,2013-12-28,2013-12-27,PHOENIX_SUNS,GOLDEN_STATE_WARRIORS,86,115,1748,29
1748,2013-12-28,2013-12-27,CLEVELAND_CAVALIERS,BOSTON_CELTICS,100,103,1749,3
1749,2013-12-29,2013-12-28,BROOKLYN_NETS,INDIANA_PACERS,91,105,1750,14
1750,2013-12-29,2013-12-28,NEW_YORK_KNICKS,TORONTO_RAPTORS,100,115,1751,15
1751,2013-12-29,2013-12-28,DETROIT_PISTONS,WASHINGTON_WIZARDS,82,106,1752,24
1752,2013-12-29,2013-12-28,CHARLOTTE_BOBCATS,ATLANTA_HAWKS,116,118,1753,2
1753,2013-12-29,2013-12-28,DALLAS_MAVERICKS,CHICAGO_BULLS,105,83,1754,22
1754,2013-12-29,2013-12-28,NEW_ORLEANS_PELICANS,HOUSTON_ROCKETS,98,107,1755,9
1755,2013-12-29,2013-12-28,DENVER_NUGGETS,MEMPHIS_GRIZZLIES,99,120,1756,21
1756,2013-12-29,2013-12-28,MINNESOTA_TIMBERWOLVES,MILWAUKEE_BUCKS,117,95,1757,22
1757,2013-12-29,2013-12-28,PHILADELPHIA_76ERS,PHOENIX_SUNS,101,115,1758,14
1758,2013-12-29,2013-12-28,MIAMI_HEAT,PORTLAND_TRAIL_BLAZERS,108,107,1759,1
1759,2013-12-29,2013-12-28,UTAH_JAZZ,LOS_ANGELES_CLIPPERS,90,98,1760,8
1760,2013-12-29,2013-12-28,GOLDEN_STATE_WARRIORS,CLEVELAND_CAVALIERS,108,104,1761,4
1761,2013-12-29,2013-12-28,ATLANTA_HAWKS,ORLANDO_MAGIC,102,109,1762,7
1762,2013-12-30,2013-12-29,HOUSTON_ROCKETS,OKLAHOMA_CITY_THUNDER,86,117,1763,31
1763,2013-12-30,2013-12-29,SACRAMENTO_KINGS,SAN_ANTONIO_SPURS,104,112,1764,8
1764,2013-12-30,2013-12-29,PHILADELPHIA_76ERS,LOS_ANGELES_LAKERS,111,104,1765,7
1765,2013-12-31,2013-12-30,WASHINGTON_WIZARDS,DETROIT_PISTONS,106,99,1766,7
1766,2013-12-31,2013-12-30,CHICAGO_BULLS,MEMPHIS_GRIZZLIES,95,91,1767,4
1767,2013-12-31,2013-12-30,DALLAS_MAVERICKS,MINNESOTA_TIMBERWOLVES,100,98,1768,2
1768,2013-12-31,2013-12-30,PORTLAND_TRAIL_BLAZERS,NEW_ORLEANS_PELICANS,108,110,1769,2
1769,2013-12-31,2013-12-30,MIAMI_HEAT,DENVER_NUGGETS,97,94,1770,3
1770,2013-12-31,2013-12-30,CHARLOTTE_BOBCATS,UTAH_JAZZ,80,83,1771,3
1771,2013-12-31,2013-12-30,PHOENIX_SUNS,LOS_ANGELES_CLIPPERS,107,88,1772,19
1772,2013-12-31,2013-12-30,ATLANTA_HAWKS,BOSTON_CELTICS,92,91,1773,1
1773,2013-12-31,2013-12-30,CLEVELAND_CAVALIERS,INDIANA_PACERS,76,91,1774,15
1774,2013-12-31,2013-12-30,GOLDEN_STATE_WARRIORS,ORLANDO_MAGIC,94,81,1775,13
1775,2014-01-01,2013-12-31,SACRAMENTO_KINGS,HOUSTON_ROCKETS,110,106,1776,4
1776,2014-01-01,2013-12-31,BROOKLYN_NETS,SAN_ANTONIO_SPURS,92,113,1777,21
1777,2014-01-01,2013-12-31,TORONTO_RAPTORS,CHICAGO_BULLS,85,79,1778,6
1778,2014-01-01,2013-12-31,PORTLAND_TRAIL_BLAZERS,OKLAHOMA_CITY_THUNDER,98,94,1779,4
1779,2014-01-01,2013-12-31,MILWAUKEE_BUCKS,LOS_ANGELES_LAKERS,94,79,1780,15
1780,2014-01-01,2013-12-31,DALLAS_MAVERICKS,WASHINGTON_WIZARDS,87,78,1781,9
1781,2014-01-02,2014-01-01,INDIANA_PACERS,TORONTO_RAPTORS,82,95,1782,13
1782,2014-01-02,2014-01-01,NEW_ORLEANS_PELICANS,MINNESOTA_TIMBERWOLVES,112,124,1783,12
1783,2014-01-02,2014-01-01,PHILADELPHIA_76ERS,DENVER_NUGGETS,114,102,1784,12
1784,2014-01-02,2014-01-01,CHARLOTTE_BOBCATS,LOS_ANGELES_CLIPPERS,85,112,1785,27
1785,2014-01-03,2014-01-02,ORLANDO_MAGIC,CLEVELAND_CAVALIERS,81,87,1786,6
1786,2014-01-03,2014-01-02,GOLDEN_STATE_WARRIORS,MIAMI_HEAT,123,114,1787,9
1787,2014-01-03,2014-01-02,BOSTON_CELTICS,CHICAGO_BULLS,82,94,1788,12
1788,2014-01-03,2014-01-02,BROOKLYN_NETS,OKLAHOMA_CITY_THUNDER,95,93,1789,2
1789,2014-01-03,2014-01-02,NEW_YORK_KNICKS,SAN_ANTONIO_SPURS,105,101,1790,4
1790,2014-01-03,2014-01-02,MEMPHIS_GRIZZLIES,PHOENIX_SUNS,99,91,1791,8
1791,2014-01-03,2014-01-02,MILWAUKEE_BUCKS,UTAH_JAZZ,87,96,1792,9
1792,2014-01-03,2014-01-02,CHARLOTTE_BOBCATS,PORTLAND_TRAIL_BLAZERS,104,134,1793,30
1793,2014-01-03,2014-01-02,PHILADELPHIA_76ERS,SACRAMENTO_KINGS,113,104,1794,9
1794,2014-01-04,2014-01-03,TORONTO_RAPTORS,WASHINGTON_WIZARDS,101,88,1795,13
1795,2014-01-04,2014-01-03,GOLDEN_STATE_WARRIORS,ATLANTA_HAWKS,101,100,1796,1
1796,2014-01-04,2014-01-03,NEW_ORLEANS_PELICANS,BOSTON_CELTICS,95,92,1797,3
1797,2014-01-04,2014-01-03,NEW_YORK_KNICKS,HOUSTON_ROCKETS,100,102,1798,2
1798,2014-01-04,2014-01-03,LOS_ANGELES_CLIPPERS,DALLAS_MAVERICKS,119,112,1799,7
1799,2014-01-04,2014-01-03,MEMPHIS_GRIZZLIES,DENVER_NUGGETS,108,111,1800,3
1800,2014-01-04,2014-01-03,UTAH_JAZZ,LOS_ANGELES_LAKERS,99,110,1801,11
1801,2014-01-05,2014-01-04,NEW_ORLEANS_PELICANS,INDIANA_PACERS,82,99,1802,17
1802,2014-01-05,2014-01-04,MIAMI_HEAT,ORLANDO_MAGIC,110,94,1803,16
1803,2014-01-05,2014-01-04,CLEVELAND_CAVALIERS,BROOKLYN_NETS,82,89,1804,7
1804,2014-01-05,2014-01-04,ATLANTA_HAWKS,CHICAGO_BULLS,84,91,1805,7
1805,2014-01-05,2014-01-04,OKLAHOMA_CITY_THUNDER,MINNESOTA_TIMBERWOLVES,115,111,1806,4
1806,2014-01-05,2014-01-04,LOS_ANGELES_CLIPPERS,SAN_ANTONIO_SPURS,92,116,1807,24
1807,2014-01-05,2014-01-04,MILWAUKEE_BUCKS,PHOENIX_SUNS,100,116,1808,16
1808,2014-01-05,2014-01-04,PHILADELPHIA_76ERS,PORTLAND_TRAIL_BLAZERS,101,99,1809,2
1809,2014-01-05,2014-01-04,CHARLOTTE_BOBCATS,SACRAMENTO_KINGS,113,103,1810,10
1810,2014-01-05,2014-01-04,MEMPHIS_GRIZZLIES,DETROIT_PISTONS,112,84,1811,28
1811,2014-01-05,2014-01-04,INDIANA_PACERS,CLEVELAND_CAVALIERS,82,78,1812,4
1812,2014-01-05,2014-01-04,TORONTO_RAPTORS,MIAMI_HEAT,97,102,1813,5
1813,2014-01-05,2014-01-04,GOLDEN_STATE_WARRIORS,WASHINGTON_WIZARDS,112,96,1814,16
1814,2014-01-06,2014-01-05,BOSTON_CELTICS,OKLAHOMA_CITY_THUNDER,96,119,1815,23
1815,2014-01-06,2014-01-05,NEW_YORK_KNICKS,DALLAS_MAVERICKS,92,80,1816,12
1816,2014-01-06,2014-01-05,DENVER_NUGGETS,LOS_ANGELES_LAKERS,137,115,1817,22
1817,2014-01-07,2014-01-06,MINNESOTA_TIMBERWOLVES,PHILADELPHIA_76ERS,126,95,1818,31
1818,2014-01-07,2014-01-06,ATLANTA_HAWKS,BROOKLYN_NETS,86,91,1819,5
1819,2014-01-07,2014-01-06,ORLANDO_MAGIC,LOS_ANGELES_CLIPPERS,81,101,1820,20
1820,2014-01-08,2014-01-07,WASHINGTON_WIZARDS,CHARLOTTE_BOBCATS,97,83,1821,14
1821,2014-01-08,2014-01-07,PHILADELPHIA_76ERS,CLEVELAND_CAVALIERS,93,111,1822,18
1822,2014-01-08,2014-01-07,TORONTO_RAPTORS,INDIANA_PACERS,79,86,1823,7
1823,2014-01-08,2014-01-07,NEW_ORLEANS_PELICANS,MIAMI_HEAT,88,107,1824,19
1824,2014-01-08,2014-01-07,DETROIT_PISTONS,NEW_YORK_KNICKS,85,89,1825,4
1825,2014-01-08,2014-01-07,PHOENIX_SUNS,CHICAGO_BULLS,87,92,1826,5
1826,2014-01-08,2014-01-07,SAN_ANTONIO_SPURS,MEMPHIS_GRIZZLIES,110,108,1827,2
1827,2014-01-08,2014-01-07,GOLDEN_STATE_WARRIORS,MILWAUKEE_BUCKS,101,80,1828,21
1828,2014-01-08,2014-01-07,LOS_ANGELES_LAKERS,DALLAS_MAVERICKS,97,110,1829,13
1829,2014-01-08,2014-01-07,BOSTON_CELTICS,DENVER_NUGGETS,98,129,1830,31
1830,2014-01-08,2014-01-07,OKLAHOMA_CITY_THUNDER,UTAH_JAZZ,101,112,1831,11
1831,2014-01-08,2014-01-07,PORTLAND_TRAIL_BLAZERS,SACRAMENTO_KINGS,119,123,1832,4
1832,2014-01-09,2014-01-08,DALLAS_MAVERICKS,SAN_ANTONIO_SPURS,90,112,1833,22
1833,2014-01-09,2014-01-08,DETROIT_PISTONS,TORONTO_RAPTORS,91,112,1834,21
1834,2014-01-09,2014-01-08,INDIANA_PACERS,ATLANTA_HAWKS,87,97,1835,10
1835,2014-01-09,2014-01-08,GOLDEN_STATE_WARRIORS,BROOKLYN_NETS,98,102,1836,4
1836,2014-01-09,2014-01-08,LOS_ANGELES_LAKERS,HOUSTON_ROCKETS,99,113,1837,14
1837,2014-01-09,2014-01-08,WASHINGTON_WIZARDS,NEW_ORLEANS_PELICANS,102,96,1838,6
1838,2014-01-09,2014-01-08,PHOENIX_SUNS,MINNESOTA_TIMBERWOLVES,104,103,1839,1
1839,2014-01-09,2014-01-08,ORLANDO_MAGIC,PORTLAND_TRAIL_BLAZERS,94,110,1840,16
1840,2014-01-09,2014-01-08,BOSTON_CELTICS,LOS_ANGELES_CLIPPERS,105,111,1841,6
1841,2014-01-10,2014-01-09,MIAMI_HEAT,NEW_YORK_KNICKS,92,102,1842,10
1842,2014-01-10,2014-01-09,OKLAHOMA_CITY_THUNDER,DENVER_NUGGETS,88,101,1843,13
1843,2014-01-11,2014-01-10,WASHINGTON_WIZARDS,INDIANA_PACERS,66,93,1844,27
1844,2014-01-11,2014-01-10,DETROIT_PISTONS,PHILADELPHIA_76ERS,114,104,1845,10
1845,2014-01-11,2014-01-10,HOUSTON_ROCKETS,ATLANTA_HAWKS,80,83,1846,3
1846,2014-01-11,2014-01-10,MIAMI_HEAT,BROOKLYN_NETS,95,104,1847,9
1847,2014-01-11,2014-01-10,PHOENIX_SUNS,MEMPHIS_GRIZZLIES,99,104,1848,5
1848,2014-01-11,2014-01-10,CHARLOTTE_BOBCATS,MINNESOTA_TIMBERWOLVES,92,119,1849,27
1849,2014-01-11,2014-01-10,DALLAS_MAVERICKS,NEW_ORLEANS_PELICANS,107,90,1850,17
1850,2014-01-11,2014-01-10,CHICAGO_BULLS,MILWAUKEE_BUCKS,81,72,1851,9
1851,2014-01-11,2014-01-10,CLEVELAND_CAVALIERS,UTAH_JAZZ,113,102,1852,11
1852,2014-01-11,2014-01-10,ORLANDO_MAGIC,SACRAMENTO_KINGS,83,103,1853,20
1853,2014-01-11,2014-01-10,BOSTON_CELTICS,GOLDEN_STATE_WARRIORS,97,99,1854,2
1854,2014-01-11,2014-01-10,LOS_ANGELES_LAKERS,LOS_ANGELES_CLIPPERS,87,123,1855,36
1855,2014-01-12,2014-01-11,BROOKLYN_NETS,TORONTO_RAPTORS,80,96,1856,16
1856,2014-01-12,2014-01-11,HOUSTON_ROCKETS,WASHINGTON_WIZARDS,114,107,1857,7
1857,2014-01-12,2014-01-11,PHOENIX_SUNS,DETROIT_PISTONS,108,110,1858,2
1858,2014-01-12,2014-01-11,NEW_YORK_KNICKS,PHILADELPHIA_76ERS,102,92,1859,10
1859,2014-01-12,2014-01-11,CHARLOTTE_BOBCATS,CHICAGO_BULLS,97,103,1860,6
1860,2014-01-12,2014-01-11,MILWAUKEE_BUCKS,OKLAHOMA_CITY_THUNDER,85,101,1861,16
1861,2014-01-12,2014-01-11,NEW_ORLEANS_PELICANS,DALLAS_MAVERICKS,107,110,1862,3
1862,2014-01-12,2014-01-11,ORLANDO_MAGIC,DENVER_NUGGETS,94,120,1863,26
1863,2014-01-12,2014-01-11,BOSTON_CELTICS,PORTLAND_TRAIL_BLAZERS,104,112,1864,8
1864,2014-01-12,2014-01-11,ATLANTA_HAWKS,MEMPHIS_GRIZZLIES,101,108,1865,7
1865,2014-01-12,2014-01-11,CLEVELAND_CAVALIERS,SACRAMENTO_KINGS,80,124,1866,44
1866,2014-01-13,2014-01-12,MINNESOTA_TIMBERWOLVES,SAN_ANTONIO_SPURS,86,104,1867,18
1867,2014-01-14,2014-01-13,MILWAUKEE_BUCKS,TORONTO_RAPTORS,94,116,1868,22
1868,2014-01-14,2014-01-13,HOUSTON_ROCKETS,BOSTON_CELTICS,104,92,1869,12
1869,2014-01-14,2014-01-13,PHOENIX_SUNS,NEW_YORK_KNICKS,96,98,1870,2
1870,2014-01-14,2014-01-13,WASHINGTON_WIZARDS,CHICAGO_BULLS,102,88,1871,14
1871,2014-01-14,2014-01-13,SAN_ANTONIO_SPURS,NEW_ORLEANS_PELICANS,101,95,1872,6
1872,2014-01-14,2014-01-13,ORLANDO_MAGIC,DALLAS_MAVERICKS,88,107,1873,19
1873,2014-01-14,2014-01-13,DENVER_NUGGETS,UTAH_JAZZ,103,118,1874,15
1874,2014-01-15,2014-01-14,NEW_YORK_KNICKS,CHARLOTTE_BOBCATS,98,108,1875,10
1875,2014-01-15,2014-01-14,SACRAMENTO_KINGS,INDIANA_PACERS,92,116,1876,24
1876,2014-01-15,2014-01-14,OKLAHOMA_CITY_THUNDER,MEMPHIS_GRIZZLIES,87,90,1877,3
1877,2014-01-15,2014-01-14,CLEVELAND_CAVALIERS,LOS_ANGELES_LAKERS,120,118,1878,2
1878,2014-01-16,2014-01-15,CHICAGO_BULLS,ORLANDO_MAGIC,128,125,1879,3
1879,2014-01-16,2014-01-15,CHARLOTTE_BOBCATS,PHILADELPHIA_76ERS,92,95,1880,3
1880,2014-01-16,2014-01-15,MIAMI_HEAT,WASHINGTON_WIZARDS,97,114,1881,17
1881,2014-01-16,2014-01-15,TORONTO_RAPTORS,BOSTON_CELTICS,83,88,1882,5
1882,2014-01-16,2014-01-15,MEMPHIS_GRIZZLIES,MILWAUKEE_BUCKS,82,77,1883,5
1883,2014-01-16,2014-01-15,SACRAMENTO_KINGS,MINNESOTA_TIMBERWOLVES,111,108,1884,3
1884,2014-01-16,2014-01-15,HOUSTON_ROCKETS,NEW_ORLEANS_PELICANS,103,100,1885,3
1885,2014-01-16,2014-01-15,UTAH_JAZZ,SAN_ANTONIO_SPURS,105,109,1886,4
1886,2014-01-16,2014-01-15,LOS_ANGELES_LAKERS,PHOENIX_SUNS,114,121,1887,7
1887,2014-01-16,2014-01-15,CLEVELAND_CAVALIERS,PORTLAND_TRAIL_BLAZERS,96,108,1888,12
1888,2014-01-16,2014-01-15,DENVER_NUGGETS,GOLDEN_STATE_WARRIORS,123,116,1889,7
1889,2014-01-16,2014-01-15,DALLAS_MAVERICKS,LOS_ANGELES_CLIPPERS,127,129,1890,2
1890,2014-01-16,2014-01-15,BROOKLYN_NETS,ATLANTA_HAWKS,127,110,1891,17
1891,2014-01-17,2014-01-16,NEW_YORK_KNICKS,INDIANA_PACERS,89,117,1892,28
1892,2014-01-17,2014-01-16,OKLAHOMA_CITY_THUNDER,HOUSTON_ROCKETS,104,92,1893,12
1893,2014-01-18,2014-01-17,LOS_ANGELES_CLIPPERS,NEW_YORK_KNICKS,109,95,1894,14
1894,2014-01-18,2014-01-17,CHARLOTTE_BOBCATS,ORLANDO_MAGIC,111,101,1895,10
1895,2014-01-18,2014-01-17,MIAMI_HEAT,PHILADELPHIA_76ERS,101,86,1896,15
1896,2014-01-18,2014-01-17,MINNESOTA_TIMBERWOLVES,TORONTO_RAPTORS,89,94,1897,5
1897,2014-01-18,2014-01-17,CHICAGO_BULLS,WASHINGTON_WIZARDS,93,96,1898,3
1898,2014-01-18,2014-01-17,LOS_ANGELES_LAKERS,BOSTON_CELTICS,107,104,1899,3
1899,2014-01-18,2014-01-17,UTAH_JAZZ,DETROIT_PISTONS,110,89,1900,21
1900,2014-01-18,2014-01-17,SACRAMENTO_KINGS,MEMPHIS_GRIZZLIES,90,91,1901,1
1901,2014-01-18,2014-01-17,PORTLAND_TRAIL_BLAZERS,SAN_ANTONIO_SPURS,109,100,1902,9
1902,2014-01-18,2014-01-17,CLEVELAND_CAVALIERS,DENVER_NUGGETS,117,109,1903,8
1903,2014-01-18,2014-01-17,DALLAS_MAVERICKS,PHOENIX_SUNS,110,107,1904,3
1904,2014-01-18,2014-01-17,GOLDEN_STATE_WARRIORS,OKLAHOMA_CITY_THUNDER,121,127,1905,6
1905,2014-01-19,2014-01-18,LOS_ANGELES_CLIPPERS,INDIANA_PACERS,92,106,1906,14
1906,2014-01-19,2014-01-18,DETROIT_PISTONS,WASHINGTON_WIZARDS,104,98,1907,6
1907,2014-01-19,2014-01-18,MIAMI_HEAT,CHARLOTTE_BOBCATS,104,96,1908,8
1908,2014-01-19,2014-01-18,PHILADELPHIA_76ERS,CHICAGO_BULLS,78,103,1909,25
1909,2014-01-19,2014-01-18,MILWAUKEE_BUCKS,HOUSTON_ROCKETS,104,114,1910,10
1910,2014-01-19,2014-01-18,UTAH_JAZZ,MINNESOTA_TIMBERWOLVES,72,98,1911,26
1911,2014-01-19,2014-01-18,GOLDEN_STATE_WARRIORS,NEW_ORLEANS_PELICANS,97,87,1912,10
1912,2014-01-19,2014-01-18,PORTLAND_TRAIL_BLAZERS,DALLAS_MAVERICKS,127,111,1913,16
1913,2014-01-19,2014-01-18,LOS_ANGELES_LAKERS,TORONTO_RAPTORS,112,106,1914,6
1914,2014-01-19,2014-01-18,BOSTON_CELTICS,ORLANDO_MAGIC,91,93,1915,2
1915,2014-01-20,2014-01-19,SACRAMENTO_KINGS,OKLAHOMA_CITY_THUNDER,93,108,1916,15
1916,2014-01-20,2014-01-19,MILWAUKEE_BUCKS,SAN_ANTONIO_SPURS,82,110,1917,28
1917,2014-01-20,2014-01-19,DENVER_NUGGETS,PHOENIX_SUNS,103,117,1918,14
1918,2014-01-20,2014-01-19,DALLAS_MAVERICKS,CLEVELAND_CAVALIERS,102,97,1919,5
1919,2014-01-20,2014-01-19,LOS_ANGELES_CLIPPERS,DETROIT_PISTONS,112,103,1920,9
1920,2014-01-20,2014-01-19,TORONTO_RAPTORS,CHARLOTTE_BOBCATS,95,100,1921,5
1921,2014-01-20,2014-01-19,PHILADELPHIA_76ERS,WASHINGTON_WIZARDS,99,107,1922,8
1922,2014-01-20,2014-01-19,BROOKLYN_NETS,NEW_YORK_KNICKS,103,80,1923,23
1923,2014-01-20,2014-01-19,NEW_ORLEANS_PELICANS,MEMPHIS_GRIZZLIES,95,92,1924,3
1924,2014-01-20,2014-01-19,MIAMI_HEAT,ATLANTA_HAWKS,114,121,1925,7
1925,2014-01-21,2014-01-20,LOS_ANGELES_LAKERS,CHICAGO_BULLS,100,102,1926,2
1926,2014-01-21,2014-01-20,PORTLAND_TRAIL_BLAZERS,HOUSTON_ROCKETS,113,126,1927,13
1927,2014-01-21,2014-01-20,INDIANA_PACERS,GOLDEN_STATE_WARRIORS,102,94,1928,8
1928,2014-01-22,2014-01-21,ORLANDO_MAGIC,BROOKLYN_NETS,90,101,1929,11
1929,2014-01-22,2014-01-21,BOSTON_CELTICS,MIAMI_HEAT,86,93,1930,7
1930,2014-01-22,2014-01-21,SACRAMENTO_KINGS,NEW_ORLEANS_PELICANS,114,97,1931,17
1931,2014-01-22,2014-01-21,PORTLAND_TRAIL_BLAZERS,OKLAHOMA_CITY_THUNDER,97,105,1932,8
1932,2014-01-22,2014-01-21,MINNESOTA_TIMBERWOLVES,UTAH_JAZZ,112,97,1933,15
1933,2014-01-23,2014-01-22,LOS_ANGELES_CLIPPERS,CHARLOTTE_BOBCATS,91,95,1934,4
1934,2014-01-23,2014-01-22,CHICAGO_BULLS,CLEVELAND_CAVALIERS,98,87,1935,11
1935,2014-01-23,2014-01-22,ATLANTA_HAWKS,ORLANDO_MAGIC,112,109,1936,3
1936,2014-01-23,2014-01-22,DALLAS_MAVERICKS,TORONTO_RAPTORS,85,93,1937,8
1937,2014-01-23,2014-01-22,BOSTON_CELTICS,WASHINGTON_WIZARDS,113,111,1938,2
1938,2014-01-23,2014-01-22,PHILADELPHIA_76ERS,NEW_YORK_KNICKS,110,106,1939,4
1939,2014-01-23,2014-01-22,SACRAMENTO_KINGS,HOUSTON_ROCKETS,98,119,1940,21
1940,2014-01-23,2014-01-22,DETROIT_PISTONS,MILWAUKEE_BUCKS,101,104,1941,3
1941,2014-01-23,2014-01-22,OKLAHOMA_CITY_THUNDER,SAN_ANTONIO_SPURS,111,105,1942,6
1942,2014-01-23,2014-01-22,INDIANA_PACERS,PHOENIX_SUNS,100,124,1943,24
1943,2014-01-24,2014-01-23,LOS_ANGELES_LAKERS,MIAMI_HEAT,102,109,1944,7
1944,2014-01-24,2014-01-23,DENVER_NUGGETS,PORTLAND_TRAIL_BLAZERS,105,110,1945,5
1945,2014-01-25,2014-01-24,LOS_ANGELES_LAKERS,ORLANDO_MAGIC,105,114,1946,9
1946,2014-01-25,2014-01-24,TORONTO_RAPTORS,PHILADELPHIA_76ERS,104,95,1947,9
1947,2014-01-25,2014-01-24,SAN_ANTONIO_SPURS,ATLANTA_HAWKS,105,79,1948,26
1948,2014-01-25,2014-01-24,OKLAHOMA_CITY_THUNDER,BOSTON_CELTICS,101,83,1949,18
1949,2014-01-25,2014-01-24,DALLAS_MAVERICKS,BROOKLYN_NETS,106,107,1950,1
1950,2014-01-25,2014-01-24,MILWAUKEE_BUCKS,CLEVELAND_CAVALIERS,78,93,1951,15
1951,2014-01-25,2014-01-24,NEW_ORLEANS_PELICANS,DETROIT_PISTONS,103,101,1952,2
1952,2014-01-25,2014-01-24,CHARLOTTE_BOBCATS,NEW_YORK_KNICKS,96,125,1953,29
1953,2014-01-25,2014-01-24,LOS_ANGELES_CLIPPERS,CHICAGO_BULLS,112,95,1954,17
1954,2014-01-25,2014-01-24,MEMPHIS_GRIZZLIES,HOUSTON_ROCKETS,88,87,1955,1
1955,2014-01-25,2014-01-24,WASHINGTON_WIZARDS,PHOENIX_SUNS,101,95,1956,6
1956,2014-01-25,2014-01-24,INDIANA_PACERS,SACRAMENTO_KINGS,116,111,1957,5
1957,2014-01-25,2014-01-24,MINNESOTA_TIMBERWOLVES,GOLDEN_STATE_WARRIORS,121,120,1958,1
1958,2014-01-26,2014-01-25,CHICAGO_BULLS,CHARLOTTE_BOBCATS,89,87,1959,2
1959,2014-01-26,2014-01-25,LOS_ANGELES_CLIPPERS,TORONTO_RAPTORS,126,118,1960,8
1960,2014-01-26,2014-01-25,OKLAHOMA_CITY_THUNDER,PHILADELPHIA_76ERS,103,91,1961,12
1961,2014-01-26,2014-01-25,HOUSTON_ROCKETS,MEMPHIS_GRIZZLIES,81,99,1962,18
1962,2014-01-26,2014-01-25,ATLANTA_HAWKS,MILWAUKEE_BUCKS,112,87,1963,25
1963,2014-01-26,2014-01-25,INDIANA_PACERS,DENVER_NUGGETS,96,109,1964,13
1964,2014-01-26,2014-01-25,WASHINGTON_WIZARDS,UTAH_JAZZ,101,104,1965,3
1965,2014-01-26,2014-01-25,MINNESOTA_TIMBERWOLVES,PORTLAND_TRAIL_BLAZERS,104,115,1966,11
1966,2014-01-26,2014-01-25,SAN_ANTONIO_SPURS,MIAMI_HEAT,101,113,1967,12
1967,2014-01-26,2014-01-25,LOS_ANGELES_LAKERS,NEW_YORK_KNICKS,103,110,1968,7
1968,2014-01-26,2014-01-25,PHOENIX_SUNS,CLEVELAND_CAVALIERS,99,90,1969,9
1969,2014-01-26,2014-01-25,ORLANDO_MAGIC,NEW_ORLEANS_PELICANS,92,100,1970,8
1970,2014-01-26,2014-01-25,BROOKLYN_NETS,BOSTON_CELTICS,85,79,1971,6
1971,2014-01-27,2014-01-26,DETROIT_PISTONS,DALLAS_MAVERICKS,106,116,1972,10
1972,2014-01-27,2014-01-26,PORTLAND_TRAIL_BLAZERS,GOLDEN_STATE_WARRIORS,88,103,1973,15
1973,2014-01-27,2014-01-26,DENVER_NUGGETS,SACRAMENTO_KINGS,125,117,1974,8
1974,2014-01-28,2014-01-27,PHOENIX_SUNS,PHILADELPHIA_76ERS,124,113,1975,11
1975,2014-01-28,2014-01-27,TORONTO_RAPTORS,BROOKLYN_NETS,104,103,1976,1
1976,2014-01-28,2014-01-27,MINNESOTA_TIMBERWOLVES,CHICAGO_BULLS,95,86,1977,9
1977,2014-01-28,2014-01-27,LOS_ANGELES_CLIPPERS,MILWAUKEE_BUCKS,114,86,1978,28
1978,2014-01-28,2014-01-27,ATLANTA_HAWKS,OKLAHOMA_CITY_THUNDER,109,111,1979,2
1979,2014-01-28,2014-01-27,SACRAMENTO_KINGS,UTAH_JAZZ,99,106,1980,7
1980,2014-01-29,2014-01-28,NEW_ORLEANS_PELICANS,CLEVELAND_CAVALIERS,100,89,1981,11
1981,2014-01-29,2014-01-28,ORLANDO_MAGIC,DETROIT_PISTONS,87,103,1982,16
1982,2014-01-29,2014-01-28,BOSTON_CELTICS,NEW_YORK_KNICKS,88,114,1983,26
1983,2014-01-29,2014-01-28,SAN_ANTONIO_SPURS,HOUSTON_ROCKETS,90,97,1984,7
1984,2014-01-29,2014-01-28,MEMPHIS_GRIZZLIES,PORTLAND_TRAIL_BLAZERS,98,81,1985,17
1985,2014-01-29,2014-01-28,WASHINGTON_WIZARDS,GOLDEN_STATE_WARRIORS,88,85,1986,3
1986,2014-01-29,2014-01-28,INDIANA_PACERS,LOS_ANGELES_LAKERS,104,92,1987,12
1987,2014-01-30,2014-01-29,OKLAHOMA_CITY_THUNDER,MIAMI_HEAT,112,95,1988,17
1988,2014-01-30,2014-01-29,ORLANDO_MAGIC,TORONTO_RAPTORS,83,98,1989,15
1989,2014-01-30,2014-01-29,PHILADELPHIA_76ERS,BOSTON_CELTICS,95,94,1990,1
1990,2014-01-30,2014-01-29,PHOENIX_SUNS,MILWAUKEE_BUCKS,126,117,1991,9
1991,2014-01-30,2014-01-29,NEW_ORLEANS_PELICANS,MINNESOTA_TIMBERWOLVES,77,88,1992,11
1992,2014-01-30,2014-01-29,HOUSTON_ROCKETS,DALLAS_MAVERICKS,117,115,1993,2
1993,2014-01-30,2014-01-29,CHARLOTTE_BOBCATS,DENVER_NUGGETS,101,98,1994,3
1994,2014-01-30,2014-01-29,CHICAGO_BULLS,SAN_ANTONIO_SPURS,96,86,1995,10
1995,2014-01-30,2014-01-29,MEMPHIS_GRIZZLIES,SACRAMENTO_KINGS,99,89,1996,10
1996,2014-01-30,2014-01-29,WASHINGTON_WIZARDS,LOS_ANGELES_CLIPPERS,103,110,1997,7
1997,2014-01-31,2014-01-30,PHOENIX_SUNS,INDIANA_PACERS,102,94,1998,8
1998,2014-01-31,2014-01-30,CLEVELAND_CAVALIERS,NEW_YORK_KNICKS,86,117,1999,31
1999,2014-01-31,2014-01-30,LOS_ANGELES_CLIPPERS,GOLDEN_STATE_WARRIORS,92,111,2000,19
2000,2014-02-01,2014-01-31,MILWAUKEE_BUCKS,ORLANDO_MAGIC,102,113,2001,11
2001,2014-02-01,2014-01-31,ATLANTA_HAWKS,PHILADELPHIA_76ERS,125,99,2002,26
2002,2014-02-01,2014-01-31,OKLAHOMA_CITY_THUNDER,BROOKLYN_NETS,120,95,2003,25
2003,2014-02-01,2014-01-31,MEMPHIS_GRIZZLIES,MINNESOTA_TIMBERWOLVES,94,90,2004,4
2004,2014-02-01,2014-01-31,SACRAMENTO_KINGS,DALLAS_MAVERICKS,103,107,2005,4
2005,2014-02-01,2014-01-31,TORONTO_RAPTORS,DENVER_NUGGETS,100,90,2006,10
2006,2014-02-01,2014-01-31,CHARLOTTE_BOBCATS,LOS_ANGELES_LAKERS,110,100,2007,10
2007,2014-02-01,2014-01-31,GOLDEN_STATE_WARRIORS,UTAH_JAZZ,95,90,2008,5
2008,2014-02-02,2014-02-01,BROOKLYN_NETS,INDIANA_PACERS,96,97,2009,1
2009,2014-02-02,2014-02-01,OKLAHOMA_CITY_THUNDER,WASHINGTON_WIZARDS,81,96,2010,15
2010,2014-02-02,2014-02-01,MINNESOTA_TIMBERWOLVES,ATLANTA_HAWKS,113,120,2011,7
2011,2014-02-02,2014-02-01,PHILADELPHIA_76ERS,DETROIT_PISTONS,96,113,2012,17
2012,2014-02-02,2014-02-01,CLEVELAND_CAVALIERS,HOUSTON_ROCKETS,92,106,2013,14
2013,2014-02-02,2014-02-01,MILWAUKEE_BUCKS,MEMPHIS_GRIZZLIES,90,99,2014,9
2014,2014-02-02,2014-02-01,CHICAGO_BULLS,NEW_ORLEANS_PELICANS,79,88,2015,9
2015,2014-02-02,2014-02-01,MIAMI_HEAT,NEW_YORK_KNICKS,106,91,2016,15
2016,2014-02-02,2014-02-01,SACRAMENTO_KINGS,SAN_ANTONIO_SPURS,93,95,2017,2
2017,2014-02-02,2014-02-01,CHARLOTTE_BOBCATS,PHOENIX_SUNS,95,105,2018,10
2018,2014-02-02,2014-02-01,TORONTO_RAPTORS,PORTLAND_TRAIL_BLAZERS,103,106,2019,3
2019,2014-02-02,2014-02-01,UTAH_JAZZ,LOS_ANGELES_CLIPPERS,87,102,2020,15
2020,2014-02-02,2014-02-01,ORLANDO_MAGIC,BOSTON_CELTICS,89,96,2021,7
2021,2014-02-04,2014-02-03,ORLANDO_MAGIC,INDIANA_PACERS,79,98,2022,19
2022,2014-02-04,2014-02-03,PORTLAND_TRAIL_BLAZERS,WASHINGTON_WIZARDS,90,100,2023,10
2023,2014-02-04,2014-02-03,PHILADELPHIA_76ERS,BROOKLYN_NETS,102,108,2024,6
2024,2014-02-04,2014-02-03,DETROIT_PISTONS,MIAMI_HEAT,96,102,2025,6
2025,2014-02-04,2014-02-03,NEW_YORK_KNICKS,MILWAUKEE_BUCKS,98,101,2026,3
2026,2014-02-04,2014-02-03,SAN_ANTONIO_SPURS,NEW_ORLEANS_PELICANS,102,95,2027,7
2027,2014-02-04,2014-02-03,MEMPHIS_GRIZZLIES,OKLAHOMA_CITY_THUNDER,77,86,2028,9
2028,2014-02-04,2014-02-03,CLEVELAND_CAVALIERS,DALLAS_MAVERICKS,107,124,2029,17
2029,2014-02-04,2014-02-03,LOS_ANGELES_CLIPPERS,DENVER_NUGGETS,115,116,2030,1
2030,2014-02-04,2014-02-03,TORONTO_RAPTORS,UTAH_JAZZ,94,79,2031,15
2031,2014-02-04,2014-02-03,CHICAGO_BULLS,SACRAMENTO_KINGS,70,99,2032,29
2032,2014-02-05,2014-02-04,INDIANA_PACERS,ATLANTA_HAWKS,89,85,2033,4
2033,2014-02-05,2014-02-04,LOS_ANGELES_LAKERS,MINNESOTA_TIMBERWOLVES,99,109,2034,10
2034,2014-02-05,2014-02-04,CHICAGO_BULLS,PHOENIX_SUNS,101,92,2035,9
2035,2014-02-05,2014-02-04,CHARLOTTE_BOBCATS,GOLDEN_STATE_WARRIORS,91,75,2036,16
2036,2014-02-06,2014-02-05,LOS_ANGELES_LAKERS,CLEVELAND_CAVALIERS,119,108,2037,11
2037,2014-02-06,2014-02-05,DETROIT_PISTONS,ORLANDO_MAGIC,98,112,2038,14
2038,2014-02-06,2014-02-05,BOSTON_CELTICS,PHILADELPHIA_76ERS,114,108,2039,6
2039,2014-02-06,2014-02-05,SAN_ANTONIO_SPURS,WASHINGTON_WIZARDS,125,118,2040,7
2040,2014-02-06,2014-02-05,PHOENIX_SUNS,HOUSTON_ROCKETS,108,122,2041,14
2041,2014-02-06,2014-02-05,DALLAS_MAVERICKS,MEMPHIS_GRIZZLIES,110,96,2042,14
2042,2014-02-06,2014-02-05,ATLANTA_HAWKS,NEW_ORLEANS_PELICANS,100,105,2043,5
2043,2014-02-06,2014-02-05,PORTLAND_TRAIL_BLAZERS,NEW_YORK_KNICKS,94,90,2044,4
2044,2014-02-06,2014-02-05,MINNESOTA_TIMBERWOLVES,OKLAHOMA_CITY_THUNDER,97,106,2045,9
2045,2014-02-06,2014-02-05,MILWAUKEE_BUCKS,DENVER_NUGGETS,100,110,2046,10
2046,2014-02-06,2014-02-05,TORONTO_RAPTORS,SACRAMENTO_KINGS,101,109,2047,8
2047,2014-02-06,2014-02-05,MIAMI_HEAT,LOS_ANGELES_CLIPPERS,116,112,2048,4
2048,2014-02-07,2014-02-06,SAN_ANTONIO_SPURS,BROOKLYN_NETS,89,103,2049,14
2049,2014-02-07,2014-02-06,CHICAGO_BULLS,GOLDEN_STATE_WARRIORS,87,102,2050,15
2050,2014-02-08,2014-02-07,PORTLAND_TRAIL_BLAZERS,INDIANA_PACERS,113,118,2051,5
2051,2014-02-08,2014-02-07,OKLAHOMA_CITY_THUNDER,ORLANDO_MAGIC,102,103,2052,1
2052,2014-02-08,2014-02-07,LOS_ANGELES_LAKERS,PHILADELPHIA_76ERS,112,98,2053,14
2053,2014-02-08,2014-02-07,CLEVELAND_CAVALIERS,WASHINGTON_WIZARDS,115,113,2054,2
2054,2014-02-08,2014-02-07,SACRAMENTO_KINGS,BOSTON_CELTICS,89,99,2055,10
2055,2014-02-08,2014-02-07,BROOKLYN_NETS,DETROIT_PISTONS,95,111,2056,16
2056,2014-02-08,2014-02-07,DENVER_NUGGETS,NEW_YORK_KNICKS,90,117,2057,27
2057,2014-02-08,2014-02-07,UTAH_JAZZ,DALLAS_MAVERICKS,81,103,2058,22
2058,2014-02-08,2014-02-07,MINNESOTA_TIMBERWOLVES,NEW_ORLEANS_PELICANS,91,98,2059,7
2059,2014-02-08,2014-02-07,TORONTO_RAPTORS,LOS_ANGELES_CLIPPERS,105,118,2060,13
2060,2014-02-09,2014-02-08,SAN_ANTONIO_SPURS,CHARLOTTE_BOBCATS,104,100,2061,4
2061,2014-02-09,2014-02-08,MEMPHIS_GRIZZLIES,ATLANTA_HAWKS,79,76,2062,3
2062,2014-02-09,2014-02-08,DENVER_NUGGETS,DETROIT_PISTONS,109,126,2063,17
2063,2014-02-09,2014-02-08,PORTLAND_TRAIL_BLAZERS,MINNESOTA_TIMBERWOLVES,117,110,2064,7
2064,2014-02-09,2014-02-08,HOUSTON_ROCKETS,MILWAUKEE_BUCKS,101,95,2065,6
2065,2014-02-09,2014-02-08,GOLDEN_STATE_WARRIORS,PHOENIX_SUNS,109,122,2066,13
2066,2014-02-09,2014-02-08,MIAMI_HEAT,UTAH_JAZZ,89,94,2067,5
2067,2014-02-09,2014-02-08,NEW_YORK_KNICKS,OKLAHOMA_CITY_THUNDER,100,112,2068,12
2068,2014-02-09,2014-02-08,CHICAGO_BULLS,LOS_ANGELES_LAKERS,92,86,2069,6
2069,2014-02-09,2014-02-08,DALLAS_MAVERICKS,BOSTON_CELTICS,102,91,2070,11
2070,2014-02-09,2014-02-08,NEW_ORLEANS_PELICANS,BROOKLYN_NETS,81,93,2071,12
2071,2014-02-09,2014-02-08,MEMPHIS_GRIZZLIES,CLEVELAND_CAVALIERS,83,91,2072,8
2072,2014-02-09,2014-02-08,INDIANA_PACERS,ORLANDO_MAGIC,92,93,2073,1
2073,2014-02-09,2014-02-08,SACRAMENTO_KINGS,WASHINGTON_WIZARDS,84,93,2074,9
2074,2014-02-10,2014-02-09,PHILADELPHIA_76ERS,LOS_ANGELES_CLIPPERS,78,123,2075,45
2075,2014-02-11,2014-02-10,DENVER_NUGGETS,INDIANA_PACERS,80,119,2076,39
2076,2014-02-11,2014-02-10,NEW_ORLEANS_PELICANS,TORONTO_RAPTORS,101,108,2077,7
2077,2014-02-11,2014-02-10,SAN_ANTONIO_SPURS,DETROIT_PISTONS,100,109,2078,9
2078,2014-02-11,2014-02-10,BOSTON_CELTICS,MILWAUKEE_BUCKS,102,86,2079,16
2079,2014-02-11,2014-02-10,HOUSTON_ROCKETS,MINNESOTA_TIMBERWOLVES,107,89,2080,18
2080,2014-02-11,2014-02-10,PHILADELPHIA_76ERS,GOLDEN_STATE_WARRIORS,80,123,2081,43
2081,2014-02-12,2014-02-11,DALLAS_MAVERICKS,CHARLOTTE_BOBCATS,89,114,2082,25
2082,2014-02-12,2014-02-11,SACRAMENTO_KINGS,CLEVELAND_CAVALIERS,99,109,2083,10
2083,2014-02-12,2014-02-11,ATLANTA_HAWKS,CHICAGO_BULLS,85,100,2084,15
2084,2014-02-12,2014-02-11,WASHINGTON_WIZARDS,MEMPHIS_GRIZZLIES,89,92,2085,3
2085,2014-02-12,2014-02-11,MIAMI_HEAT,PHOENIX_SUNS,103,97,2086,6
2086,2014-02-12,2014-02-11,OKLAHOMA_CITY_THUNDER,PORTLAND_TRAIL_BLAZERS,98,95,2087,3
2087,2014-02-12,2014-02-11,UTAH_JAZZ,LOS_ANGELES_LAKERS,96,79,2088,17
2088,2014-02-13,2014-02-12,DALLAS_MAVERICKS,INDIANA_PACERS,81,73,2089,8
2089,2014-02-13,2014-02-12,MEMPHIS_GRIZZLIES,ORLANDO_MAGIC,86,81,2090,5
2090,2014-02-13,2014-02-12,ATLANTA_HAWKS,TORONTO_RAPTORS,83,104,2091,21
2091,2014-02-13,2014-02-12,SAN_ANTONIO_SPURS,BOSTON_CELTICS,104,92,2092,12
2092,2014-02-13,2014-02-12,CHARLOTTE_BOBCATS,BROOKLYN_NETS,89,105,2093,16
2093,2014-02-13,2014-02-12,CLEVELAND_CAVALIERS,DETROIT_PISTONS,93,89,2094,4
2094,2014-02-13,2014-02-12,SACRAMENTO_KINGS,NEW_YORK_KNICKS,106,101,2095,5
2095,2014-02-13,2014-02-12,WASHINGTON_WIZARDS,HOUSTON_ROCKETS,112,113,2096,1
2096,2014-02-13,2014-02-12,NEW_ORLEANS_PELICANS,MILWAUKEE_BUCKS,102,98,2097,4
2097,2014-02-13,2014-02-12,DENVER_NUGGETS,MINNESOTA_TIMBERWOLVES,90,117,2098,27
2098,2014-02-13,2014-02-12,PHILADELPHIA_76ERS,UTAH_JAZZ,100,105,2099,5
2099,2014-02-13,2014-02-12,MIAMI_HEAT,GOLDEN_STATE_WARRIORS,111,110,2100,1
2100,2014-02-13,2014-02-12,PORTLAND_TRAIL_BLAZERS,LOS_ANGELES_CLIPPERS,117,122,2101,5
2101,2014-02-14,2014-02-13,BROOKLYN_NETS,CHICAGO_BULLS,76,92,2102,16
2102,2014-02-14,2014-02-13,OKLAHOMA_CITY_THUNDER,LOS_ANGELES_LAKERS,107,103,2103,4
2103,2014-02-19,2014-02-18,ATLANTA_HAWKS,INDIANA_PACERS,98,108,2104,10
2104,2014-02-19,2014-02-18,CLEVELAND_CAVALIERS,PHILADELPHIA_76ERS,114,85,2105,29
2105,2014-02-19,2014-02-18,TORONTO_RAPTORS,WASHINGTON_WIZARDS,103,93,2106,10
2106,2014-02-19,2014-02-18,CHARLOTTE_BOBCATS,DETROIT_PISTONS,108,96,2107,12
2107,2014-02-19,2014-02-18,NEW_YORK_KNICKS,MEMPHIS_GRIZZLIES,93,98,2108,5
2108,2014-02-19,2014-02-18,ORLANDO_MAGIC,MILWAUKEE_BUCKS,100,104,2109,4
2109,2014-02-19,2014-02-18,MIAMI_HEAT,DALLAS_MAVERICKS,117,106,2110,11
2110,2014-02-19,2014-02-18,PHOENIX_SUNS,DENVER_NUGGETS,112,107,2111,5
2111,2014-02-19,2014-02-18,SAN_ANTONIO_SPURS,LOS_ANGELES_CLIPPERS,113,103,2112,10
2112,2014-02-20,2014-02-19,DETROIT_PISTONS,CHARLOTTE_BOBCATS,98,116,2113,18
2113,2014-02-20,2014-02-19,ORLANDO_MAGIC,CLEVELAND_CAVALIERS,93,101,2114,8
2114,2014-02-20,2014-02-19,CHICAGO_BULLS,TORONTO_RAPTORS,94,92,2115,2
2115,2014-02-20,2014-02-19,WASHINGTON_WIZARDS,ATLANTA_HAWKS,114,97,2116,17
2116,2014-02-20,2014-02-19,INDIANA_PACERS,MINNESOTA_TIMBERWOLVES,91,104,2117,13
2117,2014-02-20,2014-02-19,NEW_YORK_KNICKS,NEW_ORLEANS_PELICANS,98,91,2118,7
2118,2014-02-20,2014-02-19,BOSTON_CELTICS,PHOENIX_SUNS,94,100,2119,6
2119,2014-02-20,2014-02-19,BROOKLYN_NETS,UTAH_JAZZ,105,99,2120,6
2120,2014-02-20,2014-02-19,SAN_ANTONIO_SPURS,PORTLAND_TRAIL_BLAZERS,111,109,2121,2
2121,2014-02-20,2014-02-19,GOLDEN_STATE_WARRIORS,SACRAMENTO_KINGS,101,92,2122,9
2122,2014-02-20,2014-02-19,HOUSTON_ROCKETS,LOS_ANGELES_LAKERS,134,108,2123,26
2123,2014-02-21,2014-02-20,DENVER_NUGGETS,MILWAUKEE_BUCKS,101,90,2124,11
2124,2014-02-21,2014-02-20,MIAMI_HEAT,OKLAHOMA_CITY_THUNDER,103,81,2125,22
2125,2014-02-21,2014-02-20,HOUSTON_ROCKETS,GOLDEN_STATE_WARRIORS,99,102,2126,3
2126,2014-02-22,2014-02-21,NEW_ORLEANS_PELICANS,CHARLOTTE_BOBCATS,87,90,2127,3
2127,2014-02-22,2014-02-21,NEW_YORK_KNICKS,ORLANDO_MAGIC,121,129,2128,8
2128,2014-02-22,2014-02-21,DALLAS_MAVERICKS,PHILADELPHIA_76ERS,124,112,2129,12
2129,2014-02-22,2014-02-21,CLEVELAND_CAVALIERS,TORONTO_RAPTORS,91,98,2130,7
2130,2014-02-22,2014-02-21,ATLANTA_HAWKS,DETROIT_PISTONS,107,115,2131,8
2131,2014-02-22,2014-02-21,DENVER_NUGGETS,CHICAGO_BULLS,89,117,2132,28
2132,2014-02-22,2014-02-21,LOS_ANGELES_CLIPPERS,MEMPHIS_GRIZZLIES,96,102,2133,6
2133,2014-02-22,2014-02-21,SAN_ANTONIO_SPURS,PHOENIX_SUNS,85,106,2134,21
2134,2014-02-22,2014-02-21,UTAH_JAZZ,PORTLAND_TRAIL_BLAZERS,94,102,2135,8
2135,2014-02-22,2014-02-21,BOSTON_CELTICS,LOS_ANGELES_LAKERS,92,101,2136,9
2136,2014-02-23,2014-02-22,MEMPHIS_GRIZZLIES,CHARLOTTE_BOBCATS,89,92,2137,3
2137,2014-02-23,2014-02-22,NEW_ORLEANS_PELICANS,WASHINGTON_WIZARDS,93,94,2138,1
2138,2014-02-23,2014-02-22,NEW_YORK_KNICKS,ATLANTA_HAWKS,98,107,2139,9
2139,2014-02-23,2014-02-22,DALLAS_MAVERICKS,DETROIT_PISTONS,113,102,2140,11
2140,2014-02-23,2014-02-22,INDIANA_PACERS,MILWAUKEE_BUCKS,110,100,2141,10
2141,2014-02-23,2014-02-22,MINNESOTA_TIMBERWOLVES,UTAH_JAZZ,121,104,2142,17
2142,2014-02-23,2014-02-22,BOSTON_CELTICS,SACRAMENTO_KINGS,98,105,2143,7
2143,2014-02-23,2014-02-22,BROOKLYN_NETS,GOLDEN_STATE_WARRIORS,86,93,2144,7
2144,2014-02-23,2014-02-22,LOS_ANGELES_CLIPPERS,OKLAHOMA_CITY_THUNDER,125,117,2145,8
2145,2014-02-23,2014-02-22,CHICAGO_BULLS,MIAMI_HEAT,79,93,2146,14
2146,2014-02-23,2014-02-22,WASHINGTON_WIZARDS,CLEVELAND_CAVALIERS,96,83,2147,13
2147,2014-02-23,2014-02-22,ORLANDO_MAGIC,TORONTO_RAPTORS,90,105,2148,15
2148,2014-02-24,2014-02-23,SACRAMENTO_KINGS,DENVER_NUGGETS,109,95,2149,14
2149,2014-02-24,2014-02-23,BROOKLYN_NETS,LOS_ANGELES_LAKERS,108,102,2150,6
2150,2014-02-24,2014-02-23,HOUSTON_ROCKETS,PHOENIX_SUNS,115,112,2151,3
2151,2014-02-24,2014-02-23,MINNESOTA_TIMBERWOLVES,PORTLAND_TRAIL_BLAZERS,97,108,2152,11
2152,2014-02-25,2014-02-24,MILWAUKEE_BUCKS,PHILADELPHIA_76ERS,130,110,2153,20
2153,2014-02-25,2014-02-24,GOLDEN_STATE_WARRIORS,DETROIT_PISTONS,104,96,2154,8
2154,2014-02-25,2014-02-24,DALLAS_MAVERICKS,NEW_YORK_KNICKS,110,108,2155,2
2155,2014-02-25,2014-02-24,LOS_ANGELES_CLIPPERS,NEW_ORLEANS_PELICANS,123,110,2156,13
2156,2014-02-25,2014-02-24,BOSTON_CELTICS,UTAH_JAZZ,98,110,2157,12
2157,2014-02-26,2014-02-25,TORONTO_RAPTORS,CLEVELAND_CAVALIERS,99,93,2158,6
2158,2014-02-26,2014-02-25,LOS_ANGELES_LAKERS,INDIANA_PACERS,98,118,2159,20
2159,2014-02-26,2014-02-25,ORLANDO_MAGIC,WASHINGTON_WIZARDS,106,115,2160,9
2160,2014-02-26,2014-02-25,CHICAGO_BULLS,ATLANTA_HAWKS,107,103,2161,4
2161,2014-02-26,2014-02-25,PORTLAND_TRAIL_BLAZERS,DENVER_NUGGETS,100,95,2162,5
2162,2014-02-26,2014-02-25,MINNESOTA_TIMBERWOLVES,PHOENIX_SUNS,110,101,2163,9
2163,2014-02-26,2014-02-25,HOUSTON_ROCKETS,SACRAMENTO_KINGS,129,103,2164,26
2164,2014-02-27,2014-02-26,ORLANDO_MAGIC,PHILADELPHIA_76ERS,101,90,2165,11
2165,2014-02-27,2014-02-26,ATLANTA_HAWKS,BOSTON_CELTICS,104,115,2166,11
2166,2014-02-27,2014-02-26,GOLDEN_STATE_WARRIORS,CHICAGO_BULLS,83,103,2167,20
2167,2014-02-27,2014-02-26,NEW_ORLEANS_PELICANS,DALLAS_MAVERICKS,89,108,2168,19
2168,2014-02-27,2014-02-26,LOS_ANGELES_LAKERS,MEMPHIS_GRIZZLIES,103,108,2169,5
2169,2014-02-27,2014-02-26,CLEVELAND_CAVALIERS,OKLAHOMA_CITY_THUNDER,114,104,2170,10
2170,2014-02-27,2014-02-26,DETROIT_PISTONS,SAN_ANTONIO_SPURS,110,120,2171,10
2171,2014-02-27,2014-02-26,PHOENIX_SUNS,UTAH_JAZZ,86,109,2172,23
2172,2014-02-27,2014-02-26,BROOKLYN_NETS,PORTLAND_TRAIL_BLAZERS,80,124,2173,44
2173,2014-02-27,2014-02-26,HOUSTON_ROCKETS,LOS_ANGELES_CLIPPERS,93,101,2174,8
2174,2014-02-28,2014-02-27,MILWAUKEE_BUCKS,INDIANA_PACERS,96,101,2175,5
2175,2014-02-28,2014-02-27,WASHINGTON_WIZARDS,TORONTO_RAPTORS,134,129,2176,5
2176,2014-02-28,2014-02-27,NEW_YORK_KNICKS,MIAMI_HEAT,82,108,2177,26
2177,2014-02-28,2014-02-27,BROOKLYN_NETS,DENVER_NUGGETS,112,89,2178,23
2178,2014-03-01,2014-02-28,UTAH_JAZZ,CLEVELAND_CAVALIERS,79,99,2179,20
2179,2014-03-01,2014-02-28,GOLDEN_STATE_WARRIORS,NEW_YORK_KNICKS,126,103,2180,23
2180,2014-03-01,2014-02-28,MEMPHIS_GRIZZLIES,OKLAHOMA_CITY_THUNDER,107,113,2181,6
2181,2014-03-01,2014-02-28,CHICAGO_BULLS,DALLAS_MAVERICKS,100,91,2182,9
2182,2014-03-01,2014-02-28,CHARLOTTE_BOBCATS,SAN_ANTONIO_SPURS,82,92,2183,10
2183,2014-03-01,2014-02-28,SACRAMENTO_KINGS,LOS_ANGELES_LAKERS,122,126,2184,4
2184,2014-03-01,2014-02-28,NEW_ORLEANS_PELICANS,PHOENIX_SUNS,104,116,2185,12
2185,2014-03-02,2014-03-01,ORLANDO_MAGIC,MIAMI_HEAT,98,112,2186,14
2186,2014-03-02,2014-03-01,WASHINGTON_WIZARDS,PHILADELPHIA_76ERS,122,103,2187,19
2187,2014-03-02,2014-03-01,INDIANA_PACERS,BOSTON_CELTICS,102,97,2188,5
2188,2014-03-02,2014-03-01,DETROIT_PISTONS,HOUSTON_ROCKETS,110,118,2189,8
2189,2014-03-02,2014-03-01,BROOKLYN_NETS,MILWAUKEE_BUCKS,107,98,2190,9
2190,2014-03-02,2014-03-01,CLEVELAND_CAVALIERS,MEMPHIS_GRIZZLIES,96,110,2191,14
2191,2014-03-02,2014-03-01,DENVER_NUGGETS,PORTLAND_TRAIL_BLAZERS,96,102,2192,6
2192,2014-03-02,2014-03-01,MINNESOTA_TIMBERWOLVES,SACRAMENTO_KINGS,108,97,2193,11
2193,2014-03-02,2014-03-01,NEW_ORLEANS_PELICANS,LOS_ANGELES_CLIPPERS,76,108,2194,32
2194,2014-03-02,2014-03-01,NEW_YORK_KNICKS,CHICAGO_BULLS,90,109,2195,19
2195,2014-03-02,2014-03-01,GOLDEN_STATE_WARRIORS,TORONTO_RAPTORS,98,104,2196,6
2196,2014-03-02,2014-03-01,UTAH_JAZZ,INDIANA_PACERS,91,94,2197,3
2197,2014-03-02,2014-03-01,PHILADELPHIA_76ERS,ORLANDO_MAGIC,81,92,2198,11
2198,2014-03-03,2014-03-02,CHARLOTTE_BOBCATS,OKLAHOMA_CITY_THUNDER,99,116,2199,17
2199,2014-03-03,2014-03-02,DALLAS_MAVERICKS,SAN_ANTONIO_SPURS,106,112,2200,6
2200,2014-03-03,2014-03-02,ATLANTA_HAWKS,PHOENIX_SUNS,120,129,2201,9
2201,2014-03-04,2014-03-03,MEMPHIS_GRIZZLIES,WASHINGTON_WIZARDS,110,104,2202,6
2202,2014-03-04,2014-03-03,CHICAGO_BULLS,BROOKLYN_NETS,80,96,2203,16
2203,2014-03-04,2014-03-03,NEW_YORK_KNICKS,DETROIT_PISTONS,85,96,2204,11
2204,2014-03-04,2014-03-03,CHARLOTTE_BOBCATS,MIAMI_HEAT,107,124,2205,17
2205,2014-03-04,2014-03-03,UTAH_JAZZ,MILWAUKEE_BUCKS,88,114,2206,26
2206,2014-03-04,2014-03-03,MINNESOTA_TIMBERWOLVES,DENVER_NUGGETS,132,128,2207,4
2207,2014-03-04,2014-03-03,LOS_ANGELES_LAKERS,PORTLAND_TRAIL_BLAZERS,107,106,2208,1
2208,2014-03-04,2014-03-03,NEW_ORLEANS_PELICANS,SACRAMENTO_KINGS,89,96,2209,7
2209,2014-03-05,2014-03-04,SAN_ANTONIO_SPURS,CLEVELAND_CAVALIERS,122,101,2210,21
2210,2014-03-05,2014-03-04,GOLDEN_STATE_WARRIORS,INDIANA_PACERS,98,96,2211,2
2211,2014-03-05,2014-03-04,MIAMI_HEAT,HOUSTON_ROCKETS,103,106,2212,3
2212,2014-03-05,2014-03-04,PHILADELPHIA_76ERS,OKLAHOMA_CITY_THUNDER,92,125,2213,33
2213,2014-03-05,2014-03-04,LOS_ANGELES_CLIPPERS,PHOENIX_SUNS,104,96,2214,8
2214,2014-03-05,2014-03-04,NEW_ORLEANS_PELICANS,LOS_ANGELES_LAKERS,132,125,2215,7
2215,2014-03-06,2014-03-05,INDIANA_PACERS,CHARLOTTE_BOBCATS,87,109,2216,22
2216,2014-03-06,2014-03-05,HOUSTON_ROCKETS,ORLANDO_MAGIC,101,89,2217,12
2217,2014-03-06,2014-03-05,UTAH_JAZZ,WASHINGTON_WIZARDS,91,104,2218,13
2218,2014-03-06,2014-03-05,GOLDEN_STATE_WARRIORS,BOSTON_CELTICS,108,88,2219,20
2219,2014-03-06,2014-03-05,MEMPHIS_GRIZZLIES,BROOKLYN_NETS,94,103,2220,9
2220,2014-03-06,2014-03-05,CHICAGO_BULLS,DETROIT_PISTONS,105,94,2221,11
2221,2014-03-06,2014-03-05,DALLAS_MAVERICKS,DENVER_NUGGETS,110,115,2222,5
2222,2014-03-06,2014-03-05,SACRAMENTO_KINGS,MILWAUKEE_BUCKS,116,102,2223,14
2223,2014-03-06,2014-03-05,NEW_YORK_KNICKS,MINNESOTA_TIMBERWOLVES,118,106,2224,12
2224,2014-03-06,2014-03-05,ATLANTA_HAWKS,PORTLAND_TRAIL_BLAZERS,78,102,2225,24
2225,2014-03-07,2014-03-06,MIAMI_HEAT,SAN_ANTONIO_SPURS,87,111,2226,24
2226,2014-03-07,2014-03-06,OKLAHOMA_CITY_THUNDER,PHOENIX_SUNS,122,128,2227,6
2227,2014-03-07,2014-03-06,LOS_ANGELES_CLIPPERS,LOS_ANGELES_LAKERS,142,94,2228,48
2228,2014-03-08,2014-03-07,CLEVELAND_CAVALIERS,CHARLOTTE_BOBCATS,92,101,2229,9
2229,2014-03-08,2014-03-07,MEMPHIS_GRIZZLIES,CHICAGO_BULLS,85,77,2230,8
2230,2014-03-08,2014-03-07,SACRAMENTO_KINGS,TORONTO_RAPTORS,87,99,2231,12
2231,2014-03-08,2014-03-07,BROOKLYN_NETS,BOSTON_CELTICS,84,91,2232,7
2232,2014-03-08,2014-03-07,UTAH_JAZZ,NEW_YORK_KNICKS,81,108,2233,27
2233,2014-03-08,2014-03-07,DETROIT_PISTONS,MINNESOTA_TIMBERWOLVES,101,114,2234,13
2234,2014-03-08,2014-03-07,MILWAUKEE_BUCKS,NEW_ORLEANS_PELICANS,104,112,2235,8
2235,2014-03-08,2014-03-07,PORTLAND_TRAIL_BLAZERS,DALLAS_MAVERICKS,98,103,2236,5
2236,2014-03-08,2014-03-07,LOS_ANGELES_LAKERS,DENVER_NUGGETS,126,134,2237,8
2237,2014-03-08,2014-03-07,INDIANA_PACERS,HOUSTON_ROCKETS,86,112,2238,26
2238,2014-03-08,2014-03-07,ATLANTA_HAWKS,GOLDEN_STATE_WARRIORS,97,111,2239,14
2239,2014-03-09,2014-03-08,NEW_YORK_KNICKS,CLEVELAND_CAVALIERS,107,97,2240,10
2240,2014-03-09,2014-03-08,UTAH_JAZZ,PHILADELPHIA_76ERS,104,92,2241,12
2241,2014-03-09,2014-03-08,CHARLOTTE_BOBCATS,MEMPHIS_GRIZZLIES,89,111,2242,22
2242,2014-03-09,2014-03-08,ORLANDO_MAGIC,SAN_ANTONIO_SPURS,112,121,2243,9
2243,2014-03-09,2014-03-08,WASHINGTON_WIZARDS,MILWAUKEE_BUCKS,114,107,2244,7
2244,2014-03-09,2014-03-08,ATLANTA_HAWKS,LOS_ANGELES_CLIPPERS,108,109,2245,1
2245,2014-03-09,2014-03-08,MIAMI_HEAT,CHICAGO_BULLS,88,95,2246,7
2246,2014-03-09,2014-03-08,OKLAHOMA_CITY_THUNDER,LOS_ANGELES_LAKERS,110,114,2247,4
2247,2014-03-09,2014-03-08,DETROIT_PISTONS,BOSTON_CELTICS,111,118,2248,7
2248,2014-03-09,2014-03-08,SACRAMENTO_KINGS,BROOKLYN_NETS,89,104,2249,15
2249,2014-03-09,2014-03-08,DENVER_NUGGETS,NEW_ORLEANS_PELICANS,107,111,2250,4
2250,2014-03-09,2014-03-08,PORTLAND_TRAIL_BLAZERS,HOUSTON_ROCKETS,113,118,2251,5
2251,2014-03-09,2014-03-08,TORONTO_RAPTORS,MINNESOTA_TIMBERWOLVES,111,104,2252,7
2252,2014-03-09,2014-03-08,INDIANA_PACERS,DALLAS_MAVERICKS,94,105,2253,11
2253,2014-03-10,2014-03-09,PHOENIX_SUNS,GOLDEN_STATE_WARRIORS,107,113,2254,6
2254,2014-03-10,2014-03-09,DENVER_NUGGETS,CHARLOTTE_BOBCATS,98,105,2255,7
2255,2014-03-10,2014-03-09,TORONTO_RAPTORS,BROOKLYN_NETS,97,101,2256,4
2256,2014-03-10,2014-03-09,WASHINGTON_WIZARDS,MIAMI_HEAT,90,99,2257,9
2257,2014-03-10,2014-03-09,PHILADELPHIA_76ERS,NEW_YORK_KNICKS,110,123,2258,13
2258,2014-03-11,2014-03-10,ORLANDO_MAGIC,MILWAUKEE_BUCKS,98,105,2259,7
2259,2014-03-11,2014-03-10,ATLANTA_HAWKS,UTAH_JAZZ,112,110,2260,2
2260,2014-03-11,2014-03-10,PHOENIX_SUNS,LOS_ANGELES_CLIPPERS,105,112,2261,7
2261,2014-03-11,2014-03-10,BOSTON_CELTICS,INDIANA_PACERS,83,94,2262,11
2262,2014-03-11,2014-03-10,SACRAMENTO_KINGS,DETROIT_PISTONS,89,99,2263,10
2263,2014-03-12,2014-03-11,SAN_ANTONIO_SPURS,CHICAGO_BULLS,104,96,2264,8
2264,2014-03-12,2014-03-11,PORTLAND_TRAIL_BLAZERS,MEMPHIS_GRIZZLIES,99,109,2265,10
2265,2014-03-12,2014-03-11,MILWAUKEE_BUCKS,MINNESOTA_TIMBERWOLVES,101,112,2266,11
2266,2014-03-12,2014-03-11,HOUSTON_ROCKETS,OKLAHOMA_CITY_THUNDER,98,106,2267,8
2267,2014-03-12,2014-03-11,DALLAS_MAVERICKS,GOLDEN_STATE_WARRIORS,85,108,2268,23
2268,2014-03-12,2014-03-11,BROOKLYN_NETS,MIAMI_HEAT,96,95,2269,1
2269,2014-03-12,2014-03-11,DENVER_NUGGETS,ORLANDO_MAGIC,120,112,2270,8
2270,2014-03-12,2014-03-11,SACRAMENTO_KINGS,PHILADELPHIA_76ERS,115,98,2271,17
2271,2014-03-12,2014-03-11,DETROIT_PISTONS,TORONTO_RAPTORS,87,101,2272,14
2272,2014-03-12,2014-03-11,CHARLOTTE_BOBCATS,WASHINGTON_WIZARDS,98,85,2273,13
2273,2014-03-12,2014-03-11,NEW_YORK_KNICKS,BOSTON_CELTICS,116,92,2274,24
2274,2014-03-13,2014-03-12,MEMPHIS_GRIZZLIES,NEW_ORLEANS_PELICANS,90,88,2275,2
2275,2014-03-13,2014-03-12,DALLAS_MAVERICKS,UTAH_JAZZ,108,101,2276,7
2276,2014-03-13,2014-03-12,PORTLAND_TRAIL_BLAZERS,SAN_ANTONIO_SPURS,90,103,2277,13
2277,2014-03-13,2014-03-12,CLEVELAND_CAVALIERS,PHOENIX_SUNS,110,101,2278,9
2278,2014-03-13,2014-03-12,GOLDEN_STATE_WARRIORS,LOS_ANGELES_CLIPPERS,98,111,2279,13
2279,2014-03-13,2014-03-12,HOUSTON_ROCKETS,CHICAGO_BULLS,87,111,2280,24
2280,2014-03-13,2014-03-12,MILWAUKEE_BUCKS,ATLANTA_HAWKS,97,102,2281,5
2281,2014-03-14,2014-03-13,LOS_ANGELES_LAKERS,OKLAHOMA_CITY_THUNDER,102,131,2282,29
2282,2014-03-14,2014-03-13,MINNESOTA_TIMBERWOLVES,CHARLOTTE_BOBCATS,93,105,2283,12
2283,2014-03-14,2014-03-13,WASHINGTON_WIZARDS,ORLANDO_MAGIC,105,101,2284,4
2284,2014-03-14,2014-03-13,INDIANA_PACERS,PHILADELPHIA_76ERS,101,94,2285,7
2285,2014-03-14,2014-03-13,MEMPHIS_GRIZZLIES,TORONTO_RAPTORS,86,99,2286,13
2286,2014-03-14,2014-03-13,PHOENIX_SUNS,BOSTON_CELTICS,87,80,2287,7
2287,2014-03-14,2014-03-13,DENVER_NUGGETS,MIAMI_HEAT,111,107,2288,4
2288,2014-03-15,2014-03-14,PORTLAND_TRAIL_BLAZERS,NEW_ORLEANS_PELICANS,111,103,2289,8
2289,2014-03-15,2014-03-14,LOS_ANGELES_LAKERS,SAN_ANTONIO_SPURS,85,119,2290,34
2290,2014-03-15,2014-03-14,LOS_ANGELES_CLIPPERS,UTAH_JAZZ,96,87,2291,9
2291,2014-03-15,2014-03-14,CLEVELAND_CAVALIERS,GOLDEN_STATE_WARRIORS,103,94,2292,9
2292,2014-03-15,2014-03-14,BROOKLYN_NETS,WASHINGTON_WIZARDS,94,101,2293,7
2293,2014-03-15,2014-03-14,DENVER_NUGGETS,ATLANTA_HAWKS,92,97,2294,5
2294,2014-03-15,2014-03-14,INDIANA_PACERS,DETROIT_PISTONS,112,104,2295,8
2295,2014-03-15,2014-03-14,MEMPHIS_GRIZZLIES,PHILADELPHIA_76ERS,103,77,2296,26
2296,2014-03-16,2014-03-15,SACRAMENTO_KINGS,CHICAGO_BULLS,87,94,2297,7
2297,2014-03-15,2014-03-14,MILWAUKEE_BUCKS,NEW_YORK_KNICKS,94,115,2298,21
2298,2014-03-16,2014-03-15,CHARLOTTE_BOBCATS,MILWAUKEE_BUCKS,101,92,2299,9
2299,2014-03-16,2014-03-15,PHOENIX_SUNS,TORONTO_RAPTORS,121,113,2300,8
2300,2014-03-16,2014-03-15,HOUSTON_ROCKETS,MIAMI_HEAT,104,113,2301,9
2301,2014-03-16,2014-03-15,BOSTON_CELTICS,NEW_ORLEANS_PELICANS,120,121,2302,1
2302,2014-03-16,2014-03-15,SACRAMENTO_KINGS,MINNESOTA_TIMBERWOLVES,102,104,2303,2
2303,2014-03-16,2014-03-15,DALLAS_MAVERICKS,OKLAHOMA_CITY_THUNDER,109,86,2304,23
2304,2014-03-16,2014-03-15,UTAH_JAZZ,SAN_ANTONIO_SPURS,104,122,2305,18
2305,2014-03-17,2014-03-16,GOLDEN_STATE_WARRIORS,PORTLAND_TRAIL_BLAZERS,113,112,2306,1
2306,2014-03-17,2014-03-16,CLEVELAND_CAVALIERS,LOS_ANGELES_CLIPPERS,80,102,2307,22
2307,2014-03-17,2014-03-16,ATLANTA_HAWKS,CHARLOTTE_BOBCATS,97,83,2308,14
2308,2014-03-17,2014-03-16,PHILADELPHIA_76ERS,INDIANA_PACERS,90,99,2309,9
2309,2014-03-17,2014-03-16,PHOENIX_SUNS,BROOKLYN_NETS,95,108,2310,13
2310,2014-03-18,2014-03-17,OKLAHOMA_CITY_THUNDER,CHICAGO_BULLS,97,85,2311,12
2311,2014-03-18,2014-03-17,UTAH_JAZZ,HOUSTON_ROCKETS,86,124,2312,38
2312,2014-03-18,2014-03-17,BOSTON_CELTICS,DALLAS_MAVERICKS,89,94,2313,5
2313,2014-03-18,2014-03-17,LOS_ANGELES_CLIPPERS,DENVER_NUGGETS,100,110,2314,10
2314,2014-03-18,2014-03-17,MIAMI_HEAT,CLEVELAND_CAVALIERS,100,96,2315,4
2315,2014-03-18,2014-03-17,TORONTO_RAPTORS,ATLANTA_HAWKS,113,118,2316,5
2316,2014-03-19,2014-03-18,MILWAUKEE_BUCKS,PORTLAND_TRAIL_BLAZERS,115,120,2317,5
2317,2014-03-19,2014-03-18,WASHINGTON_WIZARDS,SACRAMENTO_KINGS,111,117,2318,6
2318,2014-03-19,2014-03-18,ORLANDO_MAGIC,GOLDEN_STATE_WARRIORS,89,103,2319,14
2319,2014-03-19,2014-03-18,CHICAGO_BULLS,PHILADELPHIA_76ERS,102,94,2320,8
2320,2014-03-19,2014-03-18,MIAMI_HEAT,BOSTON_CELTICS,96,101,2321,5
2321,2014-03-19,2014-03-18,CHARLOTTE_BOBCATS,BROOKLYN_NETS,99,104,2322,5
2322,2014-03-20,2014-03-19,UTAH_JAZZ,MEMPHIS_GRIZZLIES,86,96,2323,10
2323,2014-03-20,2014-03-19,TORONTO_RAPTORS,NEW_ORLEANS_PELICANS,107,100,2324,7
2324,2014-03-20,2014-03-19,INDIANA_PACERS,NEW_YORK_KNICKS,86,92,2325,6
2325,2014-03-20,2014-03-19,MINNESOTA_TIMBERWOLVES,DALLAS_MAVERICKS,123,122,2326,1
2326,2014-03-20,2014-03-19,DETROIT_PISTONS,DENVER_NUGGETS,109,118,2327,9
2327,2014-03-20,2014-03-19,ORLANDO_MAGIC,PHOENIX_SUNS,93,109,2328,16
2328,2014-03-20,2014-03-19,SAN_ANTONIO_SPURS,LOS_ANGELES_LAKERS,125,109,2329,16
2329,2014-03-20,2014-03-19,OKLAHOMA_CITY_THUNDER,CLEVELAND_CAVALIERS,102,95,2330,7
2330,2014-03-21,2014-03-20,MINNESOTA_TIMBERWOLVES,HOUSTON_ROCKETS,106,129,2331,23
2331,2014-03-21,2014-03-20,WASHINGTON_WIZARDS,PORTLAND_TRAIL_BLAZERS,103,116,2332,13
2332,2014-03-21,2014-03-20,MILWAUKEE_BUCKS,GOLDEN_STATE_WARRIORS,110,115,2333,5
2333,2014-03-21,2014-03-20,CHICAGO_BULLS,INDIANA_PACERS,79,91,2334,12
2334,2014-03-21,2014-03-20,NEW_YORK_KNICKS,PHILADELPHIA_76ERS,93,92,2335,1
2335,2014-03-21,2014-03-20,OKLAHOMA_CITY_THUNDER,TORONTO_RAPTORS,119,118,2336,1
2336,2014-03-21,2014-03-20,NEW_ORLEANS_PELICANS,ATLANTA_HAWKS,111,105,2337,6
2337,2014-03-21,2014-03-20,BOSTON_CELTICS,BROOKLYN_NETS,98,114,2338,16
2338,2014-03-21,2014-03-20,MEMPHIS_GRIZZLIES,MIAMI_HEAT,86,91,2339,5
2339,2014-03-22,2014-03-21,DENVER_NUGGETS,DALLAS_MAVERICKS,106,122,2340,16
2340,2014-03-22,2014-03-21,DETROIT_PISTONS,PHOENIX_SUNS,92,98,2341,6
2341,2014-03-22,2014-03-21,SAN_ANTONIO_SPURS,SACRAMENTO_KINGS,99,79,2342,20
2342,2014-03-22,2014-03-21,WASHINGTON_WIZARDS,LOS_ANGELES_LAKERS,117,107,2343,10
2343,2014-03-22,2014-03-21,PORTLAND_TRAIL_BLAZERS,CHARLOTTE_BOBCATS,94,124,2344,30
2344,2014-03-22,2014-03-21,HOUSTON_ROCKETS,CLEVELAND_CAVALIERS,118,111,2345,7
2345,2014-03-23,2014-03-22,PHILADELPHIA_76ERS,CHICAGO_BULLS,81,91,2346,10
2346,2014-03-23,2014-03-22,INDIANA_PACERS,MEMPHIS_GRIZZLIES,71,82,2347,11
2347,2014-03-23,2014-03-22,MIAMI_HEAT,NEW_ORLEANS_PELICANS,95,105,2348,10
2348,2014-03-23,2014-03-22,ORLANDO_MAGIC,UTAH_JAZZ,88,89,2349,1
2349,2014-03-23,2014-03-22,SAN_ANTONIO_SPURS,GOLDEN_STATE_WARRIORS,99,90,2350,9
2350,2014-03-23,2014-03-22,DETROIT_PISTONS,LOS_ANGELES_CLIPPERS,103,112,2351,9
2351,2014-03-23,2014-03-22,ATLANTA_HAWKS,TORONTO_RAPTORS,86,96,2352,10
2352,2014-03-23,2014-03-22,PHOENIX_SUNS,MINNESOTA_TIMBERWOLVES,127,120,2353,7
2353,2014-03-23,2014-03-22,WASHINGTON_WIZARDS,DENVER_NUGGETS,102,105,2354,3
2354,2014-03-23,2014-03-22,MILWAUKEE_BUCKS,SACRAMENTO_KINGS,107,124,2355,17
2355,2014-03-23,2014-03-22,BROOKLYN_NETS,DALLAS_MAVERICKS,107,104,2356,3
2356,2014-03-23,2014-03-22,CLEVELAND_CAVALIERS,NEW_YORK_KNICKS,106,100,2357,6
2357,2014-03-24,2014-03-23,ORLANDO_MAGIC,LOS_ANGELES_LAKERS,94,103,2358,9
2358,2014-03-24,2014-03-23,HOUSTON_ROCKETS,CHARLOTTE_BOBCATS,100,89,2359,11
2359,2014-03-24,2014-03-23,PHOENIX_SUNS,ATLANTA_HAWKS,102,95,2360,7
2360,2014-03-24,2014-03-23,PORTLAND_TRAIL_BLAZERS,MIAMI_HEAT,91,93,2361,2
2361,2014-03-25,2014-03-24,INDIANA_PACERS,CHICAGO_BULLS,77,89,2362,12
2362,2014-03-25,2014-03-24,MINNESOTA_TIMBERWOLVES,MEMPHIS_GRIZZLIES,92,109,2363,17
2363,2014-03-25,2014-03-24,BROOKLYN_NETS,NEW_ORLEANS_PELICANS,104,109,2364,5
2364,2014-03-25,2014-03-24,DENVER_NUGGETS,OKLAHOMA_CITY_THUNDER,96,117,2365,21
2365,2014-03-25,2014-03-24,PHILADELPHIA_76ERS,SAN_ANTONIO_SPURS,91,113,2366,22
2366,2014-03-25,2014-03-24,DETROIT_PISTONS,UTAH_JAZZ,114,94,2367,20
2367,2014-03-25,2014-03-24,MILWAUKEE_BUCKS,LOS_ANGELES_CLIPPERS,98,106,2368,8
2368,2014-03-25,2014-03-24,TORONTO_RAPTORS,CLEVELAND_CAVALIERS,100,102,2369,2
2369,2014-03-25,2014-03-24,PORTLAND_TRAIL_BLAZERS,ORLANDO_MAGIC,85,95,2370,10
2370,2014-03-26,2014-03-25,OKLAHOMA_CITY_THUNDER,DALLAS_MAVERICKS,119,128,2371,9
2371,2014-03-26,2014-03-25,NEW_YORK_KNICKS,LOS_ANGELES_LAKERS,96,127,2372,31
2372,2014-03-26,2014-03-25,BROOKLYN_NETS,CHARLOTTE_BOBCATS,111,116,2373,5
2373,2014-03-26,2014-03-25,PHOENIX_SUNS,WASHINGTON_WIZARDS,99,93,2374,6
2374,2014-03-26,2014-03-25,TORONTO_RAPTORS,BOSTON_CELTICS,99,90,2375,9
2375,2014-03-26,2014-03-25,CLEVELAND_CAVALIERS,DETROIT_PISTONS,97,96,2376,1
2376,2014-03-27,2014-03-26,MIAMI_HEAT,INDIANA_PACERS,83,84,2377,1
2377,2014-03-27,2014-03-26,ATLANTA_HAWKS,MINNESOTA_TIMBERWOLVES,83,107,2378,24
2378,2014-03-27,2014-03-26,LOS_ANGELES_CLIPPERS,NEW_ORLEANS_PELICANS,96,98,2379,2
2379,2014-03-27,2014-03-26,DENVER_NUGGETS,SAN_ANTONIO_SPURS,103,108,2380,5
2380,2014-03-27,2014-03-26,NEW_YORK_KNICKS,SACRAMENTO_KINGS,107,99,2381,8
2381,2014-03-27,2014-03-26,MEMPHIS_GRIZZLIES,UTAH_JAZZ,91,87,2382,4
2382,2014-03-27,2014-03-26,PORTLAND_TRAIL_BLAZERS,ATLANTA_HAWKS,100,85,2383,15
2383,2014-03-28,2014-03-27,PHILADELPHIA_76ERS,HOUSTON_ROCKETS,98,120,2384,22
2384,2014-03-28,2014-03-27,LOS_ANGELES_LAKERS,MILWAUKEE_BUCKS,105,108,2385,3
2385,2014-03-28,2014-03-27,LOS_ANGELES_CLIPPERS,DALLAS_MAVERICKS,109,103,2386,6
2386,2014-03-28,2014-03-27,CHARLOTTE_BOBCATS,ORLANDO_MAGIC,105,110,2387,5
2387,2014-03-28,2014-03-27,BOSTON_CELTICS,TORONTO_RAPTORS,103,105,2388,2
2388,2014-03-28,2014-03-27,INDIANA_PACERS,WASHINGTON_WIZARDS,78,91,2389,13
2389,2014-03-28,2014-03-27,CLEVELAND_CAVALIERS,BROOKLYN_NETS,97,108,2390,11
2390,2014-03-28,2014-03-27,MIAMI_HEAT,DETROIT_PISTONS,110,78,2391,32
2391,2014-03-29,2014-03-28,PORTLAND_TRAIL_BLAZERS,CHICAGO_BULLS,91,74,2392,17
2392,2014-03-29,2014-03-28,LOS_ANGELES_LAKERS,MINNESOTA_TIMBERWOLVES,107,143,2393,36
2393,2014-03-29,2014-03-28,UTAH_JAZZ,NEW_ORLEANS_PELICANS,95,102,2394,7
2394,2014-03-29,2014-03-28,SACRAMENTO_KINGS,OKLAHOMA_CITY_THUNDER,81,94,2395,13
2395,2014-03-29,2014-03-28,SAN_ANTONIO_SPURS,DENVER_NUGGETS,133,102,2396,31
2396,2014-03-29,2014-03-28,NEW_YORK_KNICKS,PHOENIX_SUNS,88,112,2397,24
2397,2014-03-29,2014-03-28,MEMPHIS_GRIZZLIES,GOLDEN_STATE_WARRIORS,93,100,2398,7
2398,2014-03-29,2014-03-28,DETROIT_PISTONS,PHILADELPHIA_76ERS,98,123,2399,25
2399,2014-03-30,2014-03-29,LOS_ANGELES_CLIPPERS,HOUSTON_ROCKETS,118,107,2400,11
2400,2014-03-30,2014-03-29,ATLANTA_HAWKS,WASHINGTON_WIZARDS,97,101,2401,4
2401,2014-03-30,2014-03-29,SACRAMENTO_KINGS,DALLAS_MAVERICKS,100,103,2402,3
2402,2014-03-30,2014-03-29,MIAMI_HEAT,MILWAUKEE_BUCKS,88,67,2403,21
2403,2014-03-30,2014-03-29,NEW_ORLEANS_PELICANS,SAN_ANTONIO_SPURS,80,96,2404,16
2404,2014-03-30,2014-03-29,INDIANA_PACERS,CLEVELAND_CAVALIERS,76,90,2405,14
2405,2014-03-30,2014-03-29,UTAH_JAZZ,OKLAHOMA_CITY_THUNDER,96,116,2406,20
2406,2014-03-30,2014-03-29,MINNESOTA_TIMBERWOLVES,BROOKLYN_NETS,99,114,2407,15
2407,2014-03-30,2014-03-29,TORONTO_RAPTORS,ORLANDO_MAGIC,98,93,2408,5
2408,2014-03-30,2014-03-29,CHICAGO_BULLS,BOSTON_CELTICS,107,102,2409,5
2409,2014-03-31,2014-03-30,NEW_YORK_KNICKS,GOLDEN_STATE_WARRIORS,89,84,2410,5
2410,2014-03-31,2014-03-30,MEMPHIS_GRIZZLIES,PORTLAND_TRAIL_BLAZERS,98,105,2411,7
2411,2014-03-31,2014-03-30,PHOENIX_SUNS,LOS_ANGELES_LAKERS,99,115,2412,16
2412,2014-03-31,2014-03-30,WASHINGTON_WIZARDS,CHARLOTTE_BOBCATS,94,100,2413,6
2413,2014-03-31,2014-03-30,SAN_ANTONIO_SPURS,INDIANA_PACERS,103,77,2414,26
2414,2014-03-31,2014-03-30,PHILADELPHIA_76ERS,ATLANTA_HAWKS,95,103,2415,8
2415,2014-03-31,2014-03-30,MILWAUKEE_BUCKS,DETROIT_PISTONS,111,116,2416,5
2416,2014-03-31,2014-03-30,TORONTO_RAPTORS,MIAMI_HEAT,83,93,2417,10
2417,2014-04-01,2014-03-31,BOSTON_CELTICS,CHICAGO_BULLS,80,94,2418,14
2418,2014-04-01,2014-03-31,LOS_ANGELES_CLIPPERS,MINNESOTA_TIMBERWOLVES,114,104,2419,10
2419,2014-04-01,2014-03-31,SACRAMENTO_KINGS,NEW_ORLEANS_PELICANS,102,97,2420,5
2420,2014-04-01,2014-03-31,MEMPHIS_GRIZZLIES,DENVER_NUGGETS,94,92,2421,2
2421,2014-04-01,2014-03-31,NEW_YORK_KNICKS,UTAH_JAZZ,92,83,2422,9
2422,2014-04-02,2014-04-01,HOUSTON_ROCKETS,BROOKLYN_NETS,96,105,2423,9
2423,2014-04-02,2014-04-01,GOLDEN_STATE_WARRIORS,DALLAS_MAVERICKS,122,120,2424,2
2424,2014-04-02,2014-04-01,PORTLAND_TRAIL_BLAZERS,LOS_ANGELES_LAKERS,124,112,2425,12
2425,2014-04-02,2014-04-01,DETROIT_PISTONS,INDIANA_PACERS,94,101,2426,7
2426,2014-04-02,2014-04-01,BROOKLYN_NETS,NEW_YORK_KNICKS,81,110,2427,29
2427,2014-04-02,2014-04-01,CLEVELAND_CAVALIERS,ORLANDO_MAGIC,119,98,2428,21
2428,2014-04-02,2014-04-01,CHARLOTTE_BOBCATS,PHILADELPHIA_76ERS,123,93,2429,30
2429,2014-04-02,2014-04-01,HOUSTON_ROCKETS,TORONTO_RAPTORS,103,107,2430,4
2430,2014-04-02,2014-04-01,BOSTON_CELTICS,WASHINGTON_WIZARDS,92,118,2431,26
2431,2014-04-02,2014-04-01,CHICAGO_BULLS,ATLANTA_HAWKS,105,92,2432,13
2432,2014-04-02,2014-04-01,MILWAUKEE_BUCKS,MIAMI_HEAT,77,96,2433,19
2433,2014-04-03,2014-04-02,MEMPHIS_GRIZZLIES,MINNESOTA_TIMBERWOLVES,88,102,2434,14
2434,2014-04-03,2014-04-02,GOLDEN_STATE_WARRIORS,SAN_ANTONIO_SPURS,90,111,2435,21
2435,2014-04-03,2014-04-02,NEW_ORLEANS_PELICANS,DENVER_NUGGETS,107,137,2436,30
2436,2014-04-03,2014-04-02,LOS_ANGELES_CLIPPERS,PHOENIX_SUNS,112,108,2437,4
2437,2014-04-03,2014-04-02,LOS_ANGELES_LAKERS,SACRAMENTO_KINGS,102,107,2438,5
2438,2014-04-04,2014-04-03,SAN_ANTONIO_SPURS,OKLAHOMA_CITY_THUNDER,94,106,2439,12
2439,2014-04-04,2014-04-03,DALLAS_MAVERICKS,LOS_ANGELES_CLIPPERS,113,107,2440,6
2440,2014-04-04,2014-04-03,ORLANDO_MAGIC,CHARLOTTE_BOBCATS,80,91,2441,11
2441,2014-04-04,2014-04-03,DENVER_NUGGETS,MEMPHIS_GRIZZLIES,92,100,2442,8
2442,2014-04-04,2014-04-03,INDIANA_PACERS,TORONTO_RAPTORS,94,102,2443,8
2443,2014-04-04,2014-04-03,CLEVELAND_CAVALIERS,ATLANTA_HAWKS,98,117,2444,19
2444,2014-04-04,2014-04-03,PHILADELPHIA_76ERS,BOSTON_CELTICS,111,102,2445,9
2445,2014-04-04,2014-04-03,DETROIT_PISTONS,BROOKLYN_NETS,104,116,2446,12
2446,2014-04-04,2014-04-03,MINNESOTA_TIMBERWOLVES,MIAMI_HEAT,122,121,2447,1
2447,2014-04-04,2014-04-03,WASHINGTON_WIZARDS,NEW_YORK_KNICKS,90,89,2448,1
2448,2014-04-05,2014-04-04,MILWAUKEE_BUCKS,CHICAGO_BULLS,90,102,2449,12
2449,2014-04-05,2014-04-04,NEW_ORLEANS_PELICANS,UTAH_JAZZ,96,100,2450,4
2450,2014-04-05,2014-04-04,OKLAHOMA_CITY_THUNDER,HOUSTON_ROCKETS,107,111,2451,4
2451,2014-04-05,2014-04-04,PHOENIX_SUNS,PORTLAND_TRAIL_BLAZERS,109,93,2452,16
2452,2014-04-05,2014-04-04,SACRAMENTO_KINGS,GOLDEN_STATE_WARRIORS,69,102,2453,33
2453,2014-04-05,2014-04-04,DALLAS_MAVERICKS,LOS_ANGELES_LAKERS,107,95,2454,12
2454,2014-04-05,2014-04-04,MINNESOTA_TIMBERWOLVES,ORLANDO_MAGIC,92,100,2455,8
2455,2014-04-05,2014-04-04,CHICAGO_BULLS,WASHINGTON_WIZARDS,96,78,2456,18
2456,2014-04-05,2014-04-04,CHARLOTTE_BOBCATS,CLEVELAND_CAVALIERS,96,94,2457,2
2457,2014-04-05,2014-04-04,BOSTON_CELTICS,DETROIT_PISTONS,111,115,2458,4
2458,2014-04-05,2014-04-04,BROOKLYN_NETS,PHILADELPHIA_76ERS,105,101,2459,4
2459,2014-04-06,2014-04-05,TORONTO_RAPTORS,MILWAUKEE_BUCKS,102,98,2460,4
2460,2014-04-06,2014-04-05,NEW_YORK_KNICKS,MIAMI_HEAT,91,102,2461,11
2461,2014-04-06,2014-04-05,LOS_ANGELES_LAKERS,LOS_ANGELES_CLIPPERS,97,120,2462,23
2462,2014-04-06,2014-04-05,ATLANTA_HAWKS,INDIANA_PACERS,107,88,2463,19
2463,2014-04-06,2014-04-05,DALLAS_MAVERICKS,SACRAMENTO_KINGS,93,91,2464,2
2464,2014-04-06,2014-04-05,DENVER_NUGGETS,HOUSTON_ROCKETS,125,130,2465,5
2465,2014-04-06,2014-04-05,MEMPHIS_GRIZZLIES,SAN_ANTONIO_SPURS,92,112,2466,20
2466,2014-04-07,2014-04-06,UTAH_JAZZ,GOLDEN_STATE_WARRIORS,102,130,2467,28
2467,2014-04-07,2014-04-06,OKLAHOMA_CITY_THUNDER,PHOENIX_SUNS,115,122,2468,7
2468,2014-04-07,2014-04-06,NEW_ORLEANS_PELICANS,PORTLAND_TRAIL_BLAZERS,94,100,2469,6
2469,2014-04-08,2014-04-07,DETROIT_PISTONS,ATLANTA_HAWKS,102,95,2470,7
2470,2014-04-09,2014-04-08,BROOKLYN_NETS,MIAMI_HEAT,88,87,2471,1
2471,2014-04-09,2014-04-08,SAN_ANTONIO_SPURS,MINNESOTA_TIMBERWOLVES,91,110,2472,19
2472,2014-04-09,2014-04-08,DALLAS_MAVERICKS,UTAH_JAZZ,95,83,2473,12
2473,2014-04-09,2014-04-08,OKLAHOMA_CITY_THUNDER,SACRAMENTO_KINGS,107,92,2474,15
2474,2014-04-09,2014-04-08,HOUSTON_ROCKETS,LOS_ANGELES_LAKERS,145,130,2475,15
2475,2014-04-09,2014-04-08,DETROIT_PISTONS,CLEVELAND_CAVALIERS,100,122,2476,22
2476,2014-04-09,2014-04-08,BROOKLYN_NETS,ORLANDO_MAGIC,111,115,2477,4
2477,2014-04-09,2014-04-08,PHILADELPHIA_76ERS,TORONTO_RAPTORS,114,125,2478,11
2478,2014-04-09,2014-04-08,CHARLOTTE_BOBCATS,WASHINGTON_WIZARDS,94,88,2479,6
2479,2014-04-09,2014-04-08,BOSTON_CELTICS,ATLANTA_HAWKS,97,105,2480,8
2480,2014-04-10,2014-04-09,MIAMI_HEAT,MEMPHIS_GRIZZLIES,102,107,2481,5
2481,2014-04-10,2014-04-09,INDIANA_PACERS,MILWAUKEE_BUCKS,104,102,2482,2
2482,2014-04-10,2014-04-09,CHICAGO_BULLS,MINNESOTA_TIMBERWOLVES,102,87,2483,15
2483,2014-04-10,2014-04-09,PHOENIX_SUNS,NEW_ORLEANS_PELICANS,94,88,2484,6
2484,2014-04-10,2014-04-09,HOUSTON_ROCKETS,DENVER_NUGGETS,116,123,2485,7
2485,2014-04-10,2014-04-09,SACRAMENTO_KINGS,PORTLAND_TRAIL_BLAZERS,99,100,2486,1
2486,2014-04-10,2014-04-09,OKLAHOMA_CITY_THUNDER,LOS_ANGELES_CLIPPERS,107,101,2487,6
2487,2014-04-11,2014-04-10,SAN_ANTONIO_SPURS,DALLAS_MAVERICKS,109,100,2488,9
2488,2014-04-11,2014-04-10,DENVER_NUGGETS,GOLDEN_STATE_WARRIORS,100,99,2489,1
2489,2014-04-11,2014-04-10,WASHINGTON_WIZARDS,ORLANDO_MAGIC,96,86,2490,10
2490,2014-04-11,2014-04-10,NEW_YORK_KNICKS,TORONTO_RAPTORS,108,100,2491,8
2491,2014-04-11,2014-04-10,CHARLOTTE_BOBCATS,BOSTON_CELTICS,103,106,2492,3
2492,2014-04-11,2014-04-10,ATLANTA_HAWKS,BROOKLYN_NETS,93,88,2493,5
2493,2014-04-11,2014-04-10,INDIANA_PACERS,MIAMI_HEAT,86,98,2494,12
2494,2014-04-12,2014-04-11,DETROIT_PISTONS,CHICAGO_BULLS,98,106,2495,8
2495,2014-04-12,2014-04-11,PHILADELPHIA_76ERS,MEMPHIS_GRIZZLIES,95,117,2496,22
2496,2014-04-12,2014-04-11,HOUSTON_ROCKETS,MINNESOTA_TIMBERWOLVES,110,112,2497,2
2497,2014-04-12,2014-04-11,NEW_ORLEANS_PELICANS,OKLAHOMA_CITY_THUNDER,94,116,2498,22
2498,2014-04-12,2014-04-11,CLEVELAND_CAVALIERS,MILWAUKEE_BUCKS,116,119,2499,3
2499,2014-04-12,2014-04-11,PHOENIX_SUNS,SAN_ANTONIO_SPURS,104,112,2500,8
2500,2014-04-12,2014-04-11,PORTLAND_TRAIL_BLAZERS,UTAH_JAZZ,111,99,2501,12
2501,2014-04-12,2014-04-11,GOLDEN_STATE_WARRIORS,LOS_ANGELES_LAKERS,112,95,2502,17
2502,2014-04-12,2014-04-11,SACRAMENTO_KINGS,LOS_ANGELES_CLIPPERS,101,117,2503,16
2503,2014-04-12,2014-04-11,PHILADELPHIA_76ERS,CHARLOTTE_BOBCATS,105,111,2504,6
2504,2014-04-12,2014-04-11,MILWAUKEE_BUCKS,WASHINGTON_WIZARDS,91,104,2505,13
2505,2014-04-12,2014-04-11,MIAMI_HEAT,ATLANTA_HAWKS,85,98,2506,13
2506,2014-04-12,2014-04-11,BOSTON_CELTICS,CLEVELAND_CAVALIERS,111,99,2507,12
2507,2014-04-13,2014-04-12,NEW_ORLEANS_PELICANS,HOUSTON_ROCKETS,104,111,2508,7
2508,2014-04-13,2014-04-12,PHOENIX_SUNS,DALLAS_MAVERICKS,98,101,2509,3
2509,2014-04-13,2014-04-12,UTAH_JAZZ,DENVER_NUGGETS,94,101,2510,7
2510,2014-04-13,2014-04-12,OKLAHOMA_CITY_THUNDER,INDIANA_PACERS,97,102,2511,5
2511,2014-04-13,2014-04-12,TORONTO_RAPTORS,DETROIT_PISTONS,116,107,2512,9
2512,2014-04-13,2014-04-12,ORLANDO_MAGIC,BROOKLYN_NETS,88,97,2513,9
2513,2014-04-13,2014-04-12,CHICAGO_BULLS,NEW_YORK_KNICKS,89,100,2514,11
2514,2014-04-14,2014-04-13,GOLDEN_STATE_WARRIORS,PORTLAND_TRAIL_BLAZERS,117,119,2515,2
2515,2014-04-14,2014-04-13,MINNESOTA_TIMBERWOLVES,SACRAMENTO_KINGS,103,106,2516,3
2516,2014-04-14,2014-04-13,MEMPHIS_GRIZZLIES,LOS_ANGELES_LAKERS,102,90,2517,12
2517,2014-04-14,2014-04-13,BOSTON_CELTICS,PHILADELPHIA_76ERS,108,113,2518,5
2518,2014-04-14,2014-04-13,MILWAUKEE_BUCKS,TORONTO_RAPTORS,100,110,2519,10
2519,2014-04-14,2014-04-13,MIAMI_HEAT,WASHINGTON_WIZARDS,93,114,2520,21
2520,2014-04-14,2014-04-13,CHARLOTTE_BOBCATS,ATLANTA_HAWKS,95,93,2521,2
2521,2014-04-15,2014-04-14,ORLANDO_MAGIC,CHICAGO_BULLS,95,108,2522,13
2522,2014-04-15,2014-04-14,SAN_ANTONIO_SPURS,HOUSTON_ROCKETS,98,104,2523,6
2523,2014-04-15,2014-04-14,OKLAHOMA_CITY_THUNDER,NEW_ORLEANS_PELICANS,89,101,2524,12
2524,2014-04-15,2014-04-14,LOS_ANGELES_LAKERS,UTAH_JAZZ,119,104,2525,15
2525,2014-04-15,2014-04-14,MEMPHIS_GRIZZLIES,PHOENIX_SUNS,97,91,2526,6
2526,2014-04-15,2014-04-14,MINNESOTA_TIMBERWOLVES,GOLDEN_STATE_WARRIORS,120,130,2527,10
2527,2014-04-16,2014-04-15,NEW_YORK_KNICKS,BROOKLYN_NETS,109,98,2528,11
2528,2014-04-16,2014-04-15,DENVER_NUGGETS,LOS_ANGELES_CLIPPERS,105,117,2529,12
2529,2014-04-16,2014-04-15,CHICAGO_BULLS,CHARLOTTE_BOBCATS,86,91,2530,5
2530,2014-04-16,2014-04-15,INDIANA_PACERS,ORLANDO_MAGIC,101,86,2531,15
2531,2014-04-17,2014-04-16,WASHINGTON_WIZARDS,BOSTON_CELTICS,118,102,2532,16
2532,2014-04-17,2014-04-16,BROOKLYN_NETS,CLEVELAND_CAVALIERS,85,114,2533,29
2533,2014-04-17,2014-04-16,DALLAS_MAVERICKS,MEMPHIS_GRIZZLIES,105,106,2534,1
2534,2014-04-17,2014-04-16,PHILADELPHIA_76ERS,MIAMI_HEAT,100,87,2535,13
2535,2014-04-17,2014-04-16,ATLANTA_HAWKS,MILWAUKEE_BUCKS,111,103,2536,8
2536,2014-04-17,2014-04-16,UTAH_JAZZ,MINNESOTA_TIMBERWOLVES,136,130,2537,6
2537,2014-04-17,2014-04-16,HOUSTON_ROCKETS,NEW_ORLEANS_PELICANS,100,105,2538,5
2538,2014-04-17,2014-04-16,TORONTO_RAPTORS,NEW_YORK_KNICKS,92,95,2539,3
2539,2014-04-17,2014-04-16,DETROIT_PISTONS,OKLAHOMA_CITY_THUNDER,111,112,2540,1
2540,2014-04-17,2014-04-16,LOS_ANGELES_LAKERS,SAN_ANTONIO_SPURS,113,100,2541,13
2541,2014-04-17,2014-04-16,GOLDEN_STATE_WARRIORS,DENVER_NUGGETS,116,112,2542,4
2542,2014-04-17,2014-04-16,LOS_ANGELES_CLIPPERS,PORTLAND_TRAIL_BLAZERS,104,110,2543,6
2543,2014-04-17,2014-04-16,PHOENIX_SUNS,SACRAMENTO_KINGS,104,99,2544,5
2544,2014-04-19,2014-04-18,GOLDEN_STATE_WARRIORS,LOS_ANGELES_CLIPPERS,109,105,2545,4
2545,2014-04-19,2014-04-18,ATLANTA_HAWKS,INDIANA_PACERS,101,93,2546,8
2546,2014-04-20,2014-04-19,MEMPHIS_GRIZZLIES,OKLAHOMA_CITY_THUNDER,86,100,2547,14
2547,2014-04-19,2014-04-18,BROOKLYN_NETS,TORONTO_RAPTORS,94,87,2548,7
2548,2014-04-20,2014-04-19,DALLAS_MAVERICKS,SAN_ANTONIO_SPURS,85,90,2549,5
2549,2014-04-20,2014-04-19,CHARLOTTE_BOBCATS,MIAMI_HEAT,88,99,2550,11
2550,2014-04-20,2014-04-19,WASHINGTON_WIZARDS,CHICAGO_BULLS,102,93,2551,9
2551,2014-04-21,2014-04-20,PORTLAND_TRAIL_BLAZERS,HOUSTON_ROCKETS,122,120,2552,2
2552,2014-04-22,2014-04-21,MEMPHIS_GRIZZLIES,OKLAHOMA_CITY_THUNDER,111,105,2553,6
2553,2014-04-22,2014-04-21,GOLDEN_STATE_WARRIORS,LOS_ANGELES_CLIPPERS,98,138,2554,40
2554,2014-04-22,2014-04-21,ATLANTA_HAWKS,INDIANA_PACERS,85,101,2555,16
2555,2014-04-22,2014-04-21,BROOKLYN_NETS,TORONTO_RAPTORS,95,100,2556,5
2556,2014-04-23,2014-04-22,WASHINGTON_WIZARDS,CHICAGO_BULLS,101,99,2557,2
2557,2014-04-23,2014-04-22,CHARLOTTE_BOBCATS,MIAMI_HEAT,97,101,2558,4
2558,2014-04-24,2014-04-23,DALLAS_MAVERICKS,SAN_ANTONIO_SPURS,113,92,2559,21
2559,2014-04-24,2014-04-23,PORTLAND_TRAIL_BLAZERS,HOUSTON_ROCKETS,112,105,2560,7
2560,2014-04-24,2014-04-23,INDIANA_PACERS,ATLANTA_HAWKS,85,98,2561,13
2561,2014-04-25,2014-04-24,OKLAHOMA_CITY_THUNDER,MEMPHIS_GRIZZLIES,95,98,2562,3
2562,2014-04-25,2014-04-24,LOS_ANGELES_CLIPPERS,GOLDEN_STATE_WARRIORS,98,96,2563,2
2563,2014-04-25,2014-04-24,TORONTO_RAPTORS,BROOKLYN_NETS,98,102,2564,4
2564,2014-04-26,2014-04-25,CHICAGO_BULLS,WASHINGTON_WIZARDS,100,97,2565,3
2565,2014-04-26,2014-04-25,HOUSTON_ROCKETS,PORTLAND_TRAIL_BLAZERS,121,116,2566,5
2566,2014-04-26,2014-04-25,INDIANA_PACERS,ATLANTA_HAWKS,91,88,2567,3
2567,2014-04-26,2014-04-25,SAN_ANTONIO_SPURS,DALLAS_MAVERICKS,108,109,2568,1
2568,2014-04-26,2014-04-25,MIAMI_HEAT,CHARLOTTE_BOBCATS,98,85,2569,13
2569,2014-04-27,2014-04-26,OKLAHOMA_CITY_THUNDER,MEMPHIS_GRIZZLIES,92,89,2570,3
2570,2014-04-27,2014-04-26,CHICAGO_BULLS,WASHINGTON_WIZARDS,89,98,2571,9
2571,2014-04-27,2014-04-26,LOS_ANGELES_CLIPPERS,GOLDEN_STATE_WARRIORS,97,118,2572,21
2572,2014-04-27,2014-04-26,TORONTO_RAPTORS,BROOKLYN_NETS,87,79,2573,8
2573,2014-04-28,2014-04-27,HOUSTON_ROCKETS,PORTLAND_TRAIL_BLAZERS,120,123,2574,3
2574,2014-04-28,2014-04-27,MIAMI_HEAT,CHARLOTTE_BOBCATS,109,98,2575,11
2575,2014-04-29,2014-04-28,ATLANTA_HAWKS,INDIANA_PACERS,107,97,2576,10
2576,2014-04-29,2014-04-28,SAN_ANTONIO_SPURS,DALLAS_MAVERICKS,93,89,2577,4
2577,2014-04-30,2014-04-29,WASHINGTON_WIZARDS,CHICAGO_BULLS,75,69,2578,6
2578,2014-04-30,2014-04-29,MEMPHIS_GRIZZLIES,OKLAHOMA_CITY_THUNDER,100,99,2579,1
2579,2014-04-30,2014-04-29,GOLDEN_STATE_WARRIORS,LOS_ANGELES_CLIPPERS,103,113,2580,10
2580,2014-04-30,2014-04-29,DALLAS_MAVERICKS,SAN_ANTONIO_SPURS,103,109,2581,6
2581,2014-04-30,2014-04-29,BROOKLYN_NETS,TORONTO_RAPTORS,113,115,2582,2
2582,2014-05-01,2014-04-30,PORTLAND_TRAIL_BLAZERS,HOUSTON_ROCKETS,98,108,2583,10
2583,2014-05-01,2014-04-30,INDIANA_PACERS,ATLANTA_HAWKS,95,88,2584,7
2584,2014-05-02,2014-05-01,OKLAHOMA_CITY_THUNDER,MEMPHIS_GRIZZLIES,104,84,2585,20
2585,2014-05-02,2014-05-01,LOS_ANGELES_CLIPPERS,GOLDEN_STATE_WARRIORS,99,100,2586,1
2586,2014-05-02,2014-05-01,TORONTO_RAPTORS,BROOKLYN_NETS,83,97,2587,14
2587,2014-05-03,2014-05-02,SAN_ANTONIO_SPURS,DALLAS_MAVERICKS,111,113,2588,2
2588,2014-05-03,2014-05-02,HOUSTON_ROCKETS,PORTLAND_TRAIL_BLAZERS,98,99,2589,1
2589,2014-05-03,2014-05-02,ATLANTA_HAWKS,INDIANA_PACERS,80,92,2590,12
2590,2014-05-04,2014-05-03,MEMPHIS_GRIZZLIES,OKLAHOMA_CITY_THUNDER,109,120,2591,11
2591,2014-05-04,2014-05-03,GOLDEN_STATE_WARRIORS,LOS_ANGELES_CLIPPERS,121,126,2592,5
2592,2014-05-04,2014-05-03,BROOKLYN_NETS,TORONTO_RAPTORS,104,103,2593,1
2593,2014-05-04,2014-05-03,DALLAS_MAVERICKS,SAN_ANTONIO_SPURS,96,119,2594,23
2594,2014-05-05,2014-05-04,WASHINGTON_WIZARDS,INDIANA_PACERS,102,96,2595,6
2595,2014-05-06,2014-05-05,LOS_ANGELES_CLIPPERS,OKLAHOMA_CITY_THUNDER,122,105,2596,17
2596,2014-05-06,2014-05-05,BROOKLYN_NETS,MIAMI_HEAT,86,107,2597,21
2597,2014-05-07,2014-05-06,PORTLAND_TRAIL_BLAZERS,SAN_ANTONIO_SPURS,92,116,2598,24
2598,2014-05-07,2014-05-06,WASHINGTON_WIZARDS,INDIANA_PACERS,82,86,2599,4
2599,2014-05-08,2014-05-07,LOS_ANGELES_CLIPPERS,OKLAHOMA_CITY_THUNDER,101,112,2600,11
2600,2014-05-08,2014-05-07,BROOKLYN_NETS,MIAMI_HEAT,82,94,2601,12
2601,2014-05-09,2014-05-08,PORTLAND_TRAIL_BLAZERS,SAN_ANTONIO_SPURS,97,114,2602,17
2602,2014-05-10,2014-05-09,INDIANA_PACERS,WASHINGTON_WIZARDS,85,63,2603,22
2603,2014-05-10,2014-05-09,OKLAHOMA_CITY_THUNDER,LOS_ANGELES_CLIPPERS,118,112,2604,6
2604,2014-05-11,2014-05-10,MIAMI_HEAT,BROOKLYN_NETS,90,104,2605,14
2605,2014-05-11,2014-05-10,SAN_ANTONIO_SPURS,PORTLAND_TRAIL_BLAZERS,118,103,2606,15
2606,2014-05-11,2014-05-10,OKLAHOMA_CITY_THUNDER,LOS_ANGELES_CLIPPERS,99,101,2607,2
2607,2014-05-12,2014-05-11,INDIANA_PACERS,WASHINGTON_WIZARDS,95,92,2608,3
2608,2014-05-13,2014-05-12,MIAMI_HEAT,BROOKLYN_NETS,102,96,2609,6
2609,2014-05-13,2014-05-12,SAN_ANTONIO_SPURS,PORTLAND_TRAIL_BLAZERS,92,103,2610,11
2610,2014-05-13,2014-05-12,WASHINGTON_WIZARDS,INDIANA_PACERS,102,79,2611,23
2611,2014-05-14,2014-05-13,LOS_ANGELES_CLIPPERS,OKLAHOMA_CITY_THUNDER,104,105,2612,1
2612,2014-05-14,2014-05-13,BROOKLYN_NETS,MIAMI_HEAT,94,96,2613,2
2613,2014-05-15,2014-05-14,PORTLAND_TRAIL_BLAZERS,SAN_ANTONIO_SPURS,82,104,2614,22
2614,2014-05-16,2014-05-15,INDIANA_PACERS,WASHINGTON_WIZARDS,93,80,2615,13
2615,2014-05-16,2014-05-15,OKLAHOMA_CITY_THUNDER,LOS_ANGELES_CLIPPERS,104,98,2616,6
2616,2014-05-18,2014-05-17,MIAMI_HEAT,INDIANA_PACERS,96,107,2617,11
2617,2014-05-20,2014-05-19,OKLAHOMA_CITY_THUNDER,SAN_ANTONIO_SPURS,105,122,2618,17
2618,2014-05-21,2014-05-20,MIAMI_HEAT,INDIANA_PACERS,87,83,2619,4
2619,2014-05-22,2014-05-21,OKLAHOMA_CITY_THUNDER,SAN_ANTONIO_SPURS,77,112,2620,35
2620,2014-05-25,2014-05-24,INDIANA_PACERS,MIAMI_HEAT,87,99,2621,12
2621,2014-05-26,2014-05-25,SAN_ANTONIO_SPURS,OKLAHOMA_CITY_THUNDER,97,106,2622,9
2622,2014-05-27,2014-05-26,INDIANA_PACERS,MIAMI_HEAT,90,102,2623,12
2623,2014-05-28,2014-05-27,SAN_ANTONIO_SPURS,OKLAHOMA_CITY_THUNDER,92,105,2624,13
2624,2014-05-29,2014-05-28,MIAMI_HEAT,INDIANA_PACERS,90,93,2625,3
2625,2014-05-30,2014-05-29,OKLAHOMA_CITY_THUNDER,SAN_ANTONIO_SPURS,89,117,2626,28
2626,2014-05-31,2014-05-30,INDIANA_PACERS,MIAMI_HEAT,92,117,2627,25
2627,2014-06-01,2014-05-31,SAN_ANTONIO_SPURS,OKLAHOMA_CITY_THUNDER,112,107,2628,5
2628,2014-06-06,2014-06-05,MIAMI_HEAT,SAN_ANTONIO_SPURS,95,110,2629,15
2629,2014-06-09,2014-06-08,MIAMI_HEAT,SAN_ANTONIO_SPURS,98,96,2630,2
2630,2014-06-11,2014-06-10,SAN_ANTONIO_SPURS,MIAMI_HEAT,111,92,2631,19
2631,2014-06-13,2014-06-12,SAN_ANTONIO_SPURS,MIAMI_HEAT,107,86,2632,21
2632,2014-06-16,2014-06-15,MIAMI_HEAT,SAN_ANTONIO_SPURS,87,104,2633,17
2633,2014-10-29,2014-10-28,ORLANDO_MAGIC,NEW_ORLEANS_PELICANS,84,101,2634,17
2634,2014-10-29,2014-10-28,DALLAS_MAVERICKS,SAN_ANTONIO_SPURS,100,101,2635,1
2635,2014-10-29,2014-10-28,HOUSTON_ROCKETS,LOS_ANGELES_LAKERS,108,90,2636,18
2636,2014-10-29,2014-10-28,MILWAUKEE_BUCKS,CHARLOTTE_HORNETS,106,108,2637,2
2637,2014-10-29,2014-10-28,PHILADELPHIA_76ERS,INDIANA_PACERS,91,103,2638,12
2638,2014-10-29,2014-10-28,ATLANTA_HAWKS,TORONTO_RAPTORS,102,109,2639,7
2639,2014-10-29,2014-10-28,WASHINGTON_WIZARDS,MIAMI_HEAT,95,107,2640,12
2640,2014-10-29,2014-10-28,BROOKLYN_NETS,BOSTON_CELTICS,105,121,2641,16
2641,2014-10-30,2014-10-29,MINNESOTA_TIMBERWOLVES,MEMPHIS_GRIZZLIES,101,105,2642,4
2642,2014-10-30,2014-10-29,CHICAGO_BULLS,NEW_YORK_KNICKS,104,80,2643,24
2643,2014-10-30,2014-10-29,DETROIT_PISTONS,DENVER_NUGGETS,79,89,2644,10
2644,2014-10-30,2014-10-29,HOUSTON_ROCKETS,UTAH_JAZZ,104,93,2645,11
2645,2014-10-30,2014-10-29,GOLDEN_STATE_WARRIORS,SACRAMENTO_KINGS,95,77,2646,18
2646,2014-10-30,2014-10-29,LOS_ANGELES_LAKERS,PHOENIX_SUNS,99,119,2647,20
2647,2014-10-30,2014-10-29,OKLAHOMA_CITY_THUNDER,PORTLAND_TRAIL_BLAZERS,89,106,2648,17
2648,2014-10-30,2014-10-29,WASHINGTON_WIZARDS,ORLANDO_MAGIC,105,98,2649,7
2649,2014-10-31,2014-10-30,NEW_YORK_KNICKS,CLEVELAND_CAVALIERS,95,90,2650,5
2650,2014-10-31,2014-10-30,DETROIT_PISTONS,MINNESOTA_TIMBERWOLVES,91,97,2651,6
2651,2014-10-31,2014-10-30,UTAH_JAZZ,DALLAS_MAVERICKS,102,120,2652,18
2652,2014-10-31,2014-10-30,OKLAHOMA_CITY_THUNDER,LOS_ANGELES_CLIPPERS,90,93,2653,3
2653,2014-10-31,2014-10-30,MEMPHIS_GRIZZLIES,INDIANA_PACERS,97,89,2654,8
2654,2014-11-01,2014-10-31,CLEVELAND_CAVALIERS,CHICAGO_BULLS,114,108,2655,6
2655,2014-11-01,2014-10-31,PHILADELPHIA_76ERS,MILWAUKEE_BUCKS,81,93,2656,12
2656,2014-11-01,2014-10-31,SAN_ANTONIO_SPURS,PHOENIX_SUNS,89,94,2657,5
2657,2014-11-01,2014-10-31,PORTLAND_TRAIL_BLAZERS,SACRAMENTO_KINGS,94,103,2658,9
2658,2014-11-01,2014-10-31,LOS_ANGELES_CLIPPERS,LOS_ANGELES_LAKERS,118,111,2659,7
2659,2014-11-01,2014-10-31,MEMPHIS_GRIZZLIES,CHARLOTTE_HORNETS,71,69,2660,2
2660,2014-11-01,2014-10-31,DALLAS_MAVERICKS,NEW_ORLEANS_PELICANS,109,104,2661,5
2661,2014-11-01,2014-10-31,TORONTO_RAPTORS,ORLANDO_MAGIC,108,95,2662,13
2662,2014-11-01,2014-10-31,MIAMI_HEAT,PHILADELPHIA_76ERS,114,96,2663,18
2663,2014-11-01,2014-10-31,MILWAUKEE_BUCKS,WASHINGTON_WIZARDS,97,108,2664,11
2664,2014-11-01,2014-10-31,INDIANA_PACERS,ATLANTA_HAWKS,92,102,2665,10
2665,2014-11-01,2014-10-31,BROOKLYN_NETS,DETROIT_PISTONS,102,90,2666,12
2666,2014-11-02,2014-11-01,BOSTON_CELTICS,HOUSTON_ROCKETS,90,104,2667,14
2667,2014-11-02,2014-11-01,CHICAGO_BULLS,MINNESOTA_TIMBERWOLVES,106,105,2668,1
2668,2014-11-02,2014-11-01,DENVER_NUGGETS,OKLAHOMA_CITY_THUNDER,91,102,2669,11
2669,2014-11-02,2014-11-01,PHOENIX_SUNS,UTAH_JAZZ,91,118,2670,27
2670,2014-11-02,2014-11-01,LOS_ANGELES_LAKERS,GOLDEN_STATE_WARRIORS,104,127,2671,23
2671,2014-11-02,2014-11-01,SACRAMENTO_KINGS,LOS_ANGELES_CLIPPERS,98,92,2672,6
2672,2014-11-02,2014-11-01,TORONTO_RAPTORS,MIAMI_HEAT,102,107,2673,5
2673,2014-11-03,2014-11-02,CHARLOTTE_HORNETS,NEW_YORK_KNICKS,93,96,2674,3
2674,2014-11-03,2014-11-02,GOLDEN_STATE_WARRIORS,PORTLAND_TRAIL_BLAZERS,95,90,2675,5
2675,2014-11-04,2014-11-03,HOUSTON_ROCKETS,PHILADELPHIA_76ERS,104,93,2676,11
2676,2014-11-04,2014-11-03,OKLAHOMA_CITY_THUNDER,BROOKLYN_NETS,85,116,2677,31
2677,2014-11-04,2014-11-03,NEW_ORLEANS_PELICANS,MEMPHIS_GRIZZLIES,81,93,2678,12
2678,2014-11-04,2014-11-03,BOSTON_CELTICS,DALLAS_MAVERICKS,113,118,2679,5
2679,2014-11-04,2014-11-03,SACRAMENTO_KINGS,DENVER_NUGGETS,110,105,2680,5
2680,2014-11-04,2014-11-03,UTAH_JAZZ,LOS_ANGELES_CLIPPERS,101,107,2681,6
2681,2014-11-05,2014-11-04,MILWAUKEE_BUCKS,INDIANA_PACERS,87,81,2682,6
2682,2014-11-05,2014-11-04,HOUSTON_ROCKETS,MIAMI_HEAT,108,91,2683,17
2683,2014-11-05,2014-11-04,WASHINGTON_WIZARDS,NEW_YORK_KNICKS,98,83,2684,15
2684,2014-11-05,2014-11-04,OKLAHOMA_CITY_THUNDER,TORONTO_RAPTORS,88,100,2685,12
2685,2014-11-05,2014-11-04,ORLANDO_MAGIC,CHICAGO_BULLS,90,98,2686,8
2686,2014-11-05,2014-11-04,CHARLOTTE_HORNETS,NEW_ORLEANS_PELICANS,91,100,2687,9
2687,2014-11-05,2014-11-04,CLEVELAND_CAVALIERS,PORTLAND_TRAIL_BLAZERS,82,101,2688,19
2688,2014-11-05,2014-11-04,PHOENIX_SUNS,LOS_ANGELES_LAKERS,112,106,2689,6
2689,2014-11-06,2014-11-05,MIAMI_HEAT,CHARLOTTE_HORNETS,89,96,2690,7
2690,2014-11-06,2014-11-05,ORLANDO_MAGIC,PHILADELPHIA_76ERS,91,89,2691,2
2691,2014-11-06,2014-11-05,TORONTO_RAPTORS,BOSTON_CELTICS,110,107,2692,3
2692,2014-11-06,2014-11-05,MINNESOTA_TIMBERWOLVES,BROOKLYN_NETS,98,91,2693,7
2693,2014-11-06,2014-11-05,NEW_YORK_KNICKS,DETROIT_PISTONS,95,98,2694,3
2694,2014-11-06,2014-11-05,CHICAGO_BULLS,MILWAUKEE_BUCKS,95,86,2695,9
2695,2014-11-06,2014-11-05,INDIANA_PACERS,WASHINGTON_WIZARDS,94,96,2696,2
2696,2014-11-06,2014-11-05,ATLANTA_HAWKS,SAN_ANTONIO_SPURS,92,94,2697,2
2697,2014-11-06,2014-11-05,MEMPHIS_GRIZZLIES,PHOENIX_SUNS,102,91,2698,11
2698,2014-11-06,2014-11-05,CLEVELAND_CAVALIERS,UTAH_JAZZ,100,102,2699,2
2699,2014-11-06,2014-11-05,DENVER_NUGGETS,SACRAMENTO_KINGS,109,131,2700,22
2700,2014-11-06,2014-11-05,LOS_ANGELES_CLIPPERS,GOLDEN_STATE_WARRIORS,104,121,2701,17
2701,2014-11-07,2014-11-06,SAN_ANTONIO_SPURS,HOUSTON_ROCKETS,81,98,2702,17
2702,2014-11-07,2014-11-06,DALLAS_MAVERICKS,PORTLAND_TRAIL_BLAZERS,87,108,2703,21
2703,2014-11-08,2014-11-07,ATLANTA_HAWKS,CHARLOTTE_HORNETS,119,122,2704,3
2704,2014-11-08,2014-11-07,MINNESOTA_TIMBERWOLVES,ORLANDO_MAGIC,103,112,2705,9
2705,2014-11-08,2014-11-07,CHICAGO_BULLS,PHILADELPHIA_76ERS,118,115,2706,3
2706,2014-11-08,2014-11-07,INDIANA_PACERS,BOSTON_CELTICS,98,101,2707,3
2707,2014-11-08,2014-11-07,NEW_YORK_KNICKS,BROOKLYN_NETS,99,110,2708,11
2708,2014-11-08,2014-11-07,MILWAUKEE_BUCKS,DETROIT_PISTONS,95,98,2709,3
2709,2014-11-08,2014-11-07,WASHINGTON_WIZARDS,TORONTO_RAPTORS,84,103,2710,19
2710,2014-11-08,2014-11-07,MEMPHIS_GRIZZLIES,OKLAHOMA_CITY_THUNDER,91,89,2711,2
2711,2014-11-08,2014-11-07,SACRAMENTO_KINGS,PHOENIX_SUNS,114,112,2712,2
2712,2014-11-08,2014-11-07,DALLAS_MAVERICKS,UTAH_JAZZ,105,82,2713,23
2713,2014-11-08,2014-11-07,CLEVELAND_CAVALIERS,DENVER_NUGGETS,110,101,2714,9
2714,2014-11-08,2014-11-07,PORTLAND_TRAIL_BLAZERS,LOS_ANGELES_CLIPPERS,102,106,2715,4
2715,2014-11-09,2014-11-08,WASHINGTON_WIZARDS,INDIANA_PACERS,97,90,2716,7
2716,2014-11-09,2014-11-08,NEW_YORK_KNICKS,ATLANTA_HAWKS,96,103,2717,7
2717,2014-11-09,2014-11-08,MINNESOTA_TIMBERWOLVES,MIAMI_HEAT,92,102,2718,10
2718,2014-11-09,2014-11-08,BOSTON_CELTICS,CHICAGO_BULLS,106,101,2719,5
2719,2014-11-09,2014-11-08,GOLDEN_STATE_WARRIORS,HOUSTON_ROCKETS,98,87,2720,11
2720,2014-11-09,2014-11-08,MEMPHIS_GRIZZLIES,MILWAUKEE_BUCKS,92,93,2721,1
2721,2014-11-09,2014-11-08,NEW_ORLEANS_PELICANS,SAN_ANTONIO_SPURS,100,99,2722,1
2722,2014-11-09,2014-11-08,ORLANDO_MAGIC,BROOKLYN_NETS,96,104,2723,8
2723,2014-11-09,2014-11-08,UTAH_JAZZ,DETROIT_PISTONS,97,96,2724,1
2724,2014-11-10,2014-11-09,SACRAMENTO_KINGS,OKLAHOMA_CITY_THUNDER,93,101,2725,8
2725,2014-11-10,2014-11-09,PHILADELPHIA_76ERS,TORONTO_RAPTORS,88,120,2726,32
2726,2014-11-10,2014-11-09,MIAMI_HEAT,DALLAS_MAVERICKS,105,96,2727,9
2727,2014-11-10,2014-11-09,GOLDEN_STATE_WARRIORS,PHOENIX_SUNS,95,107,2728,12
2728,2014-11-10,2014-11-09,DENVER_NUGGETS,PORTLAND_TRAIL_BLAZERS,100,116,2729,16
2729,2014-11-10,2014-11-09,CHARLOTTE_HORNETS,LOS_ANGELES_LAKERS,92,107,2730,15
2730,2014-11-11,2014-11-10,NEW_ORLEANS_PELICANS,CLEVELAND_CAVALIERS,111,118,2731,7
2731,2014-11-11,2014-11-10,UTAH_JAZZ,INDIANA_PACERS,86,97,2732,11
2732,2014-11-11,2014-11-10,ATLANTA_HAWKS,NEW_YORK_KNICKS,91,85,2733,6
2733,2014-11-11,2014-11-10,DETROIT_PISTONS,CHICAGO_BULLS,91,102,2734,11
2734,2014-11-11,2014-11-10,SAN_ANTONIO_SPURS,LOS_ANGELES_CLIPPERS,89,85,2735,4
2735,2014-11-12,2014-11-11,ORLANDO_MAGIC,TORONTO_RAPTORS,100,104,2736,4
2736,2014-11-12,2014-11-11,LOS_ANGELES_LAKERS,MEMPHIS_GRIZZLIES,102,107,2737,5
2737,2014-11-12,2014-11-11,OKLAHOMA_CITY_THUNDER,MILWAUKEE_BUCKS,78,85,2738,7
2738,2014-11-12,2014-11-11,SACRAMENTO_KINGS,DALLAS_MAVERICKS,98,106,2739,8
2739,2014-11-12,2014-11-11,CHARLOTTE_HORNETS,PORTLAND_TRAIL_BLAZERS,100,102,2740,2
2740,2014-11-12,2014-11-11,SAN_ANTONIO_SPURS,GOLDEN_STATE_WARRIORS,113,100,2741,13
2741,2014-11-13,2014-11-12,DETROIT_PISTONS,WASHINGTON_WIZARDS,103,107,2742,4
2742,2014-11-13,2014-11-12,UTAH_JAZZ,ATLANTA_HAWKS,97,100,2743,3
2743,2014-11-13,2014-11-12,OKLAHOMA_CITY_THUNDER,BOSTON_CELTICS,109,94,2744,15
2744,2014-11-13,2014-11-12,INDIANA_PACERS,MIAMI_HEAT,81,75,2745,6
2745,2014-11-13,2014-11-12,ORLANDO_MAGIC,NEW_YORK_KNICKS,97,95,2746,2
2746,2014-11-13,2014-11-12,LOS_ANGELES_LAKERS,NEW_ORLEANS_PELICANS,102,109,2747,7
2747,2014-11-13,2014-11-12,PORTLAND_TRAIL_BLAZERS,DENVER_NUGGETS,130,113,2748,17
2748,2014-11-13,2014-11-12,BROOKLYN_NETS,PHOENIX_SUNS,104,112,2749,8
2749,2014-11-13,2014-11-12,HOUSTON_ROCKETS,MINNESOTA_TIMBERWOLVES,113,101,2750,12
2750,2014-11-14,2014-11-13,SACRAMENTO_KINGS,MEMPHIS_GRIZZLIES,110,111,2751,1
2751,2014-11-14,2014-11-13,CHICAGO_BULLS,TORONTO_RAPTORS,100,93,2752,7
2752,2014-11-14,2014-11-13,PHILADELPHIA_76ERS,DALLAS_MAVERICKS,70,123,2753,53
2753,2014-11-14,2014-11-13,BROOKLYN_NETS,GOLDEN_STATE_WARRIORS,99,107,2754,8
2754,2014-11-15,2014-11-14,DENVER_NUGGETS,INDIANA_PACERS,108,87,2755,21
2755,2014-11-15,2014-11-14,MILWAUKEE_BUCKS,ORLANDO_MAGIC,85,101,2756,16
2756,2014-11-15,2014-11-14,MIAMI_HEAT,ATLANTA_HAWKS,103,114,2757,11
2757,2014-11-15,2014-11-14,CLEVELAND_CAVALIERS,BOSTON_CELTICS,122,121,2758,1
2758,2014-11-15,2014-11-14,UTAH_JAZZ,NEW_YORK_KNICKS,102,100,2759,2
2759,2014-11-15,2014-11-14,PHILADELPHIA_76ERS,HOUSTON_ROCKETS,87,88,2760,1
2760,2014-11-15,2014-11-14,MINNESOTA_TIMBERWOLVES,NEW_ORLEANS_PELICANS,91,139,2761,48
2761,2014-11-15,2014-11-14,DETROIT_PISTONS,OKLAHOMA_CITY_THUNDER,96,89,2762,7
2762,2014-11-15,2014-11-14,CHARLOTTE_HORNETS,PHOENIX_SUNS,103,95,2763,8
2763,2014-11-15,2014-11-14,SAN_ANTONIO_SPURS,LOS_ANGELES_LAKERS,93,80,2764,13
2764,2014-11-16,2014-11-15,ORLANDO_MAGIC,WASHINGTON_WIZARDS,93,98,2765,5
2765,2014-11-16,2014-11-15,ATLANTA_HAWKS,CLEVELAND_CAVALIERS,94,127,2766,33
2766,2014-11-16,2014-11-15,UTAH_JAZZ,TORONTO_RAPTORS,93,111,2767,18
2767,2014-11-16,2014-11-15,INDIANA_PACERS,CHICAGO_BULLS,99,90,2768,9
2768,2014-11-16,2014-11-15,DETROIT_PISTONS,MEMPHIS_GRIZZLIES,88,95,2769,7
2769,2014-11-16,2014-11-15,MINNESOTA_TIMBERWOLVES,DALLAS_MAVERICKS,117,131,2770,14
2770,2014-11-16,2014-11-15,BROOKLYN_NETS,PORTLAND_TRAIL_BLAZERS,87,97,2771,10
2771,2014-11-16,2014-11-15,SAN_ANTONIO_SPURS,SACRAMENTO_KINGS,91,94,2772,3
2772,2014-11-16,2014-11-15,CHARLOTTE_HORNETS,GOLDEN_STATE_WARRIORS,87,112,2773,25
2773,2014-11-16,2014-11-15,PHOENIX_SUNS,LOS_ANGELES_CLIPPERS,107,120,2774,13
2774,2014-11-16,2014-11-15,DENVER_NUGGETS,NEW_YORK_KNICKS,93,109,2775,16
2775,2014-11-16,2014-11-15,MILWAUKEE_BUCKS,MIAMI_HEAT,91,84,2776,7
2776,2014-11-17,2014-11-16,HOUSTON_ROCKETS,OKLAHOMA_CITY_THUNDER,69,65,2777,4
2777,2014-11-17,2014-11-16,GOLDEN_STATE_WARRIORS,LOS_ANGELES_LAKERS,136,115,2778,21
2778,2014-11-18,2014-11-17,DALLAS_MAVERICKS,CHARLOTTE_HORNETS,107,80,2779,27
2779,2014-11-18,2014-11-17,DENVER_NUGGETS,CLEVELAND_CAVALIERS,106,97,2780,9
2780,2014-11-18,2014-11-17,PHOENIX_SUNS,BOSTON_CELTICS,118,114,2781,4
2781,2014-11-18,2014-11-17,MIAMI_HEAT,BROOKLYN_NETS,95,83,2782,12
2782,2014-11-18,2014-11-17,ORLANDO_MAGIC,DETROIT_PISTONS,107,93,2783,14
2783,2014-11-18,2014-11-17,HOUSTON_ROCKETS,MEMPHIS_GRIZZLIES,93,119,2784,26
2784,2014-11-18,2014-11-17,PHILADELPHIA_76ERS,SAN_ANTONIO_SPURS,75,100,2785,25
2785,2014-11-18,2014-11-17,NEW_ORLEANS_PELICANS,PORTLAND_TRAIL_BLAZERS,93,102,2786,9
2786,2014-11-18,2014-11-17,CHICAGO_BULLS,LOS_ANGELES_CLIPPERS,105,89,2787,16
2787,2014-11-19,2014-11-18,LOS_ANGELES_LAKERS,ATLANTA_HAWKS,114,109,2788,5
2788,2014-11-19,2014-11-18,NEW_YORK_KNICKS,MILWAUKEE_BUCKS,113,117,2789,4
2789,2014-11-19,2014-11-18,OKLAHOMA_CITY_THUNDER,UTAH_JAZZ,81,98,2790,17
2790,2014-11-19,2014-11-18,NEW_ORLEANS_PELICANS,SACRAMENTO_KINGS,106,100,2791,6
2791,2014-11-20,2014-11-19,SAN_ANTONIO_SPURS,CLEVELAND_CAVALIERS,92,90,2792,2
2792,2014-11-20,2014-11-19,CHARLOTTE_HORNETS,INDIANA_PACERS,86,88,2793,2
2793,2014-11-20,2014-11-19,LOS_ANGELES_CLIPPERS,ORLANDO_MAGIC,114,90,2794,24
2794,2014-11-20,2014-11-19,BOSTON_CELTICS,PHILADELPHIA_76ERS,101,90,2795,11
2795,2014-11-20,2014-11-19,DALLAS_MAVERICKS,WASHINGTON_WIZARDS,105,102,2796,3
2796,2014-11-20,2014-11-19,MILWAUKEE_BUCKS,BROOKLYN_NETS,122,118,2797,4
2797,2014-11-20,2014-11-19,PHOENIX_SUNS,DETROIT_PISTONS,88,86,2798,2
2798,2014-11-20,2014-11-19,MEMPHIS_GRIZZLIES,TORONTO_RAPTORS,92,96,2799,4
2799,2014-11-20,2014-11-19,NEW_YORK_KNICKS,MINNESOTA_TIMBERWOLVES,99,115,2800,16
2800,2014-11-20,2014-11-19,OKLAHOMA_CITY_THUNDER,DENVER_NUGGETS,100,107,2801,7
2801,2014-11-20,2014-11-19,LOS_ANGELES_LAKERS,HOUSTON_ROCKETS,98,92,2802,6
2802,2014-11-21,2014-11-20,LOS_ANGELES_CLIPPERS,MIAMI_HEAT,110,93,2803,17
2803,2014-11-21,2014-11-20,CHICAGO_BULLS,SACRAMENTO_KINGS,88,103,2804,15
2804,2014-11-22,2014-11-21,ORLANDO_MAGIC,CHARLOTTE_HORNETS,105,100,2805,5
2805,2014-11-22,2014-11-21,PHOENIX_SUNS,PHILADELPHIA_76ERS,122,96,2806,26
2806,2014-11-22,2014-11-21,DETROIT_PISTONS,ATLANTA_HAWKS,89,99,2807,10
2807,2014-11-22,2014-11-21,MILWAUKEE_BUCKS,TORONTO_RAPTORS,82,124,2808,42
2808,2014-11-22,2014-11-21,BOSTON_CELTICS,MEMPHIS_GRIZZLIES,100,117,2809,17
2809,2014-11-22,2014-11-21,SAN_ANTONIO_SPURS,MINNESOTA_TIMBERWOLVES,121,92,2810,29
2810,2014-11-22,2014-11-21,BROOKLYN_NETS,OKLAHOMA_CITY_THUNDER,94,92,2811,2
2811,2014-11-22,2014-11-21,CLEVELAND_CAVALIERS,WASHINGTON_WIZARDS,78,91,2812,13
2812,2014-11-22,2014-11-21,LOS_ANGELES_LAKERS,DALLAS_MAVERICKS,106,140,2813,34
2813,2014-11-22,2014-11-21,NEW_ORLEANS_PELICANS,DENVER_NUGGETS,97,117,2814,20
2814,2014-11-22,2014-11-21,UTAH_JAZZ,GOLDEN_STATE_WARRIORS,88,101,2815,13
2815,2014-11-22,2014-11-21,CHICAGO_BULLS,PORTLAND_TRAIL_BLAZERS,87,105,2816,18
2816,2014-11-23,2014-11-22,PHOENIX_SUNS,INDIANA_PACERS,106,83,2817,23
2817,2014-11-23,2014-11-22,MIAMI_HEAT,ORLANDO_MAGIC,99,92,2818,7
2818,2014-11-23,2014-11-22,TORONTO_RAPTORS,CLEVELAND_CAVALIERS,110,93,2819,17
2819,2014-11-23,2014-11-22,PHILADELPHIA_76ERS,NEW_YORK_KNICKS,83,91,2820,8
2820,2014-11-23,2014-11-22,DALLAS_MAVERICKS,HOUSTON_ROCKETS,92,95,2821,3
2821,2014-11-23,2014-11-22,SACRAMENTO_KINGS,MINNESOTA_TIMBERWOLVES,113,101,2822,12
2822,2014-11-23,2014-11-22,WASHINGTON_WIZARDS,MILWAUKEE_BUCKS,111,100,2823,11
2823,2014-11-23,2014-11-22,BROOKLYN_NETS,SAN_ANTONIO_SPURS,87,99,2824,12
2824,2014-11-23,2014-11-22,NEW_ORLEANS_PELICANS,UTAH_JAZZ,106,94,2825,12
2825,2014-11-23,2014-11-22,PORTLAND_TRAIL_BLAZERS,BOSTON_CELTICS,94,88,2826,6
2826,2014-11-23,2014-11-22,LOS_ANGELES_CLIPPERS,MEMPHIS_GRIZZLIES,91,107,2827,16
2827,2014-11-23,2014-11-22,CHARLOTTE_HORNETS,MIAMI_HEAT,93,94,2828,1
2828,2014-11-24,2014-11-23,GOLDEN_STATE_WARRIORS,OKLAHOMA_CITY_THUNDER,91,86,2829,5
2829,2014-11-24,2014-11-23,DENVER_NUGGETS,LOS_ANGELES_LAKERS,101,94,2830,7
2830,2014-11-25,2014-11-24,LOS_ANGELES_CLIPPERS,CHARLOTTE_HORNETS,113,92,2831,21
2831,2014-11-25,2014-11-24,ORLANDO_MAGIC,CLEVELAND_CAVALIERS,74,106,2832,32
2832,2014-11-25,2014-11-24,PORTLAND_TRAIL_BLAZERS,PHILADELPHIA_76ERS,114,104,2833,10
2833,2014-11-25,2014-11-24,PHOENIX_SUNS,TORONTO_RAPTORS,100,104,2834,4
2834,2014-11-25,2014-11-24,NEW_YORK_KNICKS,HOUSTON_ROCKETS,86,91,2835,5
2835,2014-11-25,2014-11-24,INDIANA_PACERS,DALLAS_MAVERICKS,111,100,2836,11
2836,2014-11-25,2014-11-24,CHICAGO_BULLS,UTAH_JAZZ,97,95,2837,2
2837,2014-11-26,2014-11-25,ATLANTA_HAWKS,WASHINGTON_WIZARDS,106,102,2838,4
2838,2014-11-26,2014-11-25,GOLDEN_STATE_WARRIORS,MIAMI_HEAT,114,97,2839,17
2839,2014-11-26,2014-11-25,DETROIT_PISTONS,MILWAUKEE_BUCKS,86,98,2840,12
2840,2014-11-26,2014-11-25,SACRAMENTO_KINGS,NEW_ORLEANS_PELICANS,99,89,2841,10
2841,2014-11-26,2014-11-25,CHICAGO_BULLS,DENVER_NUGGETS,109,114,2842,5
2842,2014-11-27,2014-11-26,PORTLAND_TRAIL_BLAZERS,CHARLOTTE_HORNETS,105,97,2843,8
2843,2014-11-27,2014-11-26,WASHINGTON_WIZARDS,CLEVELAND_CAVALIERS,87,113,2844,26
2844,2014-11-27,2014-11-26,GOLDEN_STATE_WARRIORS,ORLANDO_MAGIC,111,96,2845,15
2845,2014-11-27,2014-11-26,BROOKLYN_NETS,PHILADELPHIA_76ERS,99,91,2846,8
2846,2014-11-27,2014-11-26,TORONTO_RAPTORS,ATLANTA_HAWKS,126,115,2847,11
2847,2014-11-27,2014-11-26,NEW_YORK_KNICKS,DALLAS_MAVERICKS,102,109,2848,7
2848,2014-11-27,2014-11-26,LOS_ANGELES_CLIPPERS,DETROIT_PISTONS,104,98,2849,6
2849,2014-11-27,2014-11-26,SACRAMENTO_KINGS,HOUSTON_ROCKETS,89,102,2850,13
2850,2014-11-27,2014-11-26,MILWAUKEE_BUCKS,MINNESOTA_TIMBERWOLVES,103,86,2851,17
2851,2014-11-27,2014-11-26,UTAH_JAZZ,OKLAHOMA_CITY_THUNDER,82,97,2852,15
2852,2014-11-27,2014-11-26,INDIANA_PACERS,SAN_ANTONIO_SPURS,100,106,2853,6
2853,2014-11-27,2014-11-26,DENVER_NUGGETS,PHOENIX_SUNS,112,120,2854,8
2854,2014-11-27,2014-11-26,MEMPHIS_GRIZZLIES,LOS_ANGELES_LAKERS,99,93,2855,6
2855,2014-11-28,2014-11-27,CHICAGO_BULLS,BOSTON_CELTICS,109,102,2856,7
2856,2014-11-29,2014-11-28,GOLDEN_STATE_WARRIORS,CHARLOTTE_HORNETS,106,101,2857,5
2857,2014-11-29,2014-11-28,NEW_ORLEANS_PELICANS,ATLANTA_HAWKS,91,100,2858,9
2858,2014-11-29,2014-11-28,MILWAUKEE_BUCKS,DETROIT_PISTONS,104,88,2859,16
2859,2014-11-29,2014-11-28,DALLAS_MAVERICKS,TORONTO_RAPTORS,106,102,2860,4
2860,2014-11-29,2014-11-28,LOS_ANGELES_CLIPPERS,HOUSTON_ROCKETS,102,85,2861,17
2861,2014-11-29,2014-11-28,ORLANDO_MAGIC,INDIANA_PACERS,83,98,2862,15
2862,2014-11-29,2014-11-28,NEW_YORK_KNICKS,OKLAHOMA_CITY_THUNDER,78,105,2863,27
2863,2014-11-29,2014-11-28,SACRAMENTO_KINGS,SAN_ANTONIO_SPURS,104,112,2864,8
2864,2014-11-29,2014-11-28,PHOENIX_SUNS,DENVER_NUGGETS,97,122,2865,25
2865,2014-11-29,2014-11-28,MEMPHIS_GRIZZLIES,PORTLAND_TRAIL_BLAZERS,112,99,2866,13
2866,2014-11-29,2014-11-28,MINNESOTA_TIMBERWOLVES,LOS_ANGELES_LAKERS,120,119,2867,1
2867,2014-11-30,2014-11-29,DALLAS_MAVERICKS,PHILADELPHIA_76ERS,110,103,2868,7
2868,2014-11-30,2014-11-29,NEW_ORLEANS_PELICANS,WASHINGTON_WIZARDS,80,83,2869,3
2869,2014-11-30,2014-11-29,CHARLOTTE_HORNETS,ATLANTA_HAWKS,75,105,2870,30
2870,2014-11-30,2014-11-29,INDIANA_PACERS,CLEVELAND_CAVALIERS,97,109,2871,12
2871,2014-11-30,2014-11-29,HOUSTON_ROCKETS,MILWAUKEE_BUCKS,117,103,2872,14
2872,2014-11-30,2014-11-29,LOS_ANGELES_CLIPPERS,UTAH_JAZZ,112,96,2873,16
2873,2014-11-30,2014-11-29,SAN_ANTONIO_SPURS,BOSTON_CELTICS,111,89,2874,22
2874,2014-11-30,2014-11-29,CHICAGO_BULLS,BROOKLYN_NETS,102,84,2875,18
2875,2014-11-30,2014-11-29,GOLDEN_STATE_WARRIORS,DETROIT_PISTONS,104,93,2876,11
2876,2014-11-30,2014-11-29,MEMPHIS_GRIZZLIES,SACRAMENTO_KINGS,97,85,2877,12
2877,2014-12-01,2014-11-30,MIAMI_HEAT,NEW_YORK_KNICKS,86,79,2878,7
2878,2014-12-01,2014-11-30,ORLANDO_MAGIC,PHOENIX_SUNS,93,90,2879,3
2879,2014-12-01,2014-11-30,MINNESOTA_TIMBERWOLVES,PORTLAND_TRAIL_BLAZERS,93,107,2880,14
2880,2014-12-01,2014-11-30,TORONTO_RAPTORS,LOS_ANGELES_LAKERS,122,129,2881,7
2881,2014-12-02,2014-12-01,SAN_ANTONIO_SPURS,PHILADELPHIA_76ERS,109,103,2882,6
2882,2014-12-02,2014-12-01,MIAMI_HEAT,WASHINGTON_WIZARDS,86,107,2883,21
2883,2014-12-02,2014-12-01,DENVER_NUGGETS,UTAH_JAZZ,103,101,2884,2
2884,2014-12-02,2014-12-01,MINNESOTA_TIMBERWOLVES,LOS_ANGELES_CLIPPERS,101,127,2885,26
2885,2014-12-03,2014-12-02,MILWAUKEE_BUCKS,CLEVELAND_CAVALIERS,108,111,2886,3
2886,2014-12-03,2014-12-02,BOSTON_CELTICS,ATLANTA_HAWKS,105,109,2887,4
2887,2014-12-03,2014-12-02,LOS_ANGELES_LAKERS,DETROIT_PISTONS,106,96,2888,10
2888,2014-12-03,2014-12-02,BROOKLYN_NETS,NEW_YORK_KNICKS,98,93,2889,5
2889,2014-12-03,2014-12-02,DALLAS_MAVERICKS,CHICAGO_BULLS,132,129,2890,3
2890,2014-12-03,2014-12-02,OKLAHOMA_CITY_THUNDER,NEW_ORLEANS_PELICANS,104,112,2891,8
2891,2014-12-03,2014-12-02,PORTLAND_TRAIL_BLAZERS,DENVER_NUGGETS,105,103,2892,2
2892,2014-12-03,2014-12-02,INDIANA_PACERS,PHOENIX_SUNS,99,116,2893,17
2893,2014-12-03,2014-12-02,TORONTO_RAPTORS,SACRAMENTO_KINGS,117,109,2894,8
2894,2014-12-03,2014-12-02,ORLANDO_MAGIC,GOLDEN_STATE_WARRIORS,97,98,2895,1
2895,2014-12-04,2014-12-03,CHICAGO_BULLS,CHARLOTTE_HORNETS,102,95,2896,7
2896,2014-12-04,2014-12-03,LOS_ANGELES_LAKERS,WASHINGTON_WIZARDS,95,111,2897,16
2897,2014-12-04,2014-12-03,DETROIT_PISTONS,BOSTON_CELTICS,102,109,2898,7
2898,2014-12-04,2014-12-03,SAN_ANTONIO_SPURS,BROOKLYN_NETS,93,95,2899,2
2899,2014-12-04,2014-12-03,ATLANTA_HAWKS,MIAMI_HEAT,112,102,2900,10
2900,2014-12-04,2014-12-03,MEMPHIS_GRIZZLIES,HOUSTON_ROCKETS,96,105,2901,9
2901,2014-12-04,2014-12-03,DALLAS_MAVERICKS,MILWAUKEE_BUCKS,107,105,2902,2
2902,2014-12-04,2014-12-03,PHILADELPHIA_76ERS,MINNESOTA_TIMBERWOLVES,85,77,2903,8
2903,2014-12-04,2014-12-03,TORONTO_RAPTORS,UTAH_JAZZ,123,104,2904,19
2904,2014-12-04,2014-12-03,ORLANDO_MAGIC,LOS_ANGELES_CLIPPERS,86,114,2905,28
2905,2014-12-05,2014-12-04,CLEVELAND_CAVALIERS,NEW_YORK_KNICKS,90,87,2906,3
2906,2014-12-05,2014-12-04,INDIANA_PACERS,PORTLAND_TRAIL_BLAZERS,82,88,2907,6
2907,2014-12-05,2014-12-04,NEW_ORLEANS_PELICANS,GOLDEN_STATE_WARRIORS,85,112,2908,27
2908,2014-12-06,2014-12-05,NEW_YORK_KNICKS,CHARLOTTE_HORNETS,102,103,2909,1
2909,2014-12-06,2014-12-05,OKLAHOMA_CITY_THUNDER,PHILADELPHIA_76ERS,103,91,2910,12
2910,2014-12-06,2014-12-05,DENVER_NUGGETS,WASHINGTON_WIZARDS,89,119,2911,30
2911,2014-12-06,2014-12-05,LOS_ANGELES_LAKERS,BOSTON_CELTICS,96,113,2912,17
2912,2014-12-06,2014-12-05,ATLANTA_HAWKS,BROOKLYN_NETS,98,75,2913,23
2913,2014-12-06,2014-12-05,CLEVELAND_CAVALIERS,TORONTO_RAPTORS,105,91,2914,14
2914,2014-12-06,2014-12-05,SAN_ANTONIO_SPURS,MEMPHIS_GRIZZLIES,107,101,2915,6
2915,2014-12-06,2014-12-05,HOUSTON_ROCKETS,MINNESOTA_TIMBERWOLVES,114,112,2916,2
2916,2014-12-06,2014-12-05,PHOENIX_SUNS,DALLAS_MAVERICKS,118,106,2917,12
2917,2014-12-06,2014-12-05,MIAMI_HEAT,MILWAUKEE_BUCKS,85,109,2918,24
2918,2014-12-06,2014-12-05,ORLANDO_MAGIC,UTAH_JAZZ,98,93,2919,5
2919,2014-12-06,2014-12-05,INDIANA_PACERS,SACRAMENTO_KINGS,101,102,2920,1
2920,2014-12-07,2014-12-06,PHILADELPHIA_76ERS,DETROIT_PISTONS,108,101,2921,7
2921,2014-12-07,2014-12-06,GOLDEN_STATE_WARRIORS,CHICAGO_BULLS,112,102,2922,10
2922,2014-12-07,2014-12-06,PHOENIX_SUNS,HOUSTON_ROCKETS,95,100,2923,5
2923,2014-12-07,2014-12-06,MINNESOTA_TIMBERWOLVES,SAN_ANTONIO_SPURS,101,123,2924,22
2924,2014-12-07,2014-12-06,ORLANDO_MAGIC,SACRAMENTO_KINGS,105,96,2925,9
2925,2014-12-07,2014-12-06,NEW_ORLEANS_PELICANS,LOS_ANGELES_CLIPPERS,100,120,2926,20
2926,2014-12-07,2014-12-06,WASHINGTON_WIZARDS,BOSTON_CELTICS,93,101,2927,8
2927,2014-12-07,2014-12-06,DENVER_NUGGETS,ATLANTA_HAWKS,84,96,2928,12
2928,2014-12-07,2014-12-06,OKLAHOMA_CITY_THUNDER,DETROIT_PISTONS,96,94,2929,2
2929,2014-12-07,2014-12-06,MIAMI_HEAT,MEMPHIS_GRIZZLIES,87,103,2930,16
2930,2014-12-08,2014-12-07,MILWAUKEE_BUCKS,DALLAS_MAVERICKS,102,125,2931,23
2931,2014-12-08,2014-12-07,PORTLAND_TRAIL_BLAZERS,NEW_YORK_KNICKS,103,99,2932,4
2932,2014-12-08,2014-12-07,NEW_ORLEANS_PELICANS,LOS_ANGELES_LAKERS,104,87,2933,17
2933,2014-12-09,2014-12-08,ATLANTA_HAWKS,INDIANA_PACERS,108,92,2934,16
2934,2014-12-09,2014-12-08,BOSTON_CELTICS,WASHINGTON_WIZARDS,132,133,2935,1
2935,2014-12-09,2014-12-08,CLEVELAND_CAVALIERS,BROOKLYN_NETS,110,88,2936,22
2936,2014-12-09,2014-12-08,DENVER_NUGGETS,TORONTO_RAPTORS,107,112,2937,5
2937,2014-12-09,2014-12-08,GOLDEN_STATE_WARRIORS,MINNESOTA_TIMBERWOLVES,102,86,2938,16
2938,2014-12-09,2014-12-08,UTAH_JAZZ,SACRAMENTO_KINGS,92,101,2939,9
2939,2014-12-09,2014-12-08,PHOENIX_SUNS,LOS_ANGELES_CLIPPERS,120,121,2940,1
2940,2014-12-10,2014-12-09,TORONTO_RAPTORS,CLEVELAND_CAVALIERS,101,105,2941,4
2941,2014-12-10,2014-12-09,PORTLAND_TRAIL_BLAZERS,DETROIT_PISTONS,98,86,2942,12
2942,2014-12-10,2014-12-09,DALLAS_MAVERICKS,MEMPHIS_GRIZZLIES,105,114,2943,9
2943,2014-12-10,2014-12-09,NEW_YORK_KNICKS,NEW_ORLEANS_PELICANS,93,104,2944,11
2944,2014-12-10,2014-12-09,MILWAUKEE_BUCKS,OKLAHOMA_CITY_THUNDER,101,114,2945,13
2945,2014-12-10,2014-12-09,MIAMI_HEAT,PHOENIX_SUNS,103,97,2946,6
2946,2014-12-10,2014-12-09,SAN_ANTONIO_SPURS,UTAH_JAZZ,96,100,2947,4
2947,2014-12-10,2014-12-09,SACRAMENTO_KINGS,LOS_ANGELES_LAKERS,95,98,2948,3
2948,2014-12-11,2014-12-10,BOSTON_CELTICS,CHARLOTTE_HORNETS,87,96,2949,9
2949,2014-12-11,2014-12-10,LOS_ANGELES_CLIPPERS,INDIANA_PACERS,103,96,2950,7
2950,2014-12-11,2014-12-10,WASHINGTON_WIZARDS,ORLANDO_MAGIC,91,89,2951,2
2951,2014-12-11,2014-12-10,PHILADELPHIA_76ERS,ATLANTA_HAWKS,79,95,2952,16
2952,2014-12-11,2014-12-10,BROOKLYN_NETS,CHICAGO_BULLS,80,105,2953,25
2953,2014-12-11,2014-12-10,NEW_ORLEANS_PELICANS,DALLAS_MAVERICKS,107,112,2954,5
2954,2014-12-11,2014-12-10,PORTLAND_TRAIL_BLAZERS,MINNESOTA_TIMBERWOLVES,82,90,2955,8
2955,2014-12-11,2014-12-10,NEW_YORK_KNICKS,SAN_ANTONIO_SPURS,95,109,2956,14
2956,2014-12-11,2014-12-10,MIAMI_HEAT,DENVER_NUGGETS,82,102,2957,20
2957,2014-12-11,2014-12-10,HOUSTON_ROCKETS,GOLDEN_STATE_WARRIORS,93,105,2958,12
2958,2014-12-12,2014-12-11,CLEVELAND_CAVALIERS,OKLAHOMA_CITY_THUNDER,94,103,2959,9
2959,2014-12-12,2014-12-11,HOUSTON_ROCKETS,SACRAMENTO_KINGS,113,109,2960,4
2960,2014-12-13,2014-12-12,PORTLAND_TRAIL_BLAZERS,CHICAGO_BULLS,106,115,2961,9
2961,2014-12-13,2014-12-12,LOS_ANGELES_CLIPPERS,WASHINGTON_WIZARDS,96,104,2962,8
2962,2014-12-13,2014-12-12,ORLANDO_MAGIC,ATLANTA_HAWKS,81,87,2963,6
2963,2014-12-13,2014-12-12,NEW_YORK_KNICKS,BOSTON_CELTICS,101,95,2964,6
2964,2014-12-13,2014-12-12,PHILADELPHIA_76ERS,BROOKLYN_NETS,70,88,2965,18
2965,2014-12-13,2014-12-12,INDIANA_PACERS,TORONTO_RAPTORS,94,106,2966,12
2966,2014-12-13,2014-12-12,CHARLOTTE_HORNETS,MEMPHIS_GRIZZLIES,107,113,2967,6
2967,2014-12-13,2014-12-12,OKLAHOMA_CITY_THUNDER,MINNESOTA_TIMBERWOLVES,111,92,2968,19
2968,2014-12-13,2014-12-12,CLEVELAND_CAVALIERS,NEW_ORLEANS_PELICANS,114,119,2969,5
2969,2014-12-13,2014-12-12,DETROIT_PISTONS,PHOENIX_SUNS,105,103,2970,2
2970,2014-12-13,2014-12-12,MIAMI_HEAT,UTAH_JAZZ,100,95,2971,5
2971,2014-12-13,2014-12-12,LOS_ANGELES_LAKERS,SAN_ANTONIO_SPURS,112,110,2972,2
2972,2014-12-13,2014-12-12,GOLDEN_STATE_WARRIORS,DALLAS_MAVERICKS,105,98,2973,7
2973,2014-12-14,2014-12-13,BROOKLYN_NETS,CHARLOTTE_HORNETS,114,87,2974,27
2974,2014-12-14,2014-12-13,PORTLAND_TRAIL_BLAZERS,INDIANA_PACERS,95,85,2975,10
2975,2014-12-14,2014-12-13,ATLANTA_HAWKS,ORLANDO_MAGIC,99,100,2976,1
2976,2014-12-14,2014-12-13,LOS_ANGELES_CLIPPERS,MILWAUKEE_BUCKS,106,111,2977,5
2977,2014-12-14,2014-12-13,MEMPHIS_GRIZZLIES,PHILADELPHIA_76ERS,120,115,2978,5
2978,2014-12-14,2014-12-13,DENVER_NUGGETS,HOUSTON_ROCKETS,96,108,2979,12
2979,2014-12-14,2014-12-13,DETROIT_PISTONS,SACRAMENTO_KINGS,95,90,2980,5
2980,2014-12-14,2014-12-13,CHICAGO_BULLS,MIAMI_HEAT,93,75,2981,18
2981,2014-12-14,2014-12-13,GOLDEN_STATE_WARRIORS,NEW_ORLEANS_PELICANS,128,122,2982,6
2982,2014-12-14,2014-12-13,UTAH_JAZZ,WASHINGTON_WIZARDS,84,93,2983,9
2983,2014-12-15,2014-12-14,LOS_ANGELES_LAKERS,MINNESOTA_TIMBERWOLVES,100,94,2984,6
2984,2014-12-15,2014-12-14,PHOENIX_SUNS,OKLAHOMA_CITY_THUNDER,88,112,2985,24
2985,2014-12-15,2014-12-14,TORONTO_RAPTORS,NEW_YORK_KNICKS,95,90,2986,5
2986,2014-12-15,2014-12-14,SAN_ANTONIO_SPURS,DENVER_NUGGETS,99,91,2987,8
2987,2014-12-16,2014-12-15,CHARLOTTE_HORNETS,CLEVELAND_CAVALIERS,88,97,2988,9
2988,2014-12-16,2014-12-15,LOS_ANGELES_LAKERS,INDIANA_PACERS,91,110,2989,19
2989,2014-12-16,2014-12-15,BOSTON_CELTICS,PHILADELPHIA_76ERS,105,87,2990,18
2990,2014-12-16,2014-12-15,CHICAGO_BULLS,ATLANTA_HAWKS,86,93,2991,7
2991,2014-12-16,2014-12-15,ORLANDO_MAGIC,TORONTO_RAPTORS,82,95,2992,13
2992,2014-12-16,2014-12-15,MILWAUKEE_BUCKS,PHOENIX_SUNS,96,94,2993,2
2993,2014-12-16,2014-12-15,SAN_ANTONIO_SPURS,PORTLAND_TRAIL_BLAZERS,95,108,2994,13
2994,2014-12-16,2014-12-15,DETROIT_PISTONS,LOS_ANGELES_CLIPPERS,91,113,2995,22
2995,2014-12-17,2014-12-16,MINNESOTA_TIMBERWOLVES,WASHINGTON_WIZARDS,95,109,2996,14
2996,2014-12-17,2014-12-16,MIAMI_HEAT,BROOKLYN_NETS,95,91,2997,4
2997,2014-12-17,2014-12-16,GOLDEN_STATE_WARRIORS,MEMPHIS_GRIZZLIES,98,105,2998,7
2998,2014-12-17,2014-12-16,UTAH_JAZZ,NEW_ORLEANS_PELICANS,111,119,2999,8
2999,2014-12-17,2014-12-16,DALLAS_MAVERICKS,NEW_YORK_KNICKS,107,87,3000,20
3000,2014-12-17,2014-12-16,OKLAHOMA_CITY_THUNDER,SACRAMENTO_KINGS,104,92,3001,12
3001,2014-12-18,2014-12-17,PHOENIX_SUNS,CHARLOTTE_HORNETS,111,106,3002,5
3002,2014-12-18,2014-12-17,ATLANTA_HAWKS,CLEVELAND_CAVALIERS,127,98,3003,29
3003,2014-12-18,2014-12-17,ORLANDO_MAGIC,BOSTON_CELTICS,92,109,3004,17
3004,2014-12-18,2014-12-17,DALLAS_MAVERICKS,DETROIT_PISTONS,117,106,3005,11
3005,2014-12-18,2014-12-17,UTAH_JAZZ,MIAMI_HEAT,105,87,3006,18
3006,2014-12-18,2014-12-17,BROOKLYN_NETS,TORONTO_RAPTORS,89,105,3007,16
3007,2014-12-18,2014-12-17,MEMPHIS_GRIZZLIES,SAN_ANTONIO_SPURS,117,116,3008,1
3008,2014-12-18,2014-12-17,MILWAUKEE_BUCKS,PORTLAND_TRAIL_BLAZERS,97,104,3009,7
3009,2014-12-18,2014-12-17,HOUSTON_ROCKETS,DENVER_NUGGETS,115,111,3010,4
3010,2014-12-18,2014-12-17,INDIANA_PACERS,LOS_ANGELES_CLIPPERS,100,102,3011,2
3011,2014-12-19,2014-12-18,NEW_YORK_KNICKS,CHICAGO_BULLS,97,103,3012,6
3012,2014-12-19,2014-12-18,NEW_ORLEANS_PELICANS,HOUSTON_ROCKETS,99,90,3013,9
3013,2014-12-19,2014-12-18,MILWAUKEE_BUCKS,SACRAMENTO_KINGS,108,107,3014,1
3014,2014-12-19,2014-12-18,OKLAHOMA_CITY_THUNDER,GOLDEN_STATE_WARRIORS,109,114,3015,5
3015,2014-12-20,2014-12-19,UTAH_JAZZ,ORLANDO_MAGIC,101,94,3016,7
3016,2014-12-20,2014-12-19,CHARLOTTE_HORNETS,PHILADELPHIA_76ERS,109,91,3017,18
3017,2014-12-20,2014-12-19,MINNESOTA_TIMBERWOLVES,BOSTON_CELTICS,98,114,3018,16
3018,2014-12-20,2014-12-19,BROOKLYN_NETS,CLEVELAND_CAVALIERS,91,95,3019,4
3019,2014-12-20,2014-12-19,TORONTO_RAPTORS,DETROIT_PISTONS,110,100,3020,10
3020,2014-12-20,2014-12-19,WASHINGTON_WIZARDS,MIAMI_HEAT,105,103,3021,2
3021,2014-12-20,2014-12-19,CHICAGO_BULLS,MEMPHIS_GRIZZLIES,103,97,3022,6
3022,2014-12-20,2014-12-19,PORTLAND_TRAIL_BLAZERS,SAN_ANTONIO_SPURS,129,119,3023,10
3023,2014-12-20,2014-12-19,LOS_ANGELES_CLIPPERS,DENVER_NUGGETS,106,109,3024,3
3024,2014-12-20,2014-12-19,OKLAHOMA_CITY_THUNDER,LOS_ANGELES_LAKERS,104,103,3025,1
3025,2014-12-20,2014-12-19,PHOENIX_SUNS,NEW_YORK_KNICKS,99,90,3026,9
3026,2014-12-21,2014-12-20,UTAH_JAZZ,CHARLOTTE_HORNETS,86,104,3027,18
3027,2014-12-21,2014-12-20,PORTLAND_TRAIL_BLAZERS,NEW_ORLEANS_PELICANS,114,88,3028,26
3028,2014-12-21,2014-12-20,ATLANTA_HAWKS,HOUSTON_ROCKETS,104,97,3029,7
3029,2014-12-21,2014-12-20,SAN_ANTONIO_SPURS,DALLAS_MAVERICKS,93,99,3030,6
3030,2014-12-21,2014-12-20,INDIANA_PACERS,DENVER_NUGGETS,73,76,3031,3
3031,2014-12-21,2014-12-20,MILWAUKEE_BUCKS,LOS_ANGELES_CLIPPERS,102,106,3032,4
3032,2014-12-21,2014-12-20,NEW_YORK_KNICKS,TORONTO_RAPTORS,108,118,3033,10
3033,2014-12-21,2014-12-20,MEMPHIS_GRIZZLIES,CLEVELAND_CAVALIERS,91,105,3034,14
3034,2014-12-21,2014-12-20,DETROIT_PISTONS,BROOKLYN_NETS,105,110,3035,5
3035,2014-12-21,2014-12-20,BOSTON_CELTICS,MIAMI_HEAT,84,100,3036,16
3036,2014-12-21,2014-12-20,PHILADELPHIA_76ERS,ORLANDO_MAGIC,96,88,3037,8
3037,2014-12-21,2014-12-20,LOS_ANGELES_LAKERS,SACRAMENTO_KINGS,101,108,3038,7
3038,2014-12-21,2014-12-20,PHOENIX_SUNS,WASHINGTON_WIZARDS,104,92,3039,12
3039,2014-12-22,2014-12-21,INDIANA_PACERS,MINNESOTA_TIMBERWOLVES,100,96,3040,4
3040,2014-12-22,2014-12-21,NEW_ORLEANS_PELICANS,OKLAHOMA_CITY_THUNDER,101,99,3041,2
3041,2014-12-23,2014-12-22,DENVER_NUGGETS,CHARLOTTE_HORNETS,82,110,3042,28
3042,2014-12-23,2014-12-22,TORONTO_RAPTORS,CHICAGO_BULLS,120,129,3043,9
3043,2014-12-23,2014-12-22,PORTLAND_TRAIL_BLAZERS,HOUSTON_ROCKETS,95,110,3044,15
3044,2014-12-23,2014-12-22,UTAH_JAZZ,MEMPHIS_GRIZZLIES,97,91,3045,6
3045,2014-12-23,2014-12-22,ATLANTA_HAWKS,DALLAS_MAVERICKS,105,102,3046,3
3046,2014-12-23,2014-12-22,LOS_ANGELES_CLIPPERS,SAN_ANTONIO_SPURS,118,125,3047,7
3047,2014-12-23,2014-12-22,SACRAMENTO_KINGS,GOLDEN_STATE_WARRIORS,108,128,3048,20
3048,2014-12-24,2014-12-23,MINNESOTA_TIMBERWOLVES,CLEVELAND_CAVALIERS,104,125,3049,21
3049,2014-12-24,2014-12-23,NEW_ORLEANS_PELICANS,INDIANA_PACERS,84,96,3050,12
3050,2014-12-24,2014-12-23,BOSTON_CELTICS,ORLANDO_MAGIC,95,100,3051,5
3051,2014-12-24,2014-12-23,CHICAGO_BULLS,WASHINGTON_WIZARDS,99,91,3052,8
3052,2014-12-24,2014-12-23,LOS_ANGELES_CLIPPERS,ATLANTA_HAWKS,104,107,3053,3
3053,2014-12-24,2014-12-23,DENVER_NUGGETS,BROOKLYN_NETS,96,102,3054,6
3054,2014-12-24,2014-12-23,PHILADELPHIA_76ERS,MIAMI_HEAT,91,87,3055,4
3055,2014-12-24,2014-12-23,CHARLOTTE_HORNETS,MILWAUKEE_BUCKS,108,101,3056,7
3056,2014-12-24,2014-12-23,PORTLAND_TRAIL_BLAZERS,OKLAHOMA_CITY_THUNDER,115,111,3057,4
3057,2014-12-24,2014-12-23,DALLAS_MAVERICKS,PHOENIX_SUNS,115,124,3058,9
3058,2014-12-24,2014-12-23,GOLDEN_STATE_WARRIORS,LOS_ANGELES_LAKERS,105,115,3059,10
3059,2014-12-25,2014-12-24,WASHINGTON_WIZARDS,NEW_YORK_KNICKS,102,91,3060,11
3060,2014-12-25,2014-12-24,OKLAHOMA_CITY_THUNDER,SAN_ANTONIO_SPURS,114,106,3061,8
3061,2014-12-25,2014-12-24,CLEVELAND_CAVALIERS,MIAMI_HEAT,91,101,3062,10
3062,2014-12-26,2014-12-25,LOS_ANGELES_LAKERS,CHICAGO_BULLS,93,113,3063,20
3063,2014-12-26,2014-12-25,GOLDEN_STATE_WARRIORS,LOS_ANGELES_CLIPPERS,86,100,3064,14
3064,2014-12-26,2014-12-25,BROOKLYN_NETS,BOSTON_CELTICS,109,107,3065,2
3065,2014-12-27,2014-12-26,CLEVELAND_CAVALIERS,ORLANDO_MAGIC,98,89,3066,9
3066,2014-12-27,2014-12-26,MILWAUKEE_BUCKS,ATLANTA_HAWKS,107,77,3067,30
3067,2014-12-27,2014-12-26,INDIANA_PACERS,DETROIT_PISTONS,109,119,3068,10
3068,2014-12-27,2014-12-26,HOUSTON_ROCKETS,MEMPHIS_GRIZZLIES,117,111,3069,6
3069,2014-12-27,2014-12-26,SAN_ANTONIO_SPURS,NEW_ORLEANS_PELICANS,90,97,3070,7
3070,2014-12-27,2014-12-26,CHARLOTTE_HORNETS,OKLAHOMA_CITY_THUNDER,75,98,3071,23
3071,2014-12-27,2014-12-26,LOS_ANGELES_LAKERS,DALLAS_MAVERICKS,98,102,3072,4
3072,2014-12-27,2014-12-26,MINNESOTA_TIMBERWOLVES,DENVER_NUGGETS,102,106,3073,4
3073,2014-12-27,2014-12-26,PHILADELPHIA_76ERS,PORTLAND_TRAIL_BLAZERS,93,114,3074,21
3074,2014-12-27,2014-12-26,PHOENIX_SUNS,SACRAMENTO_KINGS,115,106,3075,9
3075,2014-12-27,2014-12-26,TORONTO_RAPTORS,LOS_ANGELES_CLIPPERS,110,98,3076,12
3076,2014-12-28,2014-12-27,ORLANDO_MAGIC,CHARLOTTE_HORNETS,102,94,3077,8
3077,2014-12-28,2014-12-27,BOSTON_CELTICS,WASHINGTON_WIZARDS,88,101,3078,13
3078,2014-12-28,2014-12-27,MEMPHIS_GRIZZLIES,MIAMI_HEAT,103,95,3079,8
3079,2014-12-28,2014-12-27,INDIANA_PACERS,BROOKLYN_NETS,110,85,3080,25
3080,2014-12-28,2014-12-27,NEW_ORLEANS_PELICANS,CHICAGO_BULLS,100,107,3081,7
3081,2014-12-28,2014-12-27,ATLANTA_HAWKS,MILWAUKEE_BUCKS,90,85,3082,5
3082,2014-12-28,2014-12-27,PHILADELPHIA_76ERS,UTAH_JAZZ,71,88,3083,17
3083,2014-12-28,2014-12-27,NEW_YORK_KNICKS,SACRAMENTO_KINGS,129,135,3084,6
3084,2014-12-28,2014-12-27,MINNESOTA_TIMBERWOLVES,GOLDEN_STATE_WARRIORS,97,110,3085,13
3085,2014-12-28,2014-12-27,DETROIT_PISTONS,CLEVELAND_CAVALIERS,103,80,3086,23
3086,2014-12-29,2014-12-28,HOUSTON_ROCKETS,SAN_ANTONIO_SPURS,106,110,3087,4
3087,2014-12-29,2014-12-28,OKLAHOMA_CITY_THUNDER,DALLAS_MAVERICKS,107,112,3088,5
3088,2014-12-29,2014-12-28,TORONTO_RAPTORS,DENVER_NUGGETS,116,102,3089,14
3089,2014-12-29,2014-12-28,NEW_YORK_KNICKS,PORTLAND_TRAIL_BLAZERS,79,101,3090,22
3090,2014-12-29,2014-12-28,PHOENIX_SUNS,LOS_ANGELES_LAKERS,116,107,3091,9
3091,2014-12-30,2014-12-29,MILWAUKEE_BUCKS,CHARLOTTE_HORNETS,104,94,3092,10
3092,2014-12-30,2014-12-29,CHICAGO_BULLS,INDIANA_PACERS,92,90,3093,2
3093,2014-12-30,2014-12-29,SACRAMENTO_KINGS,BROOKLYN_NETS,99,107,3094,8
3094,2014-12-30,2014-12-29,ORLANDO_MAGIC,MIAMI_HEAT,102,101,3095,1
3095,2014-12-30,2014-12-29,WASHINGTON_WIZARDS,HOUSTON_ROCKETS,104,103,3096,1
3096,2014-12-30,2014-12-29,UTAH_JAZZ,LOS_ANGELES_CLIPPERS,97,101,3097,4
3097,2014-12-31,2014-12-30,DETROIT_PISTONS,ORLANDO_MAGIC,109,86,3098,23
3098,2014-12-31,2014-12-30,CLEVELAND_CAVALIERS,ATLANTA_HAWKS,101,109,3099,8
3099,2014-12-31,2014-12-30,BROOKLYN_NETS,CHICAGO_BULLS,96,82,3100,14
3100,2014-12-31,2014-12-30,SAN_ANTONIO_SPURS,MEMPHIS_GRIZZLIES,87,95,3101,8
3101,2014-12-31,2014-12-30,PHOENIX_SUNS,NEW_ORLEANS_PELICANS,106,110,3102,4
3102,2014-12-31,2014-12-30,WASHINGTON_WIZARDS,DALLAS_MAVERICKS,87,114,3103,27
3103,2014-12-31,2014-12-30,LOS_ANGELES_LAKERS,DENVER_NUGGETS,111,103,3104,8
3104,2014-12-31,2014-12-30,MINNESOTA_TIMBERWOLVES,UTAH_JAZZ,94,100,3105,6
3105,2014-12-31,2014-12-30,TORONTO_RAPTORS,PORTLAND_TRAIL_BLAZERS,97,102,3106,5
3106,2014-12-31,2014-12-30,PHILADELPHIA_76ERS,GOLDEN_STATE_WARRIORS,86,126,3107,40
3107,2014-12-31,2014-12-30,SACRAMENTO_KINGS,BOSTON_CELTICS,84,106,3108,22
3108,2014-12-31,2014-12-30,MIAMI_HEAT,INDIANA_PACERS,95,106,3109,11
3109,2014-12-31,2014-12-30,NEW_YORK_KNICKS,LOS_ANGELES_CLIPPERS,78,99,3110,21
3110,2015-01-01,2014-12-31,MILWAUKEE_BUCKS,CLEVELAND_CAVALIERS,96,80,3111,16
3111,2015-01-01,2014-12-31,CHARLOTTE_HORNETS,HOUSTON_ROCKETS,83,102,3112,19
3112,2015-01-01,2014-12-31,NEW_ORLEANS_PELICANS,SAN_ANTONIO_SPURS,93,95,3113,2
3113,2015-01-01,2014-12-31,PHOENIX_SUNS,OKLAHOMA_CITY_THUNDER,134,137,3114,3
3114,2015-01-02,2015-01-01,DENVER_NUGGETS,CHICAGO_BULLS,101,106,3115,5
3115,2015-01-02,2015-01-01,SACRAMENTO_KINGS,MINNESOTA_TIMBERWOLVES,110,107,3116,3
3116,2015-01-03,2015-01-02,CLEVELAND_CAVALIERS,CHARLOTTE_HORNETS,91,87,3117,4
3117,2015-01-03,2015-01-02,BROOKLYN_NETS,ORLANDO_MAGIC,100,98,3118,2
3118,2015-01-03,2015-01-02,DALLAS_MAVERICKS,BOSTON_CELTICS,119,101,3119,18
3119,2015-01-03,2015-01-02,DETROIT_PISTONS,NEW_YORK_KNICKS,97,81,3120,16
3120,2015-01-03,2015-01-02,HOUSTON_ROCKETS,NEW_ORLEANS_PELICANS,83,111,3121,28
3121,2015-01-03,2015-01-02,WASHINGTON_WIZARDS,OKLAHOMA_CITY_THUNDER,102,109,3122,7
3122,2015-01-03,2015-01-02,INDIANA_PACERS,MILWAUKEE_BUCKS,94,91,3123,3
3123,2015-01-03,2015-01-02,PHILADELPHIA_76ERS,PHOENIX_SUNS,96,112,3124,16
3124,2015-01-03,2015-01-02,ATLANTA_HAWKS,UTAH_JAZZ,98,92,3125,6
3125,2015-01-03,2015-01-02,TORONTO_RAPTORS,GOLDEN_STATE_WARRIORS,105,126,3126,21
3126,2015-01-03,2015-01-02,MEMPHIS_GRIZZLIES,LOS_ANGELES_LAKERS,109,106,3127,3
3127,2015-01-04,2015-01-03,CHARLOTTE_HORNETS,ORLANDO_MAGIC,98,90,3128,8
3128,2015-01-04,2015-01-03,BOSTON_CELTICS,CHICAGO_BULLS,104,109,3129,5
3129,2015-01-04,2015-01-03,MIAMI_HEAT,HOUSTON_ROCKETS,79,115,3130,36
3130,2015-01-04,2015-01-03,UTAH_JAZZ,MINNESOTA_TIMBERWOLVES,101,89,3131,12
3131,2015-01-04,2015-01-03,WASHINGTON_WIZARDS,SAN_ANTONIO_SPURS,92,101,3132,9
3132,2015-01-04,2015-01-03,MEMPHIS_GRIZZLIES,DENVER_NUGGETS,85,114,3133,29
3133,2015-01-04,2015-01-03,ATLANTA_HAWKS,PORTLAND_TRAIL_BLAZERS,115,107,3134,8
3134,2015-01-04,2015-01-03,PHILADELPHIA_76ERS,LOS_ANGELES_CLIPPERS,91,127,3135,36
3135,2015-01-04,2015-01-03,DALLAS_MAVERICKS,CLEVELAND_CAVALIERS,109,90,3136,19
3136,2015-01-04,2015-01-03,SACRAMENTO_KINGS,DETROIT_PISTONS,95,114,3137,19
3137,2015-01-04,2015-01-03,BROOKLYN_NETS,MIAMI_HEAT,84,88,3138,4
3138,2015-01-05,2015-01-04,MILWAUKEE_BUCKS,NEW_YORK_KNICKS,95,82,3139,13
3139,2015-01-05,2015-01-04,TORONTO_RAPTORS,PHOENIX_SUNS,109,125,3140,16
3140,2015-01-05,2015-01-04,INDIANA_PACERS,LOS_ANGELES_LAKERS,87,88,3141,1
3141,2015-01-06,2015-01-05,CLEVELAND_CAVALIERS,PHILADELPHIA_76ERS,92,95,3142,3
3142,2015-01-06,2015-01-05,CHARLOTTE_HORNETS,BOSTON_CELTICS,104,95,3143,9
3143,2015-01-06,2015-01-05,DALLAS_MAVERICKS,BROOKLYN_NETS,96,88,3144,8
3144,2015-01-06,2015-01-05,HOUSTON_ROCKETS,CHICAGO_BULLS,105,114,3145,9
3145,2015-01-06,2015-01-05,NEW_YORK_KNICKS,MEMPHIS_GRIZZLIES,83,105,3146,22
3146,2015-01-06,2015-01-05,DENVER_NUGGETS,MINNESOTA_TIMBERWOLVES,110,101,3147,9
3147,2015-01-06,2015-01-05,WASHINGTON_WIZARDS,NEW_ORLEANS_PELICANS,92,85,3148,7
3148,2015-01-06,2015-01-05,INDIANA_PACERS,UTAH_JAZZ,105,101,3149,4
3149,2015-01-06,2015-01-05,LOS_ANGELES_LAKERS,PORTLAND_TRAIL_BLAZERS,94,98,3150,4
3150,2015-01-06,2015-01-05,OKLAHOMA_CITY_THUNDER,GOLDEN_STATE_WARRIORS,91,117,3151,26
3151,2015-01-06,2015-01-05,ATLANTA_HAWKS,LOS_ANGELES_CLIPPERS,107,98,3152,9
3152,2015-01-07,2015-01-06,PHOENIX_SUNS,MILWAUKEE_BUCKS,102,96,3153,6
3153,2015-01-07,2015-01-06,DETROIT_PISTONS,SAN_ANTONIO_SPURS,105,104,3154,1
3154,2015-01-08,2015-01-07,NEW_ORLEANS_PELICANS,CHARLOTTE_HORNETS,94,98,3155,4
3155,2015-01-08,2015-01-07,HOUSTON_ROCKETS,CLEVELAND_CAVALIERS,105,93,3156,12
3156,2015-01-08,2015-01-07,MILWAUKEE_BUCKS,PHILADELPHIA_76ERS,97,77,3157,20
3157,2015-01-08,2015-01-07,NEW_YORK_KNICKS,WASHINGTON_WIZARDS,91,101,3158,10
3158,2015-01-08,2015-01-07,MEMPHIS_GRIZZLIES,ATLANTA_HAWKS,86,96,3159,10
3159,2015-01-08,2015-01-07,BOSTON_CELTICS,BROOKLYN_NETS,89,81,3160,8
3160,2015-01-08,2015-01-07,UTAH_JAZZ,CHICAGO_BULLS,97,77,3161,20
3161,2015-01-08,2015-01-07,DETROIT_PISTONS,DALLAS_MAVERICKS,108,95,3162,13
3162,2015-01-08,2015-01-07,ORLANDO_MAGIC,DENVER_NUGGETS,90,93,3163,3
3163,2015-01-08,2015-01-07,PHOENIX_SUNS,MINNESOTA_TIMBERWOLVES,113,111,3164,2
3164,2015-01-08,2015-01-07,OKLAHOMA_CITY_THUNDER,SACRAMENTO_KINGS,83,104,3165,21
3165,2015-01-08,2015-01-07,INDIANA_PACERS,GOLDEN_STATE_WARRIORS,102,117,3166,15
3166,2015-01-08,2015-01-07,LOS_ANGELES_LAKERS,LOS_ANGELES_CLIPPERS,89,114,3167,25
3167,2015-01-09,2015-01-08,CHARLOTTE_HORNETS,TORONTO_RAPTORS,103,95,3168,8
3168,2015-01-09,2015-01-08,HOUSTON_ROCKETS,NEW_YORK_KNICKS,120,96,3169,24
3169,2015-01-09,2015-01-08,MIAMI_HEAT,PORTLAND_TRAIL_BLAZERS,83,99,3170,16
3170,2015-01-10,2015-01-09,BOSTON_CELTICS,INDIANA_PACERS,103,107,3171,4
3171,2015-01-10,2015-01-09,PHILADELPHIA_76ERS,BROOKLYN_NETS,90,88,3172,2
3172,2015-01-10,2015-01-09,ATLANTA_HAWKS,DETROIT_PISTONS,106,103,3173,3
3173,2015-01-10,2015-01-09,MEMPHIS_GRIZZLIES,NEW_ORLEANS_PELICANS,95,106,3174,11
3174,2015-01-10,2015-01-09,UTAH_JAZZ,OKLAHOMA_CITY_THUNDER,94,99,3175,5
3175,2015-01-10,2015-01-09,CHICAGO_BULLS,WASHINGTON_WIZARDS,86,102,3176,16
3176,2015-01-10,2015-01-09,MINNESOTA_TIMBERWOLVES,MILWAUKEE_BUCKS,84,98,3177,14
3177,2015-01-10,2015-01-09,PHOENIX_SUNS,SAN_ANTONIO_SPURS,95,100,3178,5
3178,2015-01-10,2015-01-09,DENVER_NUGGETS,SACRAMENTO_KINGS,118,108,3179,10
3179,2015-01-10,2015-01-09,CLEVELAND_CAVALIERS,GOLDEN_STATE_WARRIORS,94,112,3180,18
3180,2015-01-10,2015-01-09,ORLANDO_MAGIC,LOS_ANGELES_LAKERS,84,101,3181,17
3181,2015-01-10,2015-01-09,CHARLOTTE_HORNETS,NEW_YORK_KNICKS,110,82,3182,28
3182,2015-01-10,2015-01-09,DALLAS_MAVERICKS,LOS_ANGELES_CLIPPERS,100,120,3183,20
3183,2015-01-11,2015-01-10,BROOKLYN_NETS,DETROIT_PISTONS,93,98,3184,5
3184,2015-01-11,2015-01-10,INDIANA_PACERS,PHILADELPHIA_76ERS,92,93,3185,1
3185,2015-01-11,2015-01-10,BOSTON_CELTICS,TORONTO_RAPTORS,96,109,3186,13
3186,2015-01-11,2015-01-10,MILWAUKEE_BUCKS,CHICAGO_BULLS,87,95,3187,8
3187,2015-01-11,2015-01-10,UTAH_JAZZ,HOUSTON_ROCKETS,82,97,3188,15
3188,2015-01-11,2015-01-10,SAN_ANTONIO_SPURS,MINNESOTA_TIMBERWOLVES,108,93,3189,15
3189,2015-01-11,2015-01-10,ORLANDO_MAGIC,PORTLAND_TRAIL_BLAZERS,92,103,3190,11
3190,2015-01-11,2015-01-10,WASHINGTON_WIZARDS,ATLANTA_HAWKS,89,120,3191,31
3191,2015-01-11,2015-01-10,MIAMI_HEAT,LOS_ANGELES_CLIPPERS,104,90,3192,14
3192,2015-01-11,2015-01-10,PHOENIX_SUNS,MEMPHIS_GRIZZLIES,110,122,3193,12
3193,2015-01-12,2015-01-11,CLEVELAND_CAVALIERS,SACRAMENTO_KINGS,84,103,3194,19
3194,2015-01-12,2015-01-11,PORTLAND_TRAIL_BLAZERS,LOS_ANGELES_LAKERS,106,94,3195,12
3195,2015-01-13,2015-01-12,NEW_ORLEANS_PELICANS,BOSTON_CELTICS,100,108,3196,8
3196,2015-01-13,2015-01-12,HOUSTON_ROCKETS,BROOKLYN_NETS,113,99,3197,14
3197,2015-01-13,2015-01-12,DETROIT_PISTONS,TORONTO_RAPTORS,114,111,3198,3
3198,2015-01-13,2015-01-12,ORLANDO_MAGIC,CHICAGO_BULLS,121,114,3199,7
3199,2015-01-14,2015-01-13,MINNESOTA_TIMBERWOLVES,INDIANA_PACERS,110,101,3200,9
3200,2015-01-14,2015-01-13,ATLANTA_HAWKS,PHILADELPHIA_76ERS,105,87,3201,18
3201,2015-01-14,2015-01-13,SAN_ANTONIO_SPURS,WASHINGTON_WIZARDS,93,101,3202,8
3202,2015-01-14,2015-01-13,CLEVELAND_CAVALIERS,PHOENIX_SUNS,100,107,3203,7
3203,2015-01-14,2015-01-13,GOLDEN_STATE_WARRIORS,UTAH_JAZZ,116,105,3204,11
3204,2015-01-14,2015-01-13,DALLAS_MAVERICKS,SACRAMENTO_KINGS,108,104,3205,4
3205,2015-01-14,2015-01-13,MIAMI_HEAT,LOS_ANGELES_LAKERS,78,75,3206,3
3206,2015-01-15,2015-01-14,SAN_ANTONIO_SPURS,CHARLOTTE_HORNETS,98,93,3207,5
3207,2015-01-15,2015-01-14,HOUSTON_ROCKETS,ORLANDO_MAGIC,113,120,3208,7
3208,2015-01-15,2015-01-14,MEMPHIS_GRIZZLIES,BROOKLYN_NETS,103,92,3209,11
3209,2015-01-15,2015-01-14,NEW_ORLEANS_PELICANS,DETROIT_PISTONS,105,94,3210,11
3210,2015-01-15,2015-01-14,PHILADELPHIA_76ERS,TORONTO_RAPTORS,84,100,3211,16
3211,2015-01-15,2015-01-14,ATLANTA_HAWKS,BOSTON_CELTICS,105,91,3212,14
3212,2015-01-15,2015-01-14,WASHINGTON_WIZARDS,CHICAGO_BULLS,105,99,3213,6
3213,2015-01-15,2015-01-14,DALLAS_MAVERICKS,DENVER_NUGGETS,107,114,3214,7
3214,2015-01-15,2015-01-14,MIAMI_HEAT,GOLDEN_STATE_WARRIORS,89,104,3215,15
3215,2015-01-15,2015-01-14,LOS_ANGELES_CLIPPERS,PORTLAND_TRAIL_BLAZERS,100,94,3216,6
3216,2015-01-15,2015-01-14,NEW_YORK_KNICKS,MILWAUKEE_BUCKS,79,95,3217,16
3217,2015-01-16,2015-01-15,OKLAHOMA_CITY_THUNDER,HOUSTON_ROCKETS,101,112,3218,11
3218,2015-01-16,2015-01-15,CLEVELAND_CAVALIERS,LOS_ANGELES_LAKERS,109,102,3219,7
3219,2015-01-17,2015-01-16,DETROIT_PISTONS,INDIANA_PACERS,98,96,3220,2
3220,2015-01-17,2015-01-16,MEMPHIS_GRIZZLIES,ORLANDO_MAGIC,106,96,3221,10
3221,2015-01-17,2015-01-16,NEW_ORLEANS_PELICANS,PHILADELPHIA_76ERS,81,96,3222,15
3222,2015-01-17,2015-01-16,BROOKLYN_NETS,WASHINGTON_WIZARDS,102,80,3223,22
3223,2015-01-17,2015-01-16,CHICAGO_BULLS,BOSTON_CELTICS,119,103,3224,16
3224,2015-01-17,2015-01-16,ATLANTA_HAWKS,TORONTO_RAPTORS,110,89,3225,21
3225,2015-01-17,2015-01-16,GOLDEN_STATE_WARRIORS,OKLAHOMA_CITY_THUNDER,115,127,3226,12
3226,2015-01-17,2015-01-16,DENVER_NUGGETS,DALLAS_MAVERICKS,89,97,3227,8
3227,2015-01-17,2015-01-16,PORTLAND_TRAIL_BLAZERS,SAN_ANTONIO_SPURS,96,110,3228,14
3228,2015-01-17,2015-01-16,MINNESOTA_TIMBERWOLVES,PHOENIX_SUNS,99,110,3229,11
3229,2015-01-17,2015-01-16,LOS_ANGELES_LAKERS,UTAH_JAZZ,85,94,3230,9
3230,2015-01-17,2015-01-16,MIAMI_HEAT,SACRAMENTO_KINGS,95,83,3231,12
3231,2015-01-17,2015-01-16,CLEVELAND_CAVALIERS,LOS_ANGELES_CLIPPERS,126,121,3232,5
3232,2015-01-18,2015-01-17,INDIANA_PACERS,CHARLOTTE_HORNETS,71,80,3233,9
3233,2015-01-18,2015-01-17,PHILADELPHIA_76ERS,DETROIT_PISTONS,89,107,3234,18
3234,2015-01-18,2015-01-17,WASHINGTON_WIZARDS,BROOKLYN_NETS,99,90,3235,9
3235,2015-01-18,2015-01-17,ATLANTA_HAWKS,CHICAGO_BULLS,107,99,3236,8
3236,2015-01-18,2015-01-17,GOLDEN_STATE_WARRIORS,HOUSTON_ROCKETS,131,106,3237,25
3237,2015-01-18,2015-01-17,MINNESOTA_TIMBERWOLVES,DENVER_NUGGETS,113,105,3238,8
3238,2015-01-18,2015-01-17,PORTLAND_TRAIL_BLAZERS,MEMPHIS_GRIZZLIES,98,102,3239,4
3239,2015-01-18,2015-01-17,LOS_ANGELES_CLIPPERS,SACRAMENTO_KINGS,117,108,3240,9
3240,2015-01-18,2015-01-17,NEW_ORLEANS_PELICANS,TORONTO_RAPTORS,95,93,3241,2
3241,2015-01-18,2015-01-17,OKLAHOMA_CITY_THUNDER,ORLANDO_MAGIC,127,99,3242,28
3242,2015-01-19,2015-01-18,UTAH_JAZZ,SAN_ANTONIO_SPURS,69,89,3243,20
3243,2015-01-19,2015-01-18,MINNESOTA_TIMBERWOLVES,CHARLOTTE_HORNETS,80,105,3244,25
3244,2015-01-19,2015-01-18,PHILADELPHIA_76ERS,WASHINGTON_WIZARDS,76,111,3245,35
3245,2015-01-19,2015-01-18,DETROIT_PISTONS,ATLANTA_HAWKS,82,93,3246,11
3246,2015-01-19,2015-01-18,BOSTON_CELTICS,LOS_ANGELES_CLIPPERS,93,102,3247,9
3247,2015-01-19,2015-01-18,DENVER_NUGGETS,GOLDEN_STATE_WARRIORS,79,122,3248,43
3248,2015-01-19,2015-01-18,DALLAS_MAVERICKS,MEMPHIS_GRIZZLIES,103,95,3249,8
3249,2015-01-19,2015-01-18,INDIANA_PACERS,HOUSTON_ROCKETS,98,110,3250,12
3250,2015-01-19,2015-01-18,NEW_ORLEANS_PELICANS,NEW_YORK_KNICKS,92,99,3251,7
3251,2015-01-20,2015-01-19,CHICAGO_BULLS,CLEVELAND_CAVALIERS,94,108,3252,14
3252,2015-01-20,2015-01-19,TORONTO_RAPTORS,MILWAUKEE_BUCKS,92,89,3253,3
3253,2015-01-20,2015-01-19,LOS_ANGELES_LAKERS,PHOENIX_SUNS,100,115,3254,15
3254,2015-01-20,2015-01-19,SACRAMENTO_KINGS,PORTLAND_TRAIL_BLAZERS,94,98,3255,4
3255,2015-01-21,2015-01-20,OKLAHOMA_CITY_THUNDER,MIAMI_HEAT,94,86,3256,8
3256,2015-01-21,2015-01-20,SAN_ANTONIO_SPURS,DENVER_NUGGETS,109,99,3257,10
3257,2015-01-22,2015-01-21,MIAMI_HEAT,CHARLOTTE_HORNETS,76,78,3258,2
3258,2015-01-22,2015-01-21,UTAH_JAZZ,CLEVELAND_CAVALIERS,92,106,3259,14
3259,2015-01-22,2015-01-21,NEW_YORK_KNICKS,PHILADELPHIA_76ERS,98,91,3260,7
3260,2015-01-22,2015-01-21,INDIANA_PACERS,ATLANTA_HAWKS,91,110,3261,19
3261,2015-01-22,2015-01-21,ORLANDO_MAGIC,DETROIT_PISTONS,118,128,3262,10
3262,2015-01-22,2015-01-21,TORONTO_RAPTORS,MEMPHIS_GRIZZLIES,86,92,3263,6
3263,2015-01-22,2015-01-21,DALLAS_MAVERICKS,MINNESOTA_TIMBERWOLVES,98,75,3264,23
3264,2015-01-22,2015-01-21,LOS_ANGELES_LAKERS,NEW_ORLEANS_PELICANS,80,96,3265,16
3265,2015-01-22,2015-01-21,OKLAHOMA_CITY_THUNDER,WASHINGTON_WIZARDS,105,103,3266,2
3266,2015-01-22,2015-01-21,PORTLAND_TRAIL_BLAZERS,PHOENIX_SUNS,113,118,3267,5
3267,2015-01-22,2015-01-21,BROOKLYN_NETS,SACRAMENTO_KINGS,103,100,3268,3
3268,2015-01-22,2015-01-21,HOUSTON_ROCKETS,GOLDEN_STATE_WARRIORS,113,126,3269,13
3269,2015-01-23,2015-01-22,SAN_ANTONIO_SPURS,CHICAGO_BULLS,81,104,3270,23
3270,2015-01-23,2015-01-22,UTAH_JAZZ,MILWAUKEE_BUCKS,101,99,3271,2
3271,2015-01-23,2015-01-22,BOSTON_CELTICS,PORTLAND_TRAIL_BLAZERS,90,89,3272,1
3272,2015-01-23,2015-01-22,BROOKLYN_NETS,LOS_ANGELES_CLIPPERS,84,123,3273,39
3273,2015-01-24,2015-01-23,TORONTO_RAPTORS,PHILADELPHIA_76ERS,91,86,3274,5
3274,2015-01-24,2015-01-23,OKLAHOMA_CITY_THUNDER,ATLANTA_HAWKS,93,103,3275,10
3275,2015-01-24,2015-01-23,CHARLOTTE_HORNETS,CLEVELAND_CAVALIERS,90,129,3276,39
3276,2015-01-24,2015-01-23,INDIANA_PACERS,MIAMI_HEAT,87,89,3277,2
3277,2015-01-24,2015-01-23,ORLANDO_MAGIC,NEW_YORK_KNICKS,106,113,3278,7
3278,2015-01-24,2015-01-23,CHICAGO_BULLS,DALLAS_MAVERICKS,102,98,3279,4
3279,2015-01-24,2015-01-23,NEW_ORLEANS_PELICANS,MINNESOTA_TIMBERWOLVES,92,84,3280,8
3280,2015-01-24,2015-01-23,LOS_ANGELES_LAKERS,SAN_ANTONIO_SPURS,85,99,3281,14
3281,2015-01-24,2015-01-23,BOSTON_CELTICS,DENVER_NUGGETS,100,99,3282,1
3282,2015-01-24,2015-01-23,HOUSTON_ROCKETS,PHOENIX_SUNS,113,111,3283,2
3283,2015-01-24,2015-01-23,SACRAMENTO_KINGS,GOLDEN_STATE_WARRIORS,101,126,3284,25
3284,2015-01-25,2015-01-24,NEW_YORK_KNICKS,CHARLOTTE_HORNETS,71,76,3285,5
3285,2015-01-25,2015-01-24,DETROIT_PISTONS,MILWAUKEE_BUCKS,86,101,3286,15
3286,2015-01-25,2015-01-24,PHILADELPHIA_76ERS,MEMPHIS_GRIZZLIES,83,101,3287,18
3287,2015-01-25,2015-01-24,BROOKLYN_NETS,UTAH_JAZZ,73,108,3288,35
3288,2015-01-25,2015-01-24,WASHINGTON_WIZARDS,PORTLAND_TRAIL_BLAZERS,96,103,3289,7
3289,2015-01-25,2015-01-24,MIAMI_HEAT,CHICAGO_BULLS,96,84,3290,12
3290,2015-01-25,2015-01-24,OKLAHOMA_CITY_THUNDER,CLEVELAND_CAVALIERS,98,108,3291,10
3291,2015-01-25,2015-01-24,MINNESOTA_TIMBERWOLVES,ATLANTA_HAWKS,100,112,3292,12
3292,2015-01-25,2015-01-24,DALLAS_MAVERICKS,NEW_ORLEANS_PELICANS,106,109,3293,3
3293,2015-01-25,2015-01-24,INDIANA_PACERS,ORLANDO_MAGIC,106,99,3294,7
3294,2015-01-25,2015-01-24,LOS_ANGELES_CLIPPERS,PHOENIX_SUNS,120,100,3295,20
3295,2015-01-26,2015-01-25,MILWAUKEE_BUCKS,SAN_ANTONIO_SPURS,95,101,3296,6
3296,2015-01-26,2015-01-25,DETROIT_PISTONS,TORONTO_RAPTORS,110,114,3297,4
3297,2015-01-26,2015-01-25,WASHINGTON_WIZARDS,DENVER_NUGGETS,117,115,3298,2
3298,2015-01-26,2015-01-25,BOSTON_CELTICS,GOLDEN_STATE_WARRIORS,111,114,3299,3
3299,2015-01-26,2015-01-25,HOUSTON_ROCKETS,LOS_ANGELES_LAKERS,99,87,3300,12
3300,2015-01-27,2015-01-26,ORLANDO_MAGIC,MEMPHIS_GRIZZLIES,94,103,3301,9
3301,2015-01-27,2015-01-26,PHILADELPHIA_76ERS,NEW_ORLEANS_PELICANS,74,99,3302,25
3302,2015-01-27,2015-01-26,MINNESOTA_TIMBERWOLVES,OKLAHOMA_CITY_THUNDER,84,92,3303,8
3303,2015-01-27,2015-01-26,BOSTON_CELTICS,UTAH_JAZZ,99,90,3304,9
3304,2015-01-27,2015-01-26,DENVER_NUGGETS,LOS_ANGELES_CLIPPERS,98,102,3305,4
3305,2015-01-28,2015-01-27,TORONTO_RAPTORS,INDIANA_PACERS,104,91,3306,13
3306,2015-01-28,2015-01-27,CLEVELAND_CAVALIERS,DETROIT_PISTONS,103,95,3307,8
3307,2015-01-28,2015-01-27,MILWAUKEE_BUCKS,MIAMI_HEAT,109,102,3308,7
3308,2015-01-28,2015-01-27,MEMPHIS_GRIZZLIES,DALLAS_MAVERICKS,109,90,3309,19
3309,2015-01-28,2015-01-27,CHICAGO_BULLS,GOLDEN_STATE_WARRIORS,113,111,3310,2
3310,2015-01-28,2015-01-27,WASHINGTON_WIZARDS,LOS_ANGELES_LAKERS,98,92,3311,6
3311,2015-01-29,2015-01-28,PORTLAND_TRAIL_BLAZERS,CLEVELAND_CAVALIERS,94,99,3312,5
3312,2015-01-29,2015-01-28,DETROIT_PISTONS,PHILADELPHIA_76ERS,69,89,3313,20
3313,2015-01-29,2015-01-28,SACRAMENTO_KINGS,TORONTO_RAPTORS,102,119,3314,17
3314,2015-01-29,2015-01-28,BROOKLYN_NETS,ATLANTA_HAWKS,102,113,3315,11
3315,2015-01-29,2015-01-28,DALLAS_MAVERICKS,HOUSTON_ROCKETS,94,99,3316,5
3316,2015-01-29,2015-01-28,BOSTON_CELTICS,MINNESOTA_TIMBERWOLVES,98,110,3317,12
3317,2015-01-29,2015-01-28,DENVER_NUGGETS,NEW_ORLEANS_PELICANS,93,85,3318,8
3318,2015-01-29,2015-01-28,OKLAHOMA_CITY_THUNDER,NEW_YORK_KNICKS,92,100,3319,8
3319,2015-01-29,2015-01-28,CHARLOTTE_HORNETS,SAN_ANTONIO_SPURS,86,95,3320,9
3320,2015-01-29,2015-01-28,LOS_ANGELES_CLIPPERS,UTAH_JAZZ,94,89,3321,5
3321,2015-01-29,2015-01-28,WASHINGTON_WIZARDS,PHOENIX_SUNS,98,106,3322,8
3322,2015-01-30,2015-01-29,NEW_YORK_KNICKS,INDIANA_PACERS,82,103,3323,21
3323,2015-01-30,2015-01-29,MILWAUKEE_BUCKS,ORLANDO_MAGIC,115,100,3324,15
3324,2015-01-30,2015-01-29,DENVER_NUGGETS,MEMPHIS_GRIZZLIES,69,99,3325,30
3325,2015-01-30,2015-01-29,CHICAGO_BULLS,LOS_ANGELES_LAKERS,118,123,3326,5
3326,2015-01-31,2015-01-30,MINNESOTA_TIMBERWOLVES,PHILADELPHIA_76ERS,94,103,3327,9
3327,2015-01-31,2015-01-30,PORTLAND_TRAIL_BLAZERS,ATLANTA_HAWKS,99,105,3328,6
3328,2015-01-31,2015-01-30,HOUSTON_ROCKETS,BOSTON_CELTICS,93,87,3329,6
3329,2015-01-31,2015-01-30,TORONTO_RAPTORS,BROOKLYN_NETS,127,122,3330,5
3330,2015-01-31,2015-01-30,SACRAMENTO_KINGS,CLEVELAND_CAVALIERS,90,101,3331,11
3331,2015-01-31,2015-01-30,DALLAS_MAVERICKS,MIAMI_HEAT,93,72,3332,21
3332,2015-01-31,2015-01-30,LOS_ANGELES_CLIPPERS,NEW_ORLEANS_PELICANS,103,108,3333,5
3333,2015-01-31,2015-01-30,GOLDEN_STATE_WARRIORS,UTAH_JAZZ,100,110,3334,10
3334,2015-01-31,2015-01-30,CHICAGO_BULLS,PHOENIX_SUNS,93,99,3335,6
3335,2015-02-01,2015-01-31,SACRAMENTO_KINGS,INDIANA_PACERS,99,94,3336,5
3336,2015-02-01,2015-01-31,DALLAS_MAVERICKS,ORLANDO_MAGIC,108,93,3337,15
3337,2015-02-01,2015-01-31,TORONTO_RAPTORS,WASHINGTON_WIZARDS,120,116,3338,4
3338,2015-02-01,2015-01-31,PHILADELPHIA_76ERS,ATLANTA_HAWKS,85,91,3339,6
3339,2015-02-01,2015-01-31,HOUSTON_ROCKETS,DETROIT_PISTONS,101,114,3340,13
3340,2015-02-01,2015-01-31,OKLAHOMA_CITY_THUNDER,MEMPHIS_GRIZZLIES,74,85,3341,11
3341,2015-02-01,2015-01-31,CLEVELAND_CAVALIERS,MINNESOTA_TIMBERWOLVES,106,90,3342,16
3342,2015-02-01,2015-01-31,PORTLAND_TRAIL_BLAZERS,MILWAUKEE_BUCKS,88,95,3343,7
3343,2015-02-01,2015-01-31,CHARLOTTE_HORNETS,DENVER_NUGGETS,104,86,3344,18
3344,2015-02-01,2015-01-31,LOS_ANGELES_CLIPPERS,SAN_ANTONIO_SPURS,105,85,3345,20
3345,2015-02-01,2015-01-31,PHOENIX_SUNS,GOLDEN_STATE_WARRIORS,87,106,3346,19
3346,2015-02-01,2015-01-31,MIAMI_HEAT,BOSTON_CELTICS,83,75,3347,8
3347,2015-02-01,2015-01-31,LOS_ANGELES_LAKERS,NEW_YORK_KNICKS,80,92,3348,12
3348,2015-02-03,2015-02-02,PHILADELPHIA_76ERS,CLEVELAND_CAVALIERS,84,97,3349,13
3349,2015-02-03,2015-02-02,CHARLOTTE_HORNETS,WASHINGTON_WIZARDS,92,88,3350,4
3350,2015-02-03,2015-02-02,LOS_ANGELES_CLIPPERS,BROOKLYN_NETS,100,102,3351,2
3351,2015-02-03,2015-02-02,MILWAUKEE_BUCKS,TORONTO_RAPTORS,82,75,3352,7
3352,2015-02-03,2015-02-02,ATLANTA_HAWKS,NEW_ORLEANS_PELICANS,100,115,3353,15
3353,2015-02-03,2015-02-02,ORLANDO_MAGIC,OKLAHOMA_CITY_THUNDER,97,104,3354,7
3354,2015-02-03,2015-02-02,MINNESOTA_TIMBERWOLVES,DALLAS_MAVERICKS,94,100,3355,6
3355,2015-02-03,2015-02-02,MEMPHIS_GRIZZLIES,PHOENIX_SUNS,102,101,3356,1
3356,2015-02-04,2015-02-03,DENVER_NUGGETS,PHILADELPHIA_76ERS,98,105,3357,7
3357,2015-02-04,2015-02-03,MIAMI_HEAT,DETROIT_PISTONS,91,108,3358,17
3358,2015-02-04,2015-02-03,BOSTON_CELTICS,NEW_YORK_KNICKS,108,97,3359,11
3359,2015-02-04,2015-02-03,UTAH_JAZZ,PORTLAND_TRAIL_BLAZERS,102,103,3360,1
3360,2015-02-04,2015-02-03,GOLDEN_STATE_WARRIORS,SACRAMENTO_KINGS,121,96,3361,25
3361,2015-02-05,2015-02-04,DETROIT_PISTONS,INDIANA_PACERS,109,114,3362,5
3362,2015-02-05,2015-02-04,WASHINGTON_WIZARDS,ATLANTA_HAWKS,96,105,3363,9
3363,2015-02-05,2015-02-04,DENVER_NUGGETS,BOSTON_CELTICS,100,104,3364,4
3364,2015-02-05,2015-02-04,BROOKLYN_NETS,TORONTO_RAPTORS,109,93,3365,16
3365,2015-02-05,2015-02-04,CHICAGO_BULLS,HOUSTON_ROCKETS,90,101,3366,11
3366,2015-02-05,2015-02-04,LOS_ANGELES_LAKERS,MILWAUKEE_BUCKS,105,113,3367,8
3367,2015-02-05,2015-02-04,MIAMI_HEAT,MINNESOTA_TIMBERWOLVES,101,102,3368,1
3368,2015-02-05,2015-02-04,OKLAHOMA_CITY_THUNDER,NEW_ORLEANS_PELICANS,102,91,3369,11
3369,2015-02-05,2015-02-04,ORLANDO_MAGIC,SAN_ANTONIO_SPURS,103,110,3370,7
3370,2015-02-05,2015-02-04,MEMPHIS_GRIZZLIES,UTAH_JAZZ,100,90,3371,10
3371,2015-02-05,2015-02-04,DALLAS_MAVERICKS,GOLDEN_STATE_WARRIORS,114,128,3372,14
3372,2015-02-06,2015-02-05,WASHINGTON_WIZARDS,CHARLOTTE_HORNETS,87,94,3373,7
3373,2015-02-06,2015-02-05,LOS_ANGELES_CLIPPERS,CLEVELAND_CAVALIERS,94,105,3374,11
3374,2015-02-06,2015-02-05,DALLAS_MAVERICKS,SACRAMENTO_KINGS,101,78,3375,23
3375,2015-02-06,2015-02-05,PHOENIX_SUNS,PORTLAND_TRAIL_BLAZERS,87,108,3376,21
3376,2015-02-07,2015-02-06,NEW_YORK_KNICKS,BROOKLYN_NETS,88,92,3377,4
3377,2015-02-07,2015-02-06,CLEVELAND_CAVALIERS,INDIANA_PACERS,99,103,3378,4
3378,2015-02-07,2015-02-06,LOS_ANGELES_LAKERS,ORLANDO_MAGIC,97,103,3379,6
3379,2015-02-07,2015-02-06,LOS_ANGELES_CLIPPERS,TORONTO_RAPTORS,107,123,3380,16
3380,2015-02-07,2015-02-06,GOLDEN_STATE_WARRIORS,ATLANTA_HAWKS,116,124,3381,8
3381,2015-02-07,2015-02-06,PHILADELPHIA_76ERS,BOSTON_CELTICS,96,107,3382,11
3382,2015-02-07,2015-02-06,DENVER_NUGGETS,DETROIT_PISTONS,88,98,3383,10
3383,2015-02-07,2015-02-06,MILWAUKEE_BUCKS,HOUSTON_ROCKETS,111,117,3384,6
3384,2015-02-07,2015-02-06,MEMPHIS_GRIZZLIES,MINNESOTA_TIMBERWOLVES,89,90,3385,1
3385,2015-02-07,2015-02-06,NEW_ORLEANS_PELICANS,OKLAHOMA_CITY_THUNDER,116,113,3386,3
3386,2015-02-07,2015-02-06,UTAH_JAZZ,PHOENIX_SUNS,93,100,3387,7
3387,2015-02-07,2015-02-06,MIAMI_HEAT,SAN_ANTONIO_SPURS,85,98,3388,13
3388,2015-02-08,2015-02-07,CHICAGO_BULLS,NEW_ORLEANS_PELICANS,107,72,3389,35
3389,2015-02-08,2015-02-07,BROOKLYN_NETS,WASHINGTON_WIZARDS,77,114,3390,37
3390,2015-02-08,2015-02-07,GOLDEN_STATE_WARRIORS,NEW_YORK_KNICKS,106,92,3391,14
3391,2015-02-08,2015-02-07,CHARLOTTE_HORNETS,PHILADELPHIA_76ERS,81,89,3392,8
3392,2015-02-08,2015-02-07,PORTLAND_TRAIL_BLAZERS,DALLAS_MAVERICKS,101,111,3393,10
3393,2015-02-08,2015-02-07,BOSTON_CELTICS,MILWAUKEE_BUCKS,93,96,3394,3
3394,2015-02-08,2015-02-07,SACRAMENTO_KINGS,UTAH_JAZZ,90,102,3395,12
3395,2015-02-08,2015-02-07,LOS_ANGELES_CLIPPERS,OKLAHOMA_CITY_THUNDER,108,131,3396,23
3396,2015-02-08,2015-02-07,LOS_ANGELES_LAKERS,CLEVELAND_CAVALIERS,105,120,3397,15
3397,2015-02-08,2015-02-07,INDIANA_PACERS,CHARLOTTE_HORNETS,103,102,3398,1
3398,2015-02-08,2015-02-07,MINNESOTA_TIMBERWOLVES,DETROIT_PISTONS,112,101,3399,11
3399,2015-02-08,2015-02-07,ATLANTA_HAWKS,MEMPHIS_GRIZZLIES,88,94,3400,6
3400,2015-02-08,2015-02-07,CHICAGO_BULLS,ORLANDO_MAGIC,98,97,3401,1
3401,2015-02-09,2015-02-08,PORTLAND_TRAIL_BLAZERS,HOUSTON_ROCKETS,109,98,3402,11
3402,2015-02-09,2015-02-08,SAN_ANTONIO_SPURS,TORONTO_RAPTORS,82,87,3403,5
3403,2015-02-09,2015-02-08,PHOENIX_SUNS,SACRAMENTO_KINGS,83,85,3404,2
3404,2015-02-10,2015-02-09,SAN_ANTONIO_SPURS,INDIANA_PACERS,95,93,3405,2
3405,2015-02-10,2015-02-09,GOLDEN_STATE_WARRIORS,PHILADELPHIA_76ERS,89,84,3406,5
3406,2015-02-10,2015-02-09,ORLANDO_MAGIC,WASHINGTON_WIZARDS,80,96,3407,16
3407,2015-02-10,2015-02-09,NEW_YORK_KNICKS,MIAMI_HEAT,95,109,3408,14
3408,2015-02-10,2015-02-09,BROOKLYN_NETS,MILWAUKEE_BUCKS,97,103,3409,6
3409,2015-02-10,2015-02-09,ATLANTA_HAWKS,MINNESOTA_TIMBERWOLVES,117,105,3410,12
3410,2015-02-10,2015-02-09,UTAH_JAZZ,NEW_ORLEANS_PELICANS,100,96,3411,4
3411,2015-02-10,2015-02-09,LOS_ANGELES_CLIPPERS,DALLAS_MAVERICKS,115,98,3412,17
3412,2015-02-10,2015-02-09,OKLAHOMA_CITY_THUNDER,DENVER_NUGGETS,124,114,3413,10
3413,2015-02-11,2015-02-10,DETROIT_PISTONS,CHARLOTTE_HORNETS,106,78,3414,28
3414,2015-02-11,2015-02-10,SACRAMENTO_KINGS,CHICAGO_BULLS,86,104,3415,18
3415,2015-02-11,2015-02-10,BROOKLYN_NETS,MEMPHIS_GRIZZLIES,86,95,3416,9
3416,2015-02-11,2015-02-10,HOUSTON_ROCKETS,PHOENIX_SUNS,127,118,3417,9
3417,2015-02-11,2015-02-10,DENVER_NUGGETS,LOS_ANGELES_LAKERS,106,96,3418,10
3418,2015-02-12,2015-02-11,NEW_YORK_KNICKS,ORLANDO_MAGIC,83,89,3419,6
3419,2015-02-12,2015-02-11,ATLANTA_HAWKS,BOSTON_CELTICS,88,89,3420,1
3420,2015-02-12,2015-02-11,SAN_ANTONIO_SPURS,DETROIT_PISTONS,104,87,3421,17
3421,2015-02-12,2015-02-11,WASHINGTON_WIZARDS,TORONTO_RAPTORS,93,95,3422,2
3422,2015-02-12,2015-02-11,MIAMI_HEAT,CLEVELAND_CAVALIERS,93,113,3423,20
3423,2015-02-12,2015-02-11,SACRAMENTO_KINGS,MILWAUKEE_BUCKS,103,111,3424,8
3424,2015-02-12,2015-02-11,GOLDEN_STATE_WARRIORS,MINNESOTA_TIMBERWOLVES,94,91,3425,3
3425,2015-02-12,2015-02-11,INDIANA_PACERS,NEW_ORLEANS_PELICANS,106,93,3426,13
3426,2015-02-12,2015-02-11,MEMPHIS_GRIZZLIES,OKLAHOMA_CITY_THUNDER,89,105,3427,16
3427,2015-02-12,2015-02-11,UTAH_JAZZ,DALLAS_MAVERICKS,82,87,3428,5
3428,2015-02-12,2015-02-11,LOS_ANGELES_LAKERS,PORTLAND_TRAIL_BLAZERS,86,102,3429,16
3429,2015-02-12,2015-02-11,HOUSTON_ROCKETS,LOS_ANGELES_CLIPPERS,95,110,3430,15
3430,2015-02-13,2015-02-12,CLEVELAND_CAVALIERS,CHICAGO_BULLS,98,113,3431,15
3431,2015-02-20,2015-02-19,DALLAS_MAVERICKS,OKLAHOMA_CITY_THUNDER,89,104,3432,15
3432,2015-02-20,2015-02-19,SAN_ANTONIO_SPURS,LOS_ANGELES_CLIPPERS,115,119,3433,4
3433,2015-02-21,2015-02-20,NEW_ORLEANS_PELICANS,ORLANDO_MAGIC,84,95,3434,11
3434,2015-02-21,2015-02-20,INDIANA_PACERS,PHILADELPHIA_76ERS,106,95,3435,11
3435,2015-02-21,2015-02-20,TORONTO_RAPTORS,ATLANTA_HAWKS,105,80,3436,25
3436,2015-02-21,2015-02-20,CHICAGO_BULLS,DETROIT_PISTONS,91,100,3437,9
3437,2015-02-21,2015-02-20,MIAMI_HEAT,NEW_YORK_KNICKS,111,87,3438,24
3438,2015-02-21,2015-02-20,PHOENIX_SUNS,MINNESOTA_TIMBERWOLVES,109,111,3439,2
3439,2015-02-21,2015-02-20,CLEVELAND_CAVALIERS,WASHINGTON_WIZARDS,127,89,3440,38
3440,2015-02-21,2015-02-20,HOUSTON_ROCKETS,DALLAS_MAVERICKS,100,111,3441,11
3441,2015-02-21,2015-02-20,DENVER_NUGGETS,MILWAUKEE_BUCKS,81,89,3442,8
3442,2015-02-21,2015-02-20,PORTLAND_TRAIL_BLAZERS,UTAH_JAZZ,76,92,3443,16
3443,2015-02-21,2015-02-20,BOSTON_CELTICS,SACRAMENTO_KINGS,101,109,3444,8
3444,2015-02-21,2015-02-20,SAN_ANTONIO_SPURS,GOLDEN_STATE_WARRIORS,99,110,3445,11
3445,2015-02-21,2015-02-20,BROOKLYN_NETS,LOS_ANGELES_LAKERS,114,105,3446,9
3446,2015-02-22,2015-02-21,OKLAHOMA_CITY_THUNDER,CHARLOTTE_HORNETS,110,103,3447,7
3447,2015-02-22,2015-02-21,NEW_ORLEANS_PELICANS,MIAMI_HEAT,105,91,3448,14
3448,2015-02-22,2015-02-21,PHOENIX_SUNS,CHICAGO_BULLS,107,112,3449,5
3449,2015-02-22,2015-02-21,TORONTO_RAPTORS,HOUSTON_ROCKETS,76,98,3450,22
3450,2015-02-22,2015-02-21,SACRAMENTO_KINGS,LOS_ANGELES_CLIPPERS,99,126,3451,27
3451,2015-02-22,2015-02-21,CLEVELAND_CAVALIERS,NEW_YORK_KNICKS,101,83,3452,18
3452,2015-02-22,2015-02-21,WASHINGTON_WIZARDS,DETROIT_PISTONS,89,106,3453,17
3453,2015-02-22,2015-02-21,ATLANTA_HAWKS,MILWAUKEE_BUCKS,97,86,3454,11
3454,2015-02-22,2015-02-21,GOLDEN_STATE_WARRIORS,INDIANA_PACERS,98,104,3455,6
3455,2015-02-22,2015-02-21,PHILADELPHIA_76ERS,ORLANDO_MAGIC,98,103,3456,5
3456,2015-02-23,2015-02-22,DENVER_NUGGETS,OKLAHOMA_CITY_THUNDER,94,119,3457,25
3457,2015-02-23,2015-02-22,CHARLOTTE_HORNETS,DALLAS_MAVERICKS,81,92,3458,11
3458,2015-02-23,2015-02-22,MEMPHIS_GRIZZLIES,PORTLAND_TRAIL_BLAZERS,98,92,3459,6
3459,2015-02-23,2015-02-22,BOSTON_CELTICS,LOS_ANGELES_LAKERS,111,118,3460,7
3460,2015-02-24,2015-02-23,PHILADELPHIA_76ERS,MIAMI_HEAT,108,119,3461,11
3461,2015-02-24,2015-02-23,MILWAUKEE_BUCKS,CHICAGO_BULLS,71,87,3462,16
3462,2015-02-24,2015-02-23,MINNESOTA_TIMBERWOLVES,HOUSTON_ROCKETS,102,113,3463,11
3463,2015-02-24,2015-02-23,TORONTO_RAPTORS,NEW_ORLEANS_PELICANS,97,100,3464,3
3464,2015-02-24,2015-02-23,BROOKLYN_NETS,DENVER_NUGGETS,110,82,3465,28
3465,2015-02-24,2015-02-23,BOSTON_CELTICS,PHOENIX_SUNS,115,110,3466,5
3466,2015-02-24,2015-02-23,SAN_ANTONIO_SPURS,UTAH_JAZZ,81,90,3467,9
3467,2015-02-24,2015-02-23,MEMPHIS_GRIZZLIES,LOS_ANGELES_CLIPPERS,90,87,3468,3
3468,2015-02-25,2015-02-24,GOLDEN_STATE_WARRIORS,WASHINGTON_WIZARDS,114,107,3469,7
3469,2015-02-25,2015-02-24,CLEVELAND_CAVALIERS,DETROIT_PISTONS,102,93,3470,9
3470,2015-02-25,2015-02-24,INDIANA_PACERS,OKLAHOMA_CITY_THUNDER,92,105,3471,13
3471,2015-02-25,2015-02-24,TORONTO_RAPTORS,DALLAS_MAVERICKS,92,99,3472,7
3472,2015-02-26,2015-02-25,MIAMI_HEAT,ORLANDO_MAGIC,93,90,3473,3
3473,2015-02-26,2015-02-25,DALLAS_MAVERICKS,ATLANTA_HAWKS,87,104,3474,17
3474,2015-02-26,2015-02-25,NEW_YORK_KNICKS,BOSTON_CELTICS,94,115,3475,21
3475,2015-02-26,2015-02-25,CHARLOTTE_HORNETS,CHICAGO_BULLS,98,86,3476,12
3476,2015-02-26,2015-02-25,LOS_ANGELES_CLIPPERS,HOUSTON_ROCKETS,105,110,3477,5
3477,2015-02-26,2015-02-25,PHILADELPHIA_76ERS,MILWAUKEE_BUCKS,88,104,3478,16
3478,2015-02-26,2015-02-25,WASHINGTON_WIZARDS,MINNESOTA_TIMBERWOLVES,77,97,3479,20
3479,2015-02-26,2015-02-25,BROOKLYN_NETS,NEW_ORLEANS_PELICANS,96,102,3480,6
3480,2015-02-26,2015-02-25,PHOENIX_SUNS,DENVER_NUGGETS,110,96,3481,14
3481,2015-02-26,2015-02-25,LOS_ANGELES_LAKERS,UTAH_JAZZ,100,97,3482,3
3482,2015-02-26,2015-02-25,MEMPHIS_GRIZZLIES,SACRAMENTO_KINGS,90,102,3483,12
3483,2015-02-26,2015-02-25,SAN_ANTONIO_SPURS,PORTLAND_TRAIL_BLAZERS,95,111,3484,16
3484,2015-02-27,2015-02-26,GOLDEN_STATE_WARRIORS,CLEVELAND_CAVALIERS,99,110,3485,11
3485,2015-02-27,2015-02-26,OKLAHOMA_CITY_THUNDER,PHOENIX_SUNS,113,117,3486,4
3486,2015-02-28,2015-02-27,CLEVELAND_CAVALIERS,INDIANA_PACERS,86,93,3487,7
3487,2015-02-28,2015-02-27,WASHINGTON_WIZARDS,PHILADELPHIA_76ERS,81,89,3488,8
3488,2015-02-28,2015-02-27,ORLANDO_MAGIC,ATLANTA_HAWKS,88,95,3489,7
3489,2015-02-28,2015-02-27,CHARLOTTE_HORNETS,BOSTON_CELTICS,98,106,3490,8
3490,2015-02-28,2015-02-27,NEW_YORK_KNICKS,DETROIT_PISTONS,121,115,3491,6
3491,2015-02-28,2015-02-27,GOLDEN_STATE_WARRIORS,TORONTO_RAPTORS,113,89,3492,24
3492,2015-02-28,2015-02-27,MINNESOTA_TIMBERWOLVES,CHICAGO_BULLS,89,96,3493,7
3493,2015-02-28,2015-02-27,BROOKLYN_NETS,HOUSTON_ROCKETS,98,102,3494,4
3494,2015-02-28,2015-02-27,LOS_ANGELES_CLIPPERS,MEMPHIS_GRIZZLIES,97,79,3495,18
3495,2015-02-28,2015-02-27,MIAMI_HEAT,NEW_ORLEANS_PELICANS,102,104,3496,2
3496,2015-02-28,2015-02-27,UTAH_JAZZ,DENVER_NUGGETS,104,82,3497,22
3497,2015-02-28,2015-02-27,SAN_ANTONIO_SPURS,SACRAMENTO_KINGS,107,96,3498,11
3498,2015-02-28,2015-02-27,MILWAUKEE_BUCKS,LOS_ANGELES_LAKERS,93,101,3499,8
3499,2015-02-28,2015-02-27,OKLAHOMA_CITY_THUNDER,PORTLAND_TRAIL_BLAZERS,112,115,3500,3
3500,2015-03-01,2015-02-28,DETROIT_PISTONS,WASHINGTON_WIZARDS,95,99,3501,4
3501,2015-03-01,2015-02-28,ATLANTA_HAWKS,MIAMI_HEAT,93,91,3502,2
3502,2015-03-01,2015-02-28,TORONTO_RAPTORS,NEW_YORK_KNICKS,98,103,3503,5
3503,2015-03-01,2015-02-28,MEMPHIS_GRIZZLIES,MINNESOTA_TIMBERWOLVES,101,97,3504,4
3504,2015-03-01,2015-02-28,BROOKLYN_NETS,DALLAS_MAVERICKS,104,94,3505,10
3505,2015-03-01,2015-02-28,SAN_ANTONIO_SPURS,PHOENIX_SUNS,101,74,3506,27
3506,2015-03-01,2015-02-28,MILWAUKEE_BUCKS,UTAH_JAZZ,75,82,3507,7
3507,2015-03-01,2015-02-28,LOS_ANGELES_CLIPPERS,CHICAGO_BULLS,96,86,3508,10
3508,2015-03-01,2015-02-28,CLEVELAND_CAVALIERS,HOUSTON_ROCKETS,103,105,3509,2
3509,2015-03-01,2015-02-28,GOLDEN_STATE_WARRIORS,BOSTON_CELTICS,106,101,3510,5
3510,2015-03-01,2015-02-28,PHILADELPHIA_76ERS,INDIANA_PACERS,74,94,3511,20
3511,2015-03-01,2015-02-28,CHARLOTTE_HORNETS,ORLANDO_MAGIC,98,83,3512,15
3512,2015-03-01,2015-02-28,PORTLAND_TRAIL_BLAZERS,SACRAMENTO_KINGS,110,99,3513,11
3513,2015-03-01,2015-02-28,OKLAHOMA_CITY_THUNDER,LOS_ANGELES_LAKERS,108,101,3514,7
3514,2015-03-02,2015-03-01,NEW_ORLEANS_PELICANS,DENVER_NUGGETS,99,92,3515,7
3515,2015-03-03,2015-03-02,TORONTO_RAPTORS,PHILADELPHIA_76ERS,114,103,3516,11
3516,2015-03-03,2015-03-02,GOLDEN_STATE_WARRIORS,BROOKLYN_NETS,108,110,3517,2
3517,2015-03-03,2015-03-02,PHOENIX_SUNS,MIAMI_HEAT,98,115,3518,17
3518,2015-03-03,2015-03-02,LOS_ANGELES_CLIPPERS,MINNESOTA_TIMBERWOLVES,110,105,3519,5
3519,2015-03-03,2015-03-02,NEW_ORLEANS_PELICANS,DALLAS_MAVERICKS,93,102,3520,9
3520,2015-03-04,2015-03-03,LOS_ANGELES_LAKERS,CHARLOTTE_HORNETS,103,104,3521,1
3521,2015-03-04,2015-03-03,BOSTON_CELTICS,CLEVELAND_CAVALIERS,79,110,3522,31
3522,2015-03-04,2015-03-03,SACRAMENTO_KINGS,NEW_YORK_KNICKS,124,86,3523,38
3523,2015-03-04,2015-03-03,HOUSTON_ROCKETS,ATLANTA_HAWKS,96,104,3524,8
3524,2015-03-04,2015-03-03,WASHINGTON_WIZARDS,CHICAGO_BULLS,92,97,3525,5
3525,2015-03-04,2015-03-03,UTAH_JAZZ,MEMPHIS_GRIZZLIES,93,82,3526,11
3526,2015-03-04,2015-03-03,MILWAUKEE_BUCKS,DENVER_NUGGETS,95,106,3527,11
3527,2015-03-05,2015-03-04,NEW_YORK_KNICKS,INDIANA_PACERS,82,105,3528,23
3528,2015-03-05,2015-03-04,PHOENIX_SUNS,ORLANDO_MAGIC,105,100,3529,5
3529,2015-03-05,2015-03-04,UTAH_JAZZ,BOSTON_CELTICS,84,85,3530,1
3530,2015-03-05,2015-03-04,CHARLOTTE_HORNETS,BROOKLYN_NETS,115,91,3531,24
3531,2015-03-05,2015-03-04,CLEVELAND_CAVALIERS,TORONTO_RAPTORS,120,112,3532,8
3532,2015-03-05,2015-03-04,MEMPHIS_GRIZZLIES,HOUSTON_ROCKETS,102,100,3533,2
3533,2015-03-05,2015-03-04,LOS_ANGELES_LAKERS,MIAMI_HEAT,94,100,3534,6
3534,2015-03-05,2015-03-04,DENVER_NUGGETS,MINNESOTA_TIMBERWOLVES,100,85,3535,15
3535,2015-03-05,2015-03-04,DETROIT_PISTONS,NEW_ORLEANS_PELICANS,85,88,3536,3
3536,2015-03-05,2015-03-04,PHILADELPHIA_76ERS,OKLAHOMA_CITY_THUNDER,118,123,3537,5
3537,2015-03-05,2015-03-04,SACRAMENTO_KINGS,SAN_ANTONIO_SPURS,85,112,3538,27
3538,2015-03-05,2015-03-04,MILWAUKEE_BUCKS,GOLDEN_STATE_WARRIORS,93,102,3539,9
3539,2015-03-05,2015-03-04,PORTLAND_TRAIL_BLAZERS,LOS_ANGELES_CLIPPERS,98,93,3540,5
3540,2015-03-06,2015-03-05,OKLAHOMA_CITY_THUNDER,CHICAGO_BULLS,105,108,3541,3
3541,2015-03-06,2015-03-05,DALLAS_MAVERICKS,PORTLAND_TRAIL_BLAZERS,75,94,3542,19
3542,2015-03-07,2015-03-06,TORONTO_RAPTORS,CHARLOTTE_HORNETS,94,103,3543,9
3543,2015-03-07,2015-03-06,CHICAGO_BULLS,INDIANA_PACERS,84,98,3544,14
3544,2015-03-07,2015-03-06,SACRAMENTO_KINGS,ORLANDO_MAGIC,114,119,3545,5
3545,2015-03-07,2015-03-06,UTAH_JAZZ,PHILADELPHIA_76ERS,89,83,3546,6
3546,2015-03-07,2015-03-06,MIAMI_HEAT,WASHINGTON_WIZARDS,97,99,3547,2
3547,2015-03-07,2015-03-06,CLEVELAND_CAVALIERS,ATLANTA_HAWKS,97,106,3548,9
3548,2015-03-07,2015-03-06,PHOENIX_SUNS,BROOKLYN_NETS,108,100,3549,8
3549,2015-03-07,2015-03-06,DETROIT_PISTONS,HOUSTON_ROCKETS,93,103,3550,10
3550,2015-03-07,2015-03-06,LOS_ANGELES_LAKERS,MEMPHIS_GRIZZLIES,90,97,3551,7
3551,2015-03-07,2015-03-06,BOSTON_CELTICS,NEW_ORLEANS_PELICANS,104,98,3552,6
3552,2015-03-07,2015-03-06,DENVER_NUGGETS,SAN_ANTONIO_SPURS,111,120,3553,9
3553,2015-03-07,2015-03-06,DALLAS_MAVERICKS,GOLDEN_STATE_WARRIORS,89,104,3554,15
3554,2015-03-08,2015-03-07,MEMPHIS_GRIZZLIES,NEW_ORLEANS_PELICANS,89,95,3555,6
3555,2015-03-08,2015-03-07,PHOENIX_SUNS,CLEVELAND_CAVALIERS,79,89,3556,10
3556,2015-03-08,2015-03-07,SACRAMENTO_KINGS,MIAMI_HEAT,109,114,3557,5
3557,2015-03-08,2015-03-07,INDIANA_PACERS,NEW_YORK_KNICKS,92,86,3558,6
3558,2015-03-08,2015-03-07,ATLANTA_HAWKS,PHILADELPHIA_76ERS,84,92,3559,8
3559,2015-03-08,2015-03-07,PORTLAND_TRAIL_BLAZERS,MINNESOTA_TIMBERWOLVES,113,121,3560,8
3560,2015-03-08,2015-03-07,WASHINGTON_WIZARDS,MILWAUKEE_BUCKS,85,91,3561,6
3561,2015-03-08,2015-03-07,HOUSTON_ROCKETS,DENVER_NUGGETS,114,100,3562,14
3562,2015-03-08,2015-03-07,CHICAGO_BULLS,SAN_ANTONIO_SPURS,105,116,3563,11
3563,2015-03-08,2015-03-07,LOS_ANGELES_CLIPPERS,GOLDEN_STATE_WARRIORS,98,106,3564,8
3564,2015-03-08,2015-03-07,UTAH_JAZZ,BROOKLYN_NETS,95,88,3565,7
3565,2015-03-08,2015-03-07,CHARLOTTE_HORNETS,DETROIT_PISTONS,108,101,3566,7
3566,2015-03-08,2015-03-07,BOSTON_CELTICS,ORLANDO_MAGIC,98,103,3567,5
3567,2015-03-08,2015-03-07,TORONTO_RAPTORS,OKLAHOMA_CITY_THUNDER,104,108,3568,4
3568,2015-03-09,2015-03-08,DALLAS_MAVERICKS,LOS_ANGELES_LAKERS,100,93,3569,7
3569,2015-03-09,2015-03-08,WASHINGTON_WIZARDS,CHARLOTTE_HORNETS,95,69,3570,26
3570,2015-03-09,2015-03-08,SACRAMENTO_KINGS,ATLANTA_HAWKS,105,130,3571,25
3571,2015-03-09,2015-03-08,BOSTON_CELTICS,MIAMI_HEAT,100,90,3572,10
3572,2015-03-10,2015-03-09,MEMPHIS_GRIZZLIES,CHICAGO_BULLS,101,91,3573,10
3573,2015-03-10,2015-03-09,NEW_ORLEANS_PELICANS,MILWAUKEE_BUCKS,114,103,3574,11
3574,2015-03-10,2015-03-09,NEW_YORK_KNICKS,DENVER_NUGGETS,78,106,3575,28
3575,2015-03-10,2015-03-09,GOLDEN_STATE_WARRIORS,PHOENIX_SUNS,98,80,3576,18
3576,2015-03-10,2015-03-09,MINNESOTA_TIMBERWOLVES,LOS_ANGELES_CLIPPERS,76,89,3577,13
3577,2015-03-10,2015-03-09,ORLANDO_MAGIC,INDIANA_PACERS,86,118,3578,32
3578,2015-03-10,2015-03-09,NEW_ORLEANS_PELICANS,BROOKLYN_NETS,111,91,3579,20
3579,2015-03-11,2015-03-10,CLEVELAND_CAVALIERS,DALLAS_MAVERICKS,127,94,3580,33
3580,2015-03-11,2015-03-10,TORONTO_RAPTORS,SAN_ANTONIO_SPURS,107,117,3581,10
3581,2015-03-11,2015-03-10,NEW_YORK_KNICKS,UTAH_JAZZ,82,87,3582,5
3582,2015-03-11,2015-03-10,DETROIT_PISTONS,LOS_ANGELES_LAKERS,85,93,3583,8
3583,2015-03-11,2015-03-10,SACRAMENTO_KINGS,CHARLOTTE_HORNETS,113,106,3584,7
3584,2015-03-11,2015-03-10,CHICAGO_BULLS,PHILADELPHIA_76ERS,104,95,3585,9
3585,2015-03-11,2015-03-10,MEMPHIS_GRIZZLIES,BOSTON_CELTICS,92,95,3586,3
3586,2015-03-11,2015-03-10,BROOKLYN_NETS,MIAMI_HEAT,98,104,3587,6
3587,2015-03-12,2015-03-11,ORLANDO_MAGIC,MILWAUKEE_BUCKS,91,97,3588,6
3588,2015-03-12,2015-03-11,LOS_ANGELES_CLIPPERS,OKLAHOMA_CITY_THUNDER,120,108,3589,12
3589,2015-03-12,2015-03-11,ATLANTA_HAWKS,DENVER_NUGGETS,102,115,3590,13
3590,2015-03-12,2015-03-11,MINNESOTA_TIMBERWOLVES,PHOENIX_SUNS,97,106,3591,9
3591,2015-03-12,2015-03-11,DETROIT_PISTONS,GOLDEN_STATE_WARRIORS,98,105,3592,7
3592,2015-03-12,2015-03-11,HOUSTON_ROCKETS,PORTLAND_TRAIL_BLAZERS,100,105,3593,5
3593,2015-03-12,2015-03-11,MILWAUKEE_BUCKS,INDIANA_PACERS,103,109,3594,6
3594,2015-03-12,2015-03-11,MEMPHIS_GRIZZLIES,WASHINGTON_WIZARDS,87,107,3595,20
3595,2015-03-13,2015-03-12,HOUSTON_ROCKETS,UTAH_JAZZ,91,109,3596,18
3596,2015-03-13,2015-03-12,CLEVELAND_CAVALIERS,SAN_ANTONIO_SPURS,128,125,3597,3
3597,2015-03-13,2015-03-12,NEW_YORK_KNICKS,LOS_ANGELES_LAKERS,101,94,3598,7
3598,2015-03-13,2015-03-12,CHICAGO_BULLS,CHARLOTTE_HORNETS,91,101,3599,10
3599,2015-03-13,2015-03-12,SACRAMENTO_KINGS,PHILADELPHIA_76ERS,107,114,3600,7
3600,2015-03-13,2015-03-12,ORLANDO_MAGIC,BOSTON_CELTICS,88,95,3601,7
3601,2015-03-13,2015-03-12,MIAMI_HEAT,TORONTO_RAPTORS,92,102,3602,10
3602,2015-03-14,2015-03-13,MINNESOTA_TIMBERWOLVES,OKLAHOMA_CITY_THUNDER,99,113,3603,14
3603,2015-03-14,2015-03-13,LOS_ANGELES_CLIPPERS,DALLAS_MAVERICKS,99,129,3604,30
3604,2015-03-14,2015-03-13,GOLDEN_STATE_WARRIORS,DENVER_NUGGETS,103,114,3605,11
3605,2015-03-14,2015-03-13,ATLANTA_HAWKS,PHOENIX_SUNS,96,87,3606,9
3606,2015-03-14,2015-03-13,DETROIT_PISTONS,PORTLAND_TRAIL_BLAZERS,99,118,3607,19
3607,2015-03-14,2015-03-13,BOSTON_CELTICS,INDIANA_PACERS,93,89,3608,4
3608,2015-03-14,2015-03-13,SACRAMENTO_KINGS,WASHINGTON_WIZARDS,97,113,3609,16
3609,2015-03-14,2015-03-13,BROOKLYN_NETS,PHILADELPHIA_76ERS,94,87,3610,7
3610,2015-03-15,2015-03-14,MILWAUKEE_BUCKS,MEMPHIS_GRIZZLIES,83,96,3611,13
3611,2015-03-15,2015-03-14,DETROIT_PISTONS,UTAH_JAZZ,85,88,3612,3
3612,2015-03-15,2015-03-14,NEW_YORK_KNICKS,GOLDEN_STATE_WARRIORS,94,125,3613,31
3613,2015-03-15,2015-03-14,CHICAGO_BULLS,OKLAHOMA_CITY_THUNDER,100,109,3614,9
3614,2015-03-15,2015-03-14,HOUSTON_ROCKETS,LOS_ANGELES_CLIPPERS,100,98,3615,2
3615,2015-03-15,2015-03-14,DENVER_NUGGETS,NEW_ORLEANS_PELICANS,118,111,3616,7
3616,2015-03-15,2015-03-14,CLEVELAND_CAVALIERS,ORLANDO_MAGIC,123,108,3617,15
3617,2015-03-15,2015-03-14,MINNESOTA_TIMBERWOLVES,SAN_ANTONIO_SPURS,97,123,3618,26
3618,2015-03-15,2015-03-14,PORTLAND_TRAIL_BLAZERS,TORONTO_RAPTORS,113,97,3619,16
3619,2015-03-16,2015-03-15,NEW_YORK_KNICKS,PHOENIX_SUNS,89,102,3620,13
3620,2015-03-16,2015-03-15,ATLANTA_HAWKS,LOS_ANGELES_LAKERS,91,86,3621,5
3621,2015-03-16,2015-03-15,TORONTO_RAPTORS,INDIANA_PACERS,117,98,3622,19
3622,2015-03-16,2015-03-15,PORTLAND_TRAIL_BLAZERS,WASHINGTON_WIZARDS,97,105,3623,8
3623,2015-03-16,2015-03-15,PHILADELPHIA_76ERS,BOSTON_CELTICS,89,108,3624,19
3624,2015-03-17,2015-03-16,DENVER_NUGGETS,MEMPHIS_GRIZZLIES,81,92,3625,11
3625,2015-03-17,2015-03-16,CLEVELAND_CAVALIERS,MIAMI_HEAT,92,106,3626,14
3626,2015-03-17,2015-03-16,BROOKLYN_NETS,MINNESOTA_TIMBERWOLVES,122,106,3627,16
3627,2015-03-17,2015-03-16,OKLAHOMA_CITY_THUNDER,DALLAS_MAVERICKS,115,119,3628,4
3628,2015-03-17,2015-03-16,CHARLOTTE_HORNETS,UTAH_JAZZ,66,94,3629,28
3629,2015-03-17,2015-03-16,ATLANTA_HAWKS,SACRAMENTO_KINGS,110,103,3630,7
3630,2015-03-17,2015-03-16,LOS_ANGELES_LAKERS,GOLDEN_STATE_WARRIORS,105,108,3631,3
3631,2015-03-17,2015-03-16,MEMPHIS_GRIZZLIES,DETROIT_PISTONS,95,105,3632,10
3632,2015-03-17,2015-03-16,SAN_ANTONIO_SPURS,NEW_YORK_KNICKS,100,104,3633,4
3633,2015-03-18,2015-03-17,ORLANDO_MAGIC,HOUSTON_ROCKETS,94,107,3634,13
3634,2015-03-18,2015-03-17,MILWAUKEE_BUCKS,NEW_ORLEANS_PELICANS,84,85,3635,1
3635,2015-03-18,2015-03-17,CHARLOTTE_HORNETS,LOS_ANGELES_CLIPPERS,92,99,3636,7
3636,2015-03-18,2015-03-17,BROOKLYN_NETS,CLEVELAND_CAVALIERS,92,117,3637,25
3637,2015-03-18,2015-03-17,DETROIT_PISTONS,PHILADELPHIA_76ERS,83,94,3638,11
3638,2015-03-18,2015-03-17,PORTLAND_TRAIL_BLAZERS,MIAMI_HEAT,104,108,3639,4
3639,2015-03-18,2015-03-17,MINNESOTA_TIMBERWOLVES,TORONTO_RAPTORS,100,105,3640,5
3640,2015-03-19,2015-03-18,INDIANA_PACERS,CHICAGO_BULLS,86,103,3641,17
3641,2015-03-19,2015-03-18,ORLANDO_MAGIC,DALLAS_MAVERICKS,102,107,3642,5
3642,2015-03-19,2015-03-18,SAN_ANTONIO_SPURS,MILWAUKEE_BUCKS,114,103,3643,11
3643,2015-03-19,2015-03-18,BOSTON_CELTICS,OKLAHOMA_CITY_THUNDER,118,122,3644,4
3644,2015-03-19,2015-03-18,LOS_ANGELES_CLIPPERS,SACRAMENTO_KINGS,116,105,3645,11
3645,2015-03-19,2015-03-18,ATLANTA_HAWKS,GOLDEN_STATE_WARRIORS,95,114,3646,19
3646,2015-03-19,2015-03-18,WASHINGTON_WIZARDS,UTAH_JAZZ,88,84,3647,4
3647,2015-03-19,2015-03-18,MINNESOTA_TIMBERWOLVES,NEW_YORK_KNICKS,95,92,3648,3
3648,2015-03-20,2015-03-19,DENVER_NUGGETS,HOUSTON_ROCKETS,108,118,3649,10
3649,2015-03-20,2015-03-19,NEW_ORLEANS_PELICANS,PHOENIX_SUNS,72,74,3650,2
3650,2015-03-20,2015-03-19,UTAH_JAZZ,LOS_ANGELES_LAKERS,80,73,3651,7
3651,2015-03-20,2015-03-19,PORTLAND_TRAIL_BLAZERS,ORLANDO_MAGIC,104,111,3652,7
3652,2015-03-20,2015-03-19,NEW_YORK_KNICKS,PHILADELPHIA_76ERS,81,97,3653,16
3653,2015-03-20,2015-03-19,MILWAUKEE_BUCKS,BROOKLYN_NETS,127,129,3654,2
3654,2015-03-20,2015-03-19,INDIANA_PACERS,CLEVELAND_CAVALIERS,92,95,3655,3
3655,2015-03-20,2015-03-19,DENVER_NUGGETS,MIAMI_HEAT,91,108,3656,17
3656,2015-03-21,2015-03-20,TORONTO_RAPTORS,CHICAGO_BULLS,92,108,3657,16
3657,2015-03-21,2015-03-20,ATLANTA_HAWKS,OKLAHOMA_CITY_THUNDER,115,123,3658,8
3658,2015-03-21,2015-03-20,MEMPHIS_GRIZZLIES,DALLAS_MAVERICKS,112,101,3659,11
3659,2015-03-21,2015-03-20,BOSTON_CELTICS,SAN_ANTONIO_SPURS,89,101,3660,12
3660,2015-03-21,2015-03-20,CHARLOTTE_HORNETS,SACRAMENTO_KINGS,91,101,3661,10
3661,2015-03-21,2015-03-20,NEW_ORLEANS_PELICANS,GOLDEN_STATE_WARRIORS,96,112,3662,16
3662,2015-03-21,2015-03-20,WASHINGTON_WIZARDS,LOS_ANGELES_CLIPPERS,99,113,3663,14
3663,2015-03-21,2015-03-20,BROOKLYN_NETS,INDIANA_PACERS,123,111,3664,12
3664,2015-03-21,2015-03-20,CHICAGO_BULLS,DETROIT_PISTONS,91,107,3665,16
3665,2015-03-22,2015-03-21,PHOENIX_SUNS,HOUSTON_ROCKETS,117,102,3666,15
3666,2015-03-22,2015-03-21,PORTLAND_TRAIL_BLAZERS,MEMPHIS_GRIZZLIES,86,97,3667,11
3667,2015-03-22,2015-03-21,UTAH_JAZZ,GOLDEN_STATE_WARRIORS,91,106,3668,15
3668,2015-03-22,2015-03-21,SAN_ANTONIO_SPURS,ATLANTA_HAWKS,114,95,3669,19
3669,2015-03-22,2015-03-21,CLEVELAND_CAVALIERS,MILWAUKEE_BUCKS,108,90,3670,18
3670,2015-03-22,2015-03-21,MIAMI_HEAT,OKLAHOMA_CITY_THUNDER,75,93,3671,18
3671,2015-03-22,2015-03-21,NEW_ORLEANS_PELICANS,LOS_ANGELES_CLIPPERS,100,107,3672,7
3672,2015-03-22,2015-03-21,NEW_YORK_KNICKS,TORONTO_RAPTORS,89,106,3673,17
3673,2015-03-22,2015-03-21,DETROIT_PISTONS,BOSTON_CELTICS,105,97,3674,8
3674,2015-03-22,2015-03-21,DENVER_NUGGETS,ORLANDO_MAGIC,119,100,3675,19
3675,2015-03-22,2015-03-21,WASHINGTON_WIZARDS,SACRAMENTO_KINGS,86,109,3676,23
3676,2015-03-22,2015-03-21,CHARLOTTE_HORNETS,MINNESOTA_TIMBERWOLVES,109,98,3677,11
3677,2015-03-23,2015-03-22,DALLAS_MAVERICKS,PHOENIX_SUNS,92,98,3678,6
3678,2015-03-23,2015-03-22,PHILADELPHIA_76ERS,LOS_ANGELES_LAKERS,87,101,3679,14
3679,2015-03-23,2015-03-22,HOUSTON_ROCKETS,INDIANA_PACERS,110,100,3680,10
3680,2015-03-23,2015-03-22,BOSTON_CELTICS,BROOKLYN_NETS,110,91,3681,19
3681,2015-03-23,2015-03-22,MEMPHIS_GRIZZLIES,NEW_YORK_KNICKS,103,82,3682,21
3682,2015-03-24,2015-03-23,CHARLOTTE_HORNETS,CHICAGO_BULLS,86,98,3683,12
3683,2015-03-24,2015-03-23,MINNESOTA_TIMBERWOLVES,UTAH_JAZZ,106,104,3684,2
3684,2015-03-24,2015-03-23,WASHINGTON_WIZARDS,GOLDEN_STATE_WARRIORS,76,107,3685,31
3685,2015-03-24,2015-03-23,TORONTO_RAPTORS,DETROIT_PISTONS,104,108,3686,4
3686,2015-03-25,2015-03-24,SAN_ANTONIO_SPURS,DALLAS_MAVERICKS,94,101,3687,7
3687,2015-03-25,2015-03-24,MIAMI_HEAT,MILWAUKEE_BUCKS,88,89,3688,1
3688,2015-03-25,2015-03-24,LOS_ANGELES_LAKERS,OKLAHOMA_CITY_THUNDER,117,127,3689,10
3689,2015-03-25,2015-03-24,PHILADELPHIA_76ERS,SACRAMENTO_KINGS,106,107,3690,1
3690,2015-03-25,2015-03-24,GOLDEN_STATE_WARRIORS,PORTLAND_TRAIL_BLAZERS,122,108,3691,14
3691,2015-03-25,2015-03-24,BROOKLYN_NETS,CHARLOTTE_HORNETS,91,88,3692,3
3692,2015-03-25,2015-03-24,LOS_ANGELES_CLIPPERS,NEW_YORK_KNICKS,111,80,3693,31
3693,2015-03-25,2015-03-24,ATLANTA_HAWKS,ORLANDO_MAGIC,95,83,3694,12
3694,2015-03-25,2015-03-24,CHICAGO_BULLS,TORONTO_RAPTORS,116,103,3695,13
3695,2015-03-25,2015-03-24,INDIANA_PACERS,WASHINGTON_WIZARDS,103,101,3696,2
3696,2015-03-25,2015-03-24,MIAMI_HEAT,BOSTON_CELTICS,93,86,3697,7
3697,2015-03-26,2015-03-25,CLEVELAND_CAVALIERS,MEMPHIS_GRIZZLIES,111,89,3698,22
3698,2015-03-26,2015-03-25,LOS_ANGELES_LAKERS,MINNESOTA_TIMBERWOLVES,101,99,3699,2
3699,2015-03-26,2015-03-25,HOUSTON_ROCKETS,NEW_ORLEANS_PELICANS,95,93,3700,2
3700,2015-03-26,2015-03-25,PHILADELPHIA_76ERS,DENVER_NUGGETS,99,85,3701,14
3701,2015-03-26,2015-03-25,PORTLAND_TRAIL_BLAZERS,UTAH_JAZZ,92,89,3702,3
3702,2015-03-26,2015-03-25,OKLAHOMA_CITY_THUNDER,SAN_ANTONIO_SPURS,91,130,3703,39
3703,2015-03-26,2015-03-25,SACRAMENTO_KINGS,PHOENIX_SUNS,108,99,3704,9
3704,2015-03-27,2015-03-26,INDIANA_PACERS,MILWAUKEE_BUCKS,107,111,3705,4
3705,2015-03-27,2015-03-26,DETROIT_PISTONS,ORLANDO_MAGIC,111,97,3706,14
3706,2015-03-27,2015-03-26,LOS_ANGELES_CLIPPERS,PHILADELPHIA_76ERS,119,98,3707,21
3707,2015-03-27,2015-03-26,CHARLOTTE_HORNETS,WASHINGTON_WIZARDS,107,110,3708,3
3708,2015-03-27,2015-03-26,MIAMI_HEAT,ATLANTA_HAWKS,86,99,3709,13
3709,2015-03-27,2015-03-26,CLEVELAND_CAVALIERS,BROOKLYN_NETS,98,106,3710,8
3710,2015-03-27,2015-03-26,BOSTON_CELTICS,NEW_YORK_KNICKS,96,92,3711,4
3711,2015-03-27,2015-03-26,LOS_ANGELES_LAKERS,TORONTO_RAPTORS,83,94,3712,11
3712,2015-03-28,2015-03-27,MINNESOTA_TIMBERWOLVES,HOUSTON_ROCKETS,110,120,3713,10
3713,2015-03-28,2015-03-27,GOLDEN_STATE_WARRIORS,MEMPHIS_GRIZZLIES,107,84,3714,23
3714,2015-03-28,2015-03-27,SACRAMENTO_KINGS,NEW_ORLEANS_PELICANS,88,102,3715,14
3715,2015-03-28,2015-03-27,DALLAS_MAVERICKS,SAN_ANTONIO_SPURS,76,94,3716,18
3716,2015-03-28,2015-03-27,UTAH_JAZZ,DENVER_NUGGETS,91,107,3717,16
3717,2015-03-28,2015-03-27,PORTLAND_TRAIL_BLAZERS,PHOENIX_SUNS,87,81,3718,6
3718,2015-03-28,2015-03-27,ATLANTA_HAWKS,CHARLOTTE_HORNETS,100,115,3719,15
3719,2015-03-29,2015-03-28,NEW_YORK_KNICKS,CHICAGO_BULLS,80,111,3720,31
3720,2015-03-29,2015-03-28,GOLDEN_STATE_WARRIORS,MILWAUKEE_BUCKS,108,95,3721,13
3721,2015-03-29,2015-03-28,OKLAHOMA_CITY_THUNDER,UTAH_JAZZ,89,94,3722,5
3722,2015-03-29,2015-03-28,DENVER_NUGGETS,PORTLAND_TRAIL_BLAZERS,114,120,3723,6
3723,2015-03-29,2015-03-28,HOUSTON_ROCKETS,WASHINGTON_WIZARDS,99,91,3724,8
3724,2015-03-29,2015-03-28,LOS_ANGELES_LAKERS,BROOKLYN_NETS,99,107,3725,8
3725,2015-03-29,2015-03-28,MINNESOTA_TIMBERWOLVES,NEW_ORLEANS_PELICANS,88,110,3726,22
3726,2015-03-29,2015-03-28,PHILADELPHIA_76ERS,CLEVELAND_CAVALIERS,86,87,3727,1
3727,2015-03-29,2015-03-28,LOS_ANGELES_CLIPPERS,BOSTON_CELTICS,119,106,3728,13
3728,2015-03-29,2015-03-28,DETROIT_PISTONS,MIAMI_HEAT,102,109,3729,7
3729,2015-03-29,2015-03-28,DALLAS_MAVERICKS,INDIANA_PACERS,99,104,3730,5
3730,2015-03-29,2015-03-28,MEMPHIS_GRIZZLIES,SAN_ANTONIO_SPURS,89,103,3731,14
3731,2015-03-30,2015-03-29,OKLAHOMA_CITY_THUNDER,PHOENIX_SUNS,109,97,3732,12
3732,2015-03-30,2015-03-29,BOSTON_CELTICS,CHARLOTTE_HORNETS,116,104,3733,12
3733,2015-03-30,2015-03-29,LOS_ANGELES_LAKERS,PHILADELPHIA_76ERS,113,111,3734,2
3734,2015-03-30,2015-03-29,MILWAUKEE_BUCKS,ATLANTA_HAWKS,88,101,3735,13
3735,2015-03-30,2015-03-29,HOUSTON_ROCKETS,TORONTO_RAPTORS,96,99,3736,3
3736,2015-03-31,2015-03-30,SACRAMENTO_KINGS,MEMPHIS_GRIZZLIES,83,97,3737,14
3737,2015-03-31,2015-03-30,UTAH_JAZZ,MINNESOTA_TIMBERWOLVES,104,84,3738,20
3738,2015-03-31,2015-03-30,PHOENIX_SUNS,PORTLAND_TRAIL_BLAZERS,86,109,3739,23
3739,2015-03-31,2015-03-30,INDIANA_PACERS,BROOKLYN_NETS,106,111,3740,5
3740,2015-03-31,2015-03-30,ATLANTA_HAWKS,DETROIT_PISTONS,95,105,3741,10
3741,2015-04-01,2015-03-31,SAN_ANTONIO_SPURS,MIAMI_HEAT,95,81,3742,14
3742,2015-04-01,2015-03-31,GOLDEN_STATE_WARRIORS,LOS_ANGELES_CLIPPERS,110,106,3743,4
3743,2015-04-01,2015-03-31,DETROIT_PISTONS,CHARLOTTE_HORNETS,78,102,3744,24
3744,2015-04-01,2015-03-31,SAN_ANTONIO_SPURS,ORLANDO_MAGIC,103,91,3745,12
3745,2015-04-01,2015-03-31,PHILADELPHIA_76ERS,WASHINGTON_WIZARDS,93,106,3746,13
3746,2015-04-01,2015-03-31,INDIANA_PACERS,BOSTON_CELTICS,87,100,3747,13
3747,2015-04-01,2015-03-31,BROOKLYN_NETS,NEW_YORK_KNICKS,100,98,3748,2
3748,2015-04-02,2015-04-01,SACRAMENTO_KINGS,HOUSTON_ROCKETS,111,115,3749,4
3749,2015-04-02,2015-04-01,CHICAGO_BULLS,MILWAUKEE_BUCKS,91,95,3750,4
3750,2015-04-02,2015-04-01,TORONTO_RAPTORS,MINNESOTA_TIMBERWOLVES,113,99,3751,14
3751,2015-04-02,2015-04-01,DALLAS_MAVERICKS,OKLAHOMA_CITY_THUNDER,135,131,3752,4
3752,2015-04-02,2015-04-01,DENVER_NUGGETS,UTAH_JAZZ,84,98,3753,14
3753,2015-04-02,2015-04-01,LOS_ANGELES_CLIPPERS,PORTLAND_TRAIL_BLAZERS,126,122,3754,4
3754,2015-04-02,2015-04-01,NEW_ORLEANS_PELICANS,LOS_ANGELES_LAKERS,113,92,3755,21
3755,2015-04-03,2015-04-02,MIAMI_HEAT,CLEVELAND_CAVALIERS,88,114,3756,26
3756,2015-04-03,2015-04-02,HOUSTON_ROCKETS,DALLAS_MAVERICKS,108,101,3757,7
3757,2015-04-03,2015-04-02,PHOENIX_SUNS,GOLDEN_STATE_WARRIORS,106,107,3758,1
3758,2015-04-03,2015-04-02,CHARLOTTE_HORNETS,INDIANA_PACERS,74,93,3759,19
3759,2015-04-03,2015-04-02,NEW_YORK_KNICKS,WASHINGTON_WIZARDS,87,101,3760,14
3760,2015-04-03,2015-04-02,MILWAUKEE_BUCKS,BOSTON_CELTICS,110,101,3761,9
3761,2015-04-03,2015-04-02,TORONTO_RAPTORS,BROOKLYN_NETS,109,114,3762,5
3762,2015-04-04,2015-04-03,DETROIT_PISTONS,CHICAGO_BULLS,82,88,3763,6
3763,2015-04-04,2015-04-03,OKLAHOMA_CITY_THUNDER,MEMPHIS_GRIZZLIES,92,100,3764,8
3764,2015-04-04,2015-04-03,ORLANDO_MAGIC,MINNESOTA_TIMBERWOLVES,97,84,3765,13
3765,2015-04-04,2015-04-03,DENVER_NUGGETS,SAN_ANTONIO_SPURS,93,123,3766,30
3766,2015-04-04,2015-04-03,NEW_ORLEANS_PELICANS,SACRAMENTO_KINGS,101,95,3767,6
3767,2015-04-04,2015-04-03,PORTLAND_TRAIL_BLAZERS,LOS_ANGELES_LAKERS,107,77,3768,30
3768,2015-04-04,2015-04-03,PHILADELPHIA_76ERS,CHARLOTTE_HORNETS,91,92,3769,1
3769,2015-04-04,2015-04-03,BROOKLYN_NETS,ATLANTA_HAWKS,99,131,3770,32
3770,2015-04-04,2015-04-03,MIAMI_HEAT,DETROIT_PISTONS,98,99,3771,1
3771,2015-04-04,2015-04-03,BOSTON_CELTICS,TORONTO_RAPTORS,117,116,3772,1
3772,2015-04-05,2015-04-04,WASHINGTON_WIZARDS,MEMPHIS_GRIZZLIES,92,83,3773,9
3773,2015-04-05,2015-04-04,GOLDEN_STATE_WARRIORS,DALLAS_MAVERICKS,123,110,3774,13
3774,2015-04-05,2015-04-04,ORLANDO_MAGIC,MILWAUKEE_BUCKS,97,90,3775,7
3775,2015-04-05,2015-04-04,LOS_ANGELES_CLIPPERS,DENVER_NUGGETS,107,92,3776,15
3776,2015-04-05,2015-04-04,UTAH_JAZZ,PHOENIX_SUNS,85,87,3777,2
3777,2015-04-05,2015-04-04,NEW_ORLEANS_PELICANS,PORTLAND_TRAIL_BLAZERS,90,99,3778,9
3778,2015-04-05,2015-04-04,HOUSTON_ROCKETS,OKLAHOMA_CITY_THUNDER,115,112,3779,3
3779,2015-04-05,2015-04-04,CHICAGO_BULLS,CLEVELAND_CAVALIERS,94,99,3780,5
3780,2015-04-05,2015-04-04,MIAMI_HEAT,INDIANA_PACERS,89,112,3781,23
3781,2015-04-05,2015-04-04,GOLDEN_STATE_WARRIORS,SAN_ANTONIO_SPURS,92,107,3782,15
3782,2015-04-05,2015-04-04,PHILADELPHIA_76ERS,NEW_YORK_KNICKS,91,101,3783,10
3783,2015-04-06,2015-04-05,UTAH_JAZZ,SACRAMENTO_KINGS,101,95,3784,6
3784,2015-04-06,2015-04-05,LOS_ANGELES_CLIPPERS,LOS_ANGELES_LAKERS,106,78,3785,28
3785,2015-04-06,2015-04-05,PORTLAND_TRAIL_BLAZERS,BROOKLYN_NETS,96,106,3786,10
3786,2015-04-07,2015-04-06,PHOENIX_SUNS,ATLANTA_HAWKS,69,96,3787,27
3787,2015-04-07,2015-04-06,CHARLOTTE_HORNETS,MIAMI_HEAT,100,105,3788,5
3788,2015-04-08,2015-04-07,GOLDEN_STATE_WARRIORS,NEW_ORLEANS_PELICANS,100,103,3789,3
3789,2015-04-08,2015-04-07,SAN_ANTONIO_SPURS,OKLAHOMA_CITY_THUNDER,113,88,3790,25
3790,2015-04-08,2015-04-07,MINNESOTA_TIMBERWOLVES,SACRAMENTO_KINGS,111,116,3791,5
3791,2015-04-08,2015-04-07,LOS_ANGELES_LAKERS,LOS_ANGELES_CLIPPERS,100,105,3792,5
3792,2015-04-08,2015-04-07,TORONTO_RAPTORS,CHARLOTTE_HORNETS,92,74,3793,18
3793,2015-04-08,2015-04-07,BOSTON_CELTICS,DETROIT_PISTONS,113,103,3794,10
3794,2015-04-08,2015-04-07,CHICAGO_BULLS,ORLANDO_MAGIC,103,105,3795,2
3795,2015-04-08,2015-04-07,WASHINGTON_WIZARDS,PHILADELPHIA_76ERS,119,90,3796,29
3796,2015-04-08,2015-04-07,ATLANTA_HAWKS,BROOKLYN_NETS,114,111,3797,3
3797,2015-04-08,2015-04-07,INDIANA_PACERS,NEW_YORK_KNICKS,102,86,3798,16
3798,2015-04-09,2015-04-08,NEW_ORLEANS_PELICANS,MEMPHIS_GRIZZLIES,74,110,3799,36
3799,2015-04-09,2015-04-08,CLEVELAND_CAVALIERS,MILWAUKEE_BUCKS,104,99,3800,5
3800,2015-04-09,2015-04-08,HOUSTON_ROCKETS,SAN_ANTONIO_SPURS,98,110,3801,12
3801,2015-04-09,2015-04-08,LOS_ANGELES_LAKERS,DENVER_NUGGETS,101,119,3802,18
3802,2015-04-09,2015-04-08,SACRAMENTO_KINGS,UTAH_JAZZ,91,103,3803,12
3803,2015-04-09,2015-04-08,PHOENIX_SUNS,DALLAS_MAVERICKS,104,107,3804,3
3804,2015-04-09,2015-04-08,MINNESOTA_TIMBERWOLVES,PORTLAND_TRAIL_BLAZERS,91,116,3805,25
3805,2015-04-10,2015-04-09,CHICAGO_BULLS,MIAMI_HEAT,89,78,3806,11
3806,2015-04-10,2015-04-09,PORTLAND_TRAIL_BLAZERS,GOLDEN_STATE_WARRIORS,105,116,3807,11
3807,2015-04-10,2015-04-09,TORONTO_RAPTORS,ORLANDO_MAGIC,101,99,3808,2
3808,2015-04-10,2015-04-09,CHARLOTTE_HORNETS,ATLANTA_HAWKS,80,104,3809,24
3809,2015-04-10,2015-04-09,WASHINGTON_WIZARDS,BROOKLYN_NETS,80,117,3810,37
3810,2015-04-10,2015-04-09,BOSTON_CELTICS,CLEVELAND_CAVALIERS,99,90,3811,9
3811,2015-04-10,2015-04-09,INDIANA_PACERS,DETROIT_PISTONS,107,103,3812,4
3812,2015-04-10,2015-04-09,MILWAUKEE_BUCKS,NEW_YORK_KNICKS,99,91,3813,8
3813,2015-04-11,2015-04-10,SAN_ANTONIO_SPURS,HOUSTON_ROCKETS,104,103,3814,1
3814,2015-04-11,2015-04-10,PHOENIX_SUNS,NEW_ORLEANS_PELICANS,75,90,3815,15
3815,2015-04-11,2015-04-10,SACRAMENTO_KINGS,OKLAHOMA_CITY_THUNDER,103,116,3816,13
3816,2015-04-11,2015-04-10,DALLAS_MAVERICKS,DENVER_NUGGETS,144,143,3817,1
3817,2015-04-11,2015-04-10,MEMPHIS_GRIZZLIES,UTAH_JAZZ,89,88,3818,1
3818,2015-04-11,2015-04-10,MINNESOTA_TIMBERWOLVES,LOS_ANGELES_LAKERS,98,106,3819,8
3819,2015-04-11,2015-04-10,NEW_YORK_KNICKS,ORLANDO_MAGIC,80,79,3820,1
3820,2015-04-11,2015-04-10,TORONTO_RAPTORS,MIAMI_HEAT,107,104,3821,3
3821,2015-04-12,2015-04-11,PHILADELPHIA_76ERS,CHICAGO_BULLS,107,114,3822,7
3822,2015-04-12,2015-04-11,MEMPHIS_GRIZZLIES,LOS_ANGELES_CLIPPERS,86,94,3823,8
3823,2015-04-12,2015-04-11,UTAH_JAZZ,PORTLAND_TRAIL_BLAZERS,111,105,3824,6
3824,2015-04-12,2015-04-11,MINNESOTA_TIMBERWOLVES,GOLDEN_STATE_WARRIORS,101,110,3825,9
3825,2015-04-12,2015-04-11,CLEVELAND_CAVALIERS,BOSTON_CELTICS,78,117,3826,39
3826,2015-04-12,2015-04-11,BROOKLYN_NETS,MILWAUKEE_BUCKS,73,96,3827,23
3827,2015-04-12,2015-04-11,CHARLOTTE_HORNETS,DETROIT_PISTONS,77,116,3828,39
3828,2015-04-12,2015-04-11,SACRAMENTO_KINGS,DENVER_NUGGETS,111,122,3829,11
3829,2015-04-12,2015-04-11,OKLAHOMA_CITY_THUNDER,INDIANA_PACERS,104,116,3830,12
3830,2015-04-12,2015-04-11,ATLANTA_HAWKS,WASHINGTON_WIZARDS,99,108,3831,9
3831,2015-04-12,2015-04-11,NEW_ORLEANS_PELICANS,HOUSTON_ROCKETS,114,121,3832,7
3832,2015-04-12,2015-04-11,PHOENIX_SUNS,SAN_ANTONIO_SPURS,91,107,3833,16
3833,2015-04-13,2015-04-12,DALLAS_MAVERICKS,LOS_ANGELES_LAKERS,120,106,3834,14
3834,2015-04-13,2015-04-12,HOUSTON_ROCKETS,CHARLOTTE_HORNETS,100,90,3835,10
3835,2015-04-13,2015-04-12,DETROIT_PISTONS,CLEVELAND_CAVALIERS,97,109,3836,12
3836,2015-04-13,2015-04-12,MILWAUKEE_BUCKS,PHILADELPHIA_76ERS,107,97,3837,10
3837,2015-04-13,2015-04-12,NEW_YORK_KNICKS,ATLANTA_HAWKS,112,108,3838,4
3838,2015-04-13,2015-04-12,CHICAGO_BULLS,BROOKLYN_NETS,113,86,3839,27
3839,2015-04-13,2015-04-12,ORLANDO_MAGIC,MIAMI_HEAT,93,100,3840,7
3840,2015-04-14,2015-04-13,NEW_ORLEANS_PELICANS,MINNESOTA_TIMBERWOLVES,100,88,3841,12
3841,2015-04-14,2015-04-13,PORTLAND_TRAIL_BLAZERS,OKLAHOMA_CITY_THUNDER,90,101,3842,11
3842,2015-04-14,2015-04-13,DALLAS_MAVERICKS,UTAH_JAZZ,92,109,3843,17
3843,2015-04-14,2015-04-13,LOS_ANGELES_LAKERS,SACRAMENTO_KINGS,92,102,3844,10
3844,2015-04-14,2015-04-13,MEMPHIS_GRIZZLIES,GOLDEN_STATE_WARRIORS,107,111,3845,4
3845,2015-04-14,2015-04-13,DENVER_NUGGETS,LOS_ANGELES_CLIPPERS,103,110,3846,7
3846,2015-04-14,2015-04-13,TORONTO_RAPTORS,BOSTON_CELTICS,93,95,3847,2
3847,2015-04-15,2015-04-14,WASHINGTON_WIZARDS,INDIANA_PACERS,95,99,3848,4
3848,2015-04-15,2015-04-14,LOS_ANGELES_CLIPPERS,PHOENIX_SUNS,112,101,3849,11
3849,2015-04-15,2015-04-14,CHARLOTTE_HORNETS,TORONTO_RAPTORS,87,92,3850,5
3850,2015-04-16,2015-04-15,ORLANDO_MAGIC,BROOKLYN_NETS,88,101,3851,13
3851,2015-04-16,2015-04-15,ATLANTA_HAWKS,CHICAGO_BULLS,85,91,3852,6
3852,2015-04-16,2015-04-15,WASHINGTON_WIZARDS,CLEVELAND_CAVALIERS,108,113,3853,5
3853,2015-04-16,2015-04-15,PORTLAND_TRAIL_BLAZERS,DALLAS_MAVERICKS,98,114,3854,16
3854,2015-04-16,2015-04-15,UTAH_JAZZ,HOUSTON_ROCKETS,91,117,3855,26
3855,2015-04-16,2015-04-15,BOSTON_CELTICS,MILWAUKEE_BUCKS,105,100,3856,5
3856,2015-04-16,2015-04-15,OKLAHOMA_CITY_THUNDER,MINNESOTA_TIMBERWOLVES,138,113,3857,25
3857,2015-04-16,2015-04-15,SAN_ANTONIO_SPURS,NEW_ORLEANS_PELICANS,103,108,3858,5
3858,2015-04-16,2015-04-15,DETROIT_PISTONS,NEW_YORK_KNICKS,112,90,3859,22
3859,2015-04-16,2015-04-15,MIAMI_HEAT,PHILADELPHIA_76ERS,105,101,3860,4
3860,2015-04-16,2015-04-15,INDIANA_PACERS,MEMPHIS_GRIZZLIES,83,95,3861,12
3861,2015-04-16,2015-04-15,DENVER_NUGGETS,GOLDEN_STATE_WARRIORS,126,133,3862,7
3862,2015-04-16,2015-04-15,SACRAMENTO_KINGS,LOS_ANGELES_LAKERS,122,99,3863,23
3863,2015-04-18,2015-04-17,WASHINGTON_WIZARDS,TORONTO_RAPTORS,93,86,3864,7
3864,2015-04-18,2015-04-17,NEW_ORLEANS_PELICANS,GOLDEN_STATE_WARRIORS,99,106,3865,7
3865,2015-04-18,2015-04-17,MILWAUKEE_BUCKS,CHICAGO_BULLS,91,103,3866,12
3866,2015-04-19,2015-04-18,DALLAS_MAVERICKS,HOUSTON_ROCKETS,108,118,3867,10
3867,2015-04-19,2015-04-18,BOSTON_CELTICS,CLEVELAND_CAVALIERS,100,113,3868,13
3868,2015-04-19,2015-04-18,BROOKLYN_NETS,ATLANTA_HAWKS,92,99,3869,7
3869,2015-04-20,2015-04-19,PORTLAND_TRAIL_BLAZERS,MEMPHIS_GRIZZLIES,86,100,3870,14
3870,2015-04-20,2015-04-19,SAN_ANTONIO_SPURS,LOS_ANGELES_CLIPPERS,92,107,3871,15
3871,2015-04-21,2015-04-20,MILWAUKEE_BUCKS,CHICAGO_BULLS,82,91,3872,9
3872,2015-04-21,2015-04-20,NEW_ORLEANS_PELICANS,GOLDEN_STATE_WARRIORS,87,97,3873,10
3873,2015-04-21,2015-04-20,BOSTON_CELTICS,CLEVELAND_CAVALIERS,91,99,3874,8
3874,2015-04-22,2015-04-21,WASHINGTON_WIZARDS,TORONTO_RAPTORS,117,106,3875,11
3875,2015-04-22,2015-04-21,DALLAS_MAVERICKS,HOUSTON_ROCKETS,99,111,3876,12
3876,2015-04-22,2015-04-21,BROOKLYN_NETS,ATLANTA_HAWKS,91,96,3877,5
3877,2015-04-23,2015-04-22,PORTLAND_TRAIL_BLAZERS,MEMPHIS_GRIZZLIES,82,97,3878,15
3878,2015-04-23,2015-04-22,SAN_ANTONIO_SPURS,LOS_ANGELES_CLIPPERS,111,107,3879,4
3879,2015-04-23,2015-04-22,CLEVELAND_CAVALIERS,BOSTON_CELTICS,103,95,3880,8
3880,2015-04-24,2015-04-23,CHICAGO_BULLS,MILWAUKEE_BUCKS,113,106,3881,7
3881,2015-04-24,2015-04-23,GOLDEN_STATE_WARRIORS,NEW_ORLEANS_PELICANS,123,119,3882,4
3882,2015-04-24,2015-04-23,HOUSTON_ROCKETS,DALLAS_MAVERICKS,130,128,3883,2
3883,2015-04-25,2015-04-24,TORONTO_RAPTORS,WASHINGTON_WIZARDS,99,106,3884,7
3884,2015-04-25,2015-04-24,LOS_ANGELES_CLIPPERS,SAN_ANTONIO_SPURS,73,100,3885,27
3885,2015-04-25,2015-04-24,ATLANTA_HAWKS,BROOKLYN_NETS,83,91,3886,8
3886,2015-04-25,2015-04-24,CHICAGO_BULLS,MILWAUKEE_BUCKS,90,92,3887,2
3887,2015-04-26,2015-04-25,GOLDEN_STATE_WARRIORS,NEW_ORLEANS_PELICANS,109,98,3888,11
3888,2015-04-26,2015-04-25,MEMPHIS_GRIZZLIES,PORTLAND_TRAIL_BLAZERS,115,109,3889,6
3889,2015-04-26,2015-04-25,CLEVELAND_CAVALIERS,BOSTON_CELTICS,101,93,3890,8
3890,2015-04-26,2015-04-25,LOS_ANGELES_CLIPPERS,SAN_ANTONIO_SPURS,114,105,3891,9
3891,2015-04-26,2015-04-25,TORONTO_RAPTORS,WASHINGTON_WIZARDS,94,125,3892,31
3892,2015-04-27,2015-04-26,HOUSTON_ROCKETS,DALLAS_MAVERICKS,109,121,3893,12
3893,2015-04-27,2015-04-26,ATLANTA_HAWKS,BROOKLYN_NETS,115,120,3894,5
3894,2015-04-28,2015-04-27,MILWAUKEE_BUCKS,CHICAGO_BULLS,94,88,3895,6
3895,2015-04-28,2015-04-27,MEMPHIS_GRIZZLIES,PORTLAND_TRAIL_BLAZERS,92,99,3896,7
3896,2015-04-29,2015-04-28,DALLAS_MAVERICKS,HOUSTON_ROCKETS,94,103,3897,9
3897,2015-04-29,2015-04-28,SAN_ANTONIO_SPURS,LOS_ANGELES_CLIPPERS,111,107,3898,4
3898,2015-04-29,2015-04-28,BROOKLYN_NETS,ATLANTA_HAWKS,97,107,3899,10
3899,2015-04-30,2015-04-29,PORTLAND_TRAIL_BLAZERS,MEMPHIS_GRIZZLIES,93,99,3900,6
3900,2015-04-30,2015-04-29,CHICAGO_BULLS,MILWAUKEE_BUCKS,120,66,3901,54
3901,2015-05-01,2015-04-30,LOS_ANGELES_CLIPPERS,SAN_ANTONIO_SPURS,102,96,3902,6
3902,2015-05-02,2015-05-01,ATLANTA_HAWKS,BROOKLYN_NETS,111,87,3903,24
3903,2015-05-03,2015-05-02,SAN_ANTONIO_SPURS,LOS_ANGELES_CLIPPERS,109,111,3904,2
3904,2015-05-03,2015-05-02,WASHINGTON_WIZARDS,ATLANTA_HAWKS,104,98,3905,6
3905,2015-05-03,2015-05-02,MEMPHIS_GRIZZLIES,GOLDEN_STATE_WARRIORS,86,101,3906,15
3906,2015-05-04,2015-05-03,CHICAGO_BULLS,CLEVELAND_CAVALIERS,99,92,3907,7
3907,2015-05-05,2015-05-04,LOS_ANGELES_CLIPPERS,HOUSTON_ROCKETS,117,101,3908,16
3908,2015-05-06,2015-05-05,WASHINGTON_WIZARDS,ATLANTA_HAWKS,90,106,3909,16
3909,2015-05-06,2015-05-05,MEMPHIS_GRIZZLIES,GOLDEN_STATE_WARRIORS,97,90,3910,7
3910,2015-05-06,2015-05-05,CHICAGO_BULLS,CLEVELAND_CAVALIERS,91,106,3911,15
3911,2015-05-07,2015-05-06,LOS_ANGELES_CLIPPERS,HOUSTON_ROCKETS,109,115,3912,6
3912,2015-05-09,2015-05-08,CLEVELAND_CAVALIERS,CHICAGO_BULLS,96,99,3913,3
3913,2015-05-09,2015-05-08,HOUSTON_ROCKETS,LOS_ANGELES_CLIPPERS,99,124,3914,25
3914,2015-05-09,2015-05-08,ATLANTA_HAWKS,WASHINGTON_WIZARDS,101,103,3915,2
3915,2015-05-10,2015-05-09,GOLDEN_STATE_WARRIORS,MEMPHIS_GRIZZLIES,89,99,3916,10
3916,2015-05-10,2015-05-09,CLEVELAND_CAVALIERS,CHICAGO_BULLS,86,84,3917,2
3917,2015-05-11,2015-05-10,HOUSTON_ROCKETS,LOS_ANGELES_CLIPPERS,95,128,3918,33
3918,2015-05-11,2015-05-10,ATLANTA_HAWKS,WASHINGTON_WIZARDS,106,101,3919,5
3919,2015-05-12,2015-05-11,GOLDEN_STATE_WARRIORS,MEMPHIS_GRIZZLIES,101,84,3920,17
3920,2015-05-12,2015-05-11,CHICAGO_BULLS,CLEVELAND_CAVALIERS,101,106,3921,5
3921,2015-05-13,2015-05-12,LOS_ANGELES_CLIPPERS,HOUSTON_ROCKETS,103,124,3922,21
3922,2015-05-14,2015-05-13,WASHINGTON_WIZARDS,ATLANTA_HAWKS,81,82,3923,1
3923,2015-05-14,2015-05-13,MEMPHIS_GRIZZLIES,GOLDEN_STATE_WARRIORS,78,98,3924,20
3924,2015-05-15,2015-05-14,CLEVELAND_CAVALIERS,CHICAGO_BULLS,94,73,3925,21
3925,2015-05-15,2015-05-14,HOUSTON_ROCKETS,LOS_ANGELES_CLIPPERS,119,107,3926,12
3926,2015-05-15,2015-05-14,ATLANTA_HAWKS,WASHINGTON_WIZARDS,94,91,3927,3
3927,2015-05-16,2015-05-15,GOLDEN_STATE_WARRIORS,MEMPHIS_GRIZZLIES,108,95,3928,13
3928,2015-05-17,2015-05-16,LOS_ANGELES_CLIPPERS,HOUSTON_ROCKETS,100,113,3929,13
3929,2015-05-20,2015-05-19,HOUSTON_ROCKETS,GOLDEN_STATE_WARRIORS,106,110,3930,4
3930,2015-05-21,2015-05-20,CLEVELAND_CAVALIERS,ATLANTA_HAWKS,97,89,3931,8
3931,2015-05-22,2015-05-21,HOUSTON_ROCKETS,GOLDEN_STATE_WARRIORS,98,99,3932,1
3932,2015-05-23,2015-05-22,CLEVELAND_CAVALIERS,ATLANTA_HAWKS,94,82,3933,12
3933,2015-05-24,2015-05-23,GOLDEN_STATE_WARRIORS,HOUSTON_ROCKETS,115,80,3934,35
3934,2015-05-25,2015-05-24,ATLANTA_HAWKS,CLEVELAND_CAVALIERS,111,114,3935,3
3935,2015-05-26,2015-05-25,GOLDEN_STATE_WARRIORS,HOUSTON_ROCKETS,115,128,3936,13
3936,2015-05-27,2015-05-26,ATLANTA_HAWKS,CLEVELAND_CAVALIERS,88,118,3937,30
3937,2015-05-28,2015-05-27,HOUSTON_ROCKETS,GOLDEN_STATE_WARRIORS,90,104,3938,14
3938,2015-06-05,2015-06-04,CLEVELAND_CAVALIERS,GOLDEN_STATE_WARRIORS,100,108,3939,8
3939,2015-06-08,2015-06-07,CLEVELAND_CAVALIERS,GOLDEN_STATE_WARRIORS,95,93,3940,2
3940,2015-06-10,2015-06-09,GOLDEN_STATE_WARRIORS,CLEVELAND_CAVALIERS,91,96,3941,5
3941,2015-06-12,2015-06-11,GOLDEN_STATE_WARRIORS,CLEVELAND_CAVALIERS,103,82,3942,21
3942,2015-06-15,2015-06-14,CLEVELAND_CAVALIERS,GOLDEN_STATE_WARRIORS,91,104,3943,13
3943,2015-06-17,2015-06-16,GOLDEN_STATE_WARRIORS,CLEVELAND_CAVALIERS,105,97,3944,8
3944,2015-10-28,2015-10-27,DETROIT_PISTONS,ATLANTA_HAWKS,106,94,3945,12
3945,2015-10-28,2015-10-27,CLEVELAND_CAVALIERS,CHICAGO_BULLS,95,97,3946,2
3946,2015-10-28,2015-10-27,NEW_ORLEANS_PELICANS,GOLDEN_STATE_WARRIORS,95,111,3947,16
3947,2015-10-28,2015-10-27,WASHINGTON_WIZARDS,ORLANDO_MAGIC,88,87,3948,1
3948,2015-10-28,2015-10-27,INDIANA_PACERS,TORONTO_RAPTORS,99,106,3949,7
3949,2015-10-28,2015-10-27,CHARLOTTE_HORNETS,MIAMI_HEAT,94,104,3950,10
3950,2015-10-28,2015-10-27,CHICAGO_BULLS,BROOKLYN_NETS,115,100,3951,15
3951,2015-10-28,2015-10-27,PHILADELPHIA_76ERS,BOSTON_CELTICS,95,112,3952,17
3952,2015-10-28,2015-10-27,UTAH_JAZZ,DETROIT_PISTONS,87,92,3953,5
3953,2015-10-29,2015-10-28,DENVER_NUGGETS,HOUSTON_ROCKETS,105,85,3954,20
3954,2015-10-29,2015-10-28,SAN_ANTONIO_SPURS,OKLAHOMA_CITY_THUNDER,106,112,3955,6
3955,2015-10-29,2015-10-28,NEW_YORK_KNICKS,MILWAUKEE_BUCKS,122,97,3956,25
3956,2015-10-29,2015-10-28,CLEVELAND_CAVALIERS,MEMPHIS_GRIZZLIES,106,76,3957,30
3957,2015-10-29,2015-10-28,DALLAS_MAVERICKS,PHOENIX_SUNS,111,95,3958,16
3958,2015-10-29,2015-10-28,NEW_ORLEANS_PELICANS,PORTLAND_TRAIL_BLAZERS,94,112,3959,18
3959,2015-10-29,2015-10-28,LOS_ANGELES_CLIPPERS,SACRAMENTO_KINGS,111,104,3960,7
3960,2015-10-29,2015-10-28,MINNESOTA_TIMBERWOLVES,LOS_ANGELES_LAKERS,112,111,3961,1
3961,2015-10-29,2015-10-28,MEMPHIS_GRIZZLIES,INDIANA_PACERS,112,103,3962,9
3962,2015-10-30,2015-10-29,ATLANTA_HAWKS,NEW_YORK_KNICKS,112,101,3963,11
3963,2015-10-30,2015-10-29,DALLAS_MAVERICKS,LOS_ANGELES_CLIPPERS,88,104,3964,16
3964,2015-10-30,2015-10-29,UTAH_JAZZ,PHILADELPHIA_76ERS,99,71,3965,28
3965,2015-10-30,2015-10-29,OKLAHOMA_CITY_THUNDER,ORLANDO_MAGIC,139,136,3966,3
3966,2015-10-30,2015-10-29,MIAMI_HEAT,CLEVELAND_CAVALIERS,92,102,3967,10
3967,2015-10-30,2015-10-29,CHICAGO_BULLS,DETROIT_PISTONS,94,98,3968,4
3968,2015-10-30,2015-10-29,TORONTO_RAPTORS,BOSTON_CELTICS,113,103,3969,10
3969,2015-10-31,2015-10-30,WASHINGTON_WIZARDS,MILWAUKEE_BUCKS,118,113,3970,5
3970,2015-10-31,2015-10-30,CHARLOTTE_HORNETS,ATLANTA_HAWKS,94,97,3971,3
3971,2015-10-31,2015-10-30,BROOKLYN_NETS,SAN_ANTONIO_SPURS,75,102,3972,27
3972,2015-10-31,2015-10-30,MINNESOTA_TIMBERWOLVES,DENVER_NUGGETS,95,78,3973,17
3973,2015-10-31,2015-10-30,GOLDEN_STATE_WARRIORS,HOUSTON_ROCKETS,112,92,3974,20
3974,2015-10-31,2015-10-30,LOS_ANGELES_LAKERS,SACRAMENTO_KINGS,114,132,3975,18
3975,2015-10-31,2015-10-30,PORTLAND_TRAIL_BLAZERS,PHOENIX_SUNS,92,110,3976,18
3976,2015-10-31,2015-10-30,UTAH_JAZZ,INDIANA_PACERS,97,76,3977,21
3977,2015-10-31,2015-10-30,NEW_YORK_KNICKS,WASHINGTON_WIZARDS,117,110,3978,7
3978,2015-10-31,2015-10-30,GOLDEN_STATE_WARRIORS,NEW_ORLEANS_PELICANS,134,120,3979,14
3979,2015-11-01,2015-10-31,BROOKLYN_NETS,MEMPHIS_GRIZZLIES,91,101,3980,10
3980,2015-11-01,2015-10-31,PHOENIX_SUNS,PORTLAND_TRAIL_BLAZERS,101,90,3981,11
3981,2015-11-01,2015-10-31,SACRAMENTO_KINGS,LOS_ANGELES_CLIPPERS,109,114,3982,5
3982,2015-11-01,2015-10-31,ATLANTA_HAWKS,CHARLOTTE_HORNETS,94,92,3983,2
3983,2015-11-01,2015-10-31,SAN_ANTONIO_SPURS,BOSTON_CELTICS,95,87,3984,8
3984,2015-11-01,2015-10-31,HOUSTON_ROCKETS,MIAMI_HEAT,89,109,3985,20
3985,2015-11-01,2015-10-31,MILWAUKEE_BUCKS,TORONTO_RAPTORS,87,106,3986,19
3986,2015-11-02,2015-11-01,ORLANDO_MAGIC,CHICAGO_BULLS,87,92,3987,5
3987,2015-11-02,2015-11-01,DENVER_NUGGETS,OKLAHOMA_CITY_THUNDER,93,117,3988,24
3988,2015-11-02,2015-11-01,DALLAS_MAVERICKS,LOS_ANGELES_LAKERS,103,93,3989,10
3989,2015-11-03,2015-11-02,CLEVELAND_CAVALIERS,PHILADELPHIA_76ERS,107,100,3990,7
3990,2015-11-03,2015-11-02,MILWAUKEE_BUCKS,BROOKLYN_NETS,103,96,3991,7
3991,2015-11-03,2015-11-02,SAN_ANTONIO_SPURS,NEW_YORK_KNICKS,94,84,3992,10
3992,2015-11-03,2015-11-02,OKLAHOMA_CITY_THUNDER,HOUSTON_ROCKETS,105,110,3993,5
3993,2015-11-03,2015-11-02,PORTLAND_TRAIL_BLAZERS,MINNESOTA_TIMBERWOLVES,106,101,3994,5
3994,2015-11-03,2015-11-02,MEMPHIS_GRIZZLIES,GOLDEN_STATE_WARRIORS,69,119,3995,50
3995,2015-11-03,2015-11-02,PHOENIX_SUNS,LOS_ANGELES_CLIPPERS,96,102,3996,6
3996,2015-11-04,2015-11-03,CHICAGO_BULLS,CHARLOTTE_HORNETS,105,130,3997,25
3997,2015-11-04,2015-11-03,INDIANA_PACERS,DETROIT_PISTONS,94,82,3998,12
3998,2015-11-04,2015-11-03,ATLANTA_HAWKS,MIAMI_HEAT,98,92,3999,6
3999,2015-11-04,2015-11-03,ORLANDO_MAGIC,NEW_ORLEANS_PELICANS,103,94,4000,9
4000,2015-11-04,2015-11-03,TORONTO_RAPTORS,DALLAS_MAVERICKS,102,91,4001,11
4001,2015-11-04,2015-11-03,MEMPHIS_GRIZZLIES,SACRAMENTO_KINGS,103,89,4002,14
4002,2015-11-04,2015-11-03,DENVER_NUGGETS,LOS_ANGELES_LAKERS,120,109,4003,11
4003,2015-11-05,2015-11-04,BOSTON_CELTICS,INDIANA_PACERS,98,100,4004,2
4004,2015-11-05,2015-11-04,SAN_ANTONIO_SPURS,WASHINGTON_WIZARDS,99,102,4005,3
4005,2015-11-05,2015-11-04,BROOKLYN_NETS,ATLANTA_HAWKS,87,101,4006,14
4006,2015-11-05,2015-11-04,NEW_YORK_KNICKS,CLEVELAND_CAVALIERS,86,96,4007,10
4007,2015-11-05,2015-11-04,ORLANDO_MAGIC,HOUSTON_ROCKETS,114,119,4008,5
4008,2015-11-05,2015-11-04,PHILADELPHIA_76ERS,MILWAUKEE_BUCKS,87,91,4009,4
4009,2015-11-05,2015-11-04,TORONTO_RAPTORS,OKLAHOMA_CITY_THUNDER,103,98,4010,5
4010,2015-11-05,2015-11-04,SACRAMENTO_KINGS,PHOENIX_SUNS,97,118,4011,21
4011,2015-11-05,2015-11-04,PORTLAND_TRAIL_BLAZERS,UTAH_JAZZ,108,92,4012,16
4012,2015-11-05,2015-11-04,LOS_ANGELES_CLIPPERS,GOLDEN_STATE_WARRIORS,108,112,4013,4
4013,2015-11-06,2015-11-05,OKLAHOMA_CITY_THUNDER,CHICAGO_BULLS,98,104,4014,6
4014,2015-11-06,2015-11-05,MIAMI_HEAT,MINNESOTA_TIMBERWOLVES,96,84,4015,12
4015,2015-11-06,2015-11-05,CHARLOTTE_HORNETS,DALLAS_MAVERICKS,108,94,4016,14
4016,2015-11-06,2015-11-05,UTAH_JAZZ,DENVER_NUGGETS,96,84,4017,12
4017,2015-11-06,2015-11-05,MEMPHIS_GRIZZLIES,PORTLAND_TRAIL_BLAZERS,96,115,4018,19
4018,2015-11-07,2015-11-06,TORONTO_RAPTORS,ORLANDO_MAGIC,87,92,4019,5
4019,2015-11-07,2015-11-06,WASHINGTON_WIZARDS,BOSTON_CELTICS,98,118,4020,20
4020,2015-11-07,2015-11-06,LOS_ANGELES_LAKERS,BROOKLYN_NETS,104,98,4021,6
4021,2015-11-07,2015-11-06,PHILADELPHIA_76ERS,CLEVELAND_CAVALIERS,102,108,4022,6
4022,2015-11-07,2015-11-06,MILWAUKEE_BUCKS,NEW_YORK_KNICKS,99,92,4023,7
4023,2015-11-07,2015-11-06,MIAMI_HEAT,INDIANA_PACERS,87,90,4024,3
4024,2015-11-07,2015-11-06,ATLANTA_HAWKS,NEW_ORLEANS_PELICANS,121,115,4025,6
4025,2015-11-07,2015-11-06,DETROIT_PISTONS,PHOENIX_SUNS,100,92,4026,8
4026,2015-11-07,2015-11-06,DENVER_NUGGETS,GOLDEN_STATE_WARRIORS,104,119,4027,15
4027,2015-11-07,2015-11-06,HOUSTON_ROCKETS,SACRAMENTO_KINGS,116,110,4028,6
4028,2015-11-07,2015-11-06,MINNESOTA_TIMBERWOLVES,CHICAGO_BULLS,102,93,4029,9
4029,2015-11-08,2015-11-07,ORLANDO_MAGIC,PHILADELPHIA_76ERS,105,97,4030,8
4030,2015-11-08,2015-11-07,WASHINGTON_WIZARDS,ATLANTA_HAWKS,99,114,4031,15
4031,2015-11-08,2015-11-07,NEW_ORLEANS_PELICANS,DALLAS_MAVERICKS,98,107,4032,9
4032,2015-11-08,2015-11-07,BROOKLYN_NETS,MILWAUKEE_BUCKS,86,94,4033,8
4033,2015-11-08,2015-11-07,CHARLOTTE_HORNETS,SAN_ANTONIO_SPURS,94,114,4034,20
4034,2015-11-08,2015-11-07,MEMPHIS_GRIZZLIES,UTAH_JAZZ,79,89,4035,10
4035,2015-11-08,2015-11-07,GOLDEN_STATE_WARRIORS,SACRAMENTO_KINGS,103,94,4036,9
4036,2015-11-08,2015-11-07,HOUSTON_ROCKETS,LOS_ANGELES_CLIPPERS,109,105,4037,4
4037,2015-11-08,2015-11-07,INDIANA_PACERS,CLEVELAND_CAVALIERS,97,101,4038,4
4038,2015-11-08,2015-11-07,LOS_ANGELES_LAKERS,NEW_YORK_KNICKS,95,99,4039,4
4039,2015-11-08,2015-11-07,TORONTO_RAPTORS,MIAMI_HEAT,76,96,4040,20
4040,2015-11-09,2015-11-08,PHOENIX_SUNS,OKLAHOMA_CITY_THUNDER,103,124,4041,21
4041,2015-11-09,2015-11-08,DETROIT_PISTONS,PORTLAND_TRAIL_BLAZERS,120,103,4042,17
4042,2015-11-10,2015-11-09,ORLANDO_MAGIC,INDIANA_PACERS,84,97,4043,13
4043,2015-11-10,2015-11-09,CHICAGO_BULLS,PHILADELPHIA_76ERS,111,88,4044,23
4044,2015-11-10,2015-11-09,MINNESOTA_TIMBERWOLVES,ATLANTA_HAWKS,117,107,4045,10
4045,2015-11-10,2015-11-09,PORTLAND_TRAIL_BLAZERS,DENVER_NUGGETS,104,108,4046,4
4046,2015-11-10,2015-11-09,SAN_ANTONIO_SPURS,SACRAMENTO_KINGS,106,88,4047,18
4047,2015-11-10,2015-11-09,DETROIT_PISTONS,GOLDEN_STATE_WARRIORS,95,109,4048,14
4048,2015-11-10,2015-11-09,MEMPHIS_GRIZZLIES,LOS_ANGELES_CLIPPERS,92,94,4049,2
4049,2015-11-11,2015-11-10,UTAH_JAZZ,CLEVELAND_CAVALIERS,114,118,4050,4
4050,2015-11-11,2015-11-10,OKLAHOMA_CITY_THUNDER,WASHINGTON_WIZARDS,125,101,4051,24
4051,2015-11-11,2015-11-10,LOS_ANGELES_LAKERS,MIAMI_HEAT,88,101,4052,13
4052,2015-11-11,2015-11-10,NEW_YORK_KNICKS,TORONTO_RAPTORS,111,109,4053,2
4053,2015-11-11,2015-11-10,BOSTON_CELTICS,MILWAUKEE_BUCKS,99,83,4054,16
4054,2015-11-11,2015-11-10,CHARLOTTE_HORNETS,MINNESOTA_TIMBERWOLVES,104,95,4055,9
4055,2015-11-11,2015-11-10,DALLAS_MAVERICKS,NEW_ORLEANS_PELICANS,105,120,4056,15
4056,2015-11-12,2015-11-11,NEW_YORK_KNICKS,CHARLOTTE_HORNETS,93,95,4057,2
4057,2015-11-12,2015-11-11,LOS_ANGELES_LAKERS,ORLANDO_MAGIC,99,101,4058,2
4058,2015-11-12,2015-11-11,TORONTO_RAPTORS,PHILADELPHIA_76ERS,119,103,4059,16
4059,2015-11-12,2015-11-11,INDIANA_PACERS,BOSTON_CELTICS,102,91,4060,11
4060,2015-11-12,2015-11-11,NEW_ORLEANS_PELICANS,ATLANTA_HAWKS,98,106,4061,8
4061,2015-11-12,2015-11-11,LOS_ANGELES_CLIPPERS,DALLAS_MAVERICKS,108,118,4062,10
4062,2015-11-12,2015-11-11,BROOKLYN_NETS,HOUSTON_ROCKETS,106,98,4063,8
4063,2015-11-12,2015-11-11,GOLDEN_STATE_WARRIORS,MEMPHIS_GRIZZLIES,100,84,4064,16
4064,2015-11-12,2015-11-11,MILWAUKEE_BUCKS,DENVER_NUGGETS,102,103,4065,1
4065,2015-11-12,2015-11-11,DETROIT_PISTONS,SACRAMENTO_KINGS,92,101,4066,9
4066,2015-11-12,2015-11-11,SAN_ANTONIO_SPURS,PORTLAND_TRAIL_BLAZERS,113,101,4067,12
4067,2015-11-13,2015-11-12,UTAH_JAZZ,MIAMI_HEAT,91,92,4068,1
4068,2015-11-13,2015-11-12,GOLDEN_STATE_WARRIORS,MINNESOTA_TIMBERWOLVES,129,116,4069,13
4069,2015-11-13,2015-11-12,LOS_ANGELES_CLIPPERS,PHOENIX_SUNS,104,118,4070,14
4070,2015-11-14,2015-11-13,MINNESOTA_TIMBERWOLVES,INDIANA_PACERS,103,107,4071,4
4071,2015-11-14,2015-11-13,UTAH_JAZZ,ORLANDO_MAGIC,93,102,4072,9
4072,2015-11-14,2015-11-13,ATLANTA_HAWKS,BOSTON_CELTICS,93,106,4073,13
4073,2015-11-14,2015-11-13,CLEVELAND_CAVALIERS,NEW_YORK_KNICKS,90,84,4074,6
4074,2015-11-14,2015-11-13,NEW_ORLEANS_PELICANS,TORONTO_RAPTORS,81,100,4075,19
4075,2015-11-14,2015-11-13,CHARLOTTE_HORNETS,CHICAGO_BULLS,97,102,4076,5
4076,2015-11-14,2015-11-13,PORTLAND_TRAIL_BLAZERS,MEMPHIS_GRIZZLIES,100,101,4077,1
4077,2015-11-14,2015-11-13,PHILADELPHIA_76ERS,OKLAHOMA_CITY_THUNDER,85,102,4078,17
4078,2015-11-14,2015-11-13,LOS_ANGELES_LAKERS,DALLAS_MAVERICKS,82,90,4079,8
4079,2015-11-14,2015-11-13,HOUSTON_ROCKETS,DENVER_NUGGETS,98,107,4080,9
4080,2015-11-14,2015-11-13,BROOKLYN_NETS,SACRAMENTO_KINGS,109,111,4081,2
4081,2015-11-14,2015-11-13,DETROIT_PISTONS,LOS_ANGELES_CLIPPERS,96,101,4082,5
4082,2015-11-15,2015-11-14,ORLANDO_MAGIC,WASHINGTON_WIZARDS,99,108,4083,9
4083,2015-11-15,2015-11-14,DALLAS_MAVERICKS,HOUSTON_ROCKETS,110,98,4084,12
4084,2015-11-15,2015-11-14,CLEVELAND_CAVALIERS,MILWAUKEE_BUCKS,105,108,4085,3
4085,2015-11-15,2015-11-14,PHILADELPHIA_76ERS,SAN_ANTONIO_SPURS,83,92,4086,9
4086,2015-11-15,2015-11-14,DENVER_NUGGETS,PHOENIX_SUNS,81,105,4087,24
4087,2015-11-15,2015-11-14,BROOKLYN_NETS,GOLDEN_STATE_WARRIORS,99,107,4088,8
4088,2015-11-15,2015-11-14,NEW_ORLEANS_PELICANS,NEW_YORK_KNICKS,87,95,4089,8
4089,2015-11-15,2015-11-14,MEMPHIS_GRIZZLIES,MINNESOTA_TIMBERWOLVES,114,106,4090,8
4090,2015-11-15,2015-11-14,PORTLAND_TRAIL_BLAZERS,CHARLOTTE_HORNETS,94,106,4091,12
4091,2015-11-15,2015-11-14,UTAH_JAZZ,ATLANTA_HAWKS,97,96,4092,1
4092,2015-11-16,2015-11-15,BOSTON_CELTICS,OKLAHOMA_CITY_THUNDER,100,85,4093,15
4093,2015-11-16,2015-11-15,TORONTO_RAPTORS,SACRAMENTO_KINGS,101,107,4094,6
4094,2015-11-16,2015-11-15,DETROIT_PISTONS,LOS_ANGELES_LAKERS,85,97,4095,12
4095,2015-11-17,2015-11-16,DALLAS_MAVERICKS,PHILADELPHIA_76ERS,92,86,4096,6
4096,2015-11-17,2015-11-16,INDIANA_PACERS,CHICAGO_BULLS,95,96,4097,1
4097,2015-11-17,2015-11-16,BOSTON_CELTICS,HOUSTON_ROCKETS,111,95,4098,16
4098,2015-11-17,2015-11-16,OKLAHOMA_CITY_THUNDER,MEMPHIS_GRIZZLIES,114,122,4099,8
4099,2015-11-17,2015-11-16,PORTLAND_TRAIL_BLAZERS,SAN_ANTONIO_SPURS,80,93,4100,13
4100,2015-11-17,2015-11-16,LOS_ANGELES_LAKERS,PHOENIX_SUNS,101,120,4101,19
4101,2015-11-18,2015-11-17,MILWAUKEE_BUCKS,WASHINGTON_WIZARDS,86,115,4102,29
4102,2015-11-18,2015-11-17,ATLANTA_HAWKS,BROOKLYN_NETS,88,90,4103,2
4103,2015-11-18,2015-11-17,CLEVELAND_CAVALIERS,DETROIT_PISTONS,99,104,4104,5
4104,2015-11-18,2015-11-17,MINNESOTA_TIMBERWOLVES,MIAMI_HEAT,103,91,4105,12
4105,2015-11-18,2015-11-17,CHARLOTTE_HORNETS,NEW_YORK_KNICKS,94,102,4106,8
4106,2015-11-18,2015-11-17,DENVER_NUGGETS,NEW_ORLEANS_PELICANS,115,98,4107,17
4107,2015-11-18,2015-11-17,TORONTO_RAPTORS,GOLDEN_STATE_WARRIORS,110,115,4108,5
4108,2015-11-19,2015-11-18,BROOKLYN_NETS,CHARLOTTE_HORNETS,111,116,4109,5
4109,2015-11-19,2015-11-18,MINNESOTA_TIMBERWOLVES,ORLANDO_MAGIC,101,104,4110,3
4110,2015-11-19,2015-11-18,INDIANA_PACERS,PHILADELPHIA_76ERS,112,85,4111,27
4111,2015-11-19,2015-11-18,DALLAS_MAVERICKS,BOSTON_CELTICS,106,102,4112,4
4112,2015-11-19,2015-11-18,SACRAMENTO_KINGS,ATLANTA_HAWKS,97,103,4113,6
4113,2015-11-19,2015-11-18,PORTLAND_TRAIL_BLAZERS,HOUSTON_ROCKETS,103,108,4114,5
4114,2015-11-19,2015-11-18,NEW_ORLEANS_PELICANS,OKLAHOMA_CITY_THUNDER,103,110,4115,7
4115,2015-11-19,2015-11-18,DENVER_NUGGETS,SAN_ANTONIO_SPURS,98,109,4116,11
4116,2015-11-19,2015-11-18,TORONTO_RAPTORS,UTAH_JAZZ,89,93,4117,4
4117,2015-11-19,2015-11-18,CHICAGO_BULLS,PHOENIX_SUNS,103,97,4118,6
4118,2015-11-20,2015-11-19,SACRAMENTO_KINGS,MIAMI_HEAT,109,116,4119,7
4119,2015-11-20,2015-11-19,MILWAUKEE_BUCKS,CLEVELAND_CAVALIERS,100,115,4120,15
4120,2015-11-20,2015-11-19,GOLDEN_STATE_WARRIORS,LOS_ANGELES_CLIPPERS,124,117,4121,7
4121,2015-11-21,2015-11-20,PHILADELPHIA_76ERS,CHARLOTTE_HORNETS,88,113,4122,25
4122,2015-11-21,2015-11-20,BROOKLYN_NETS,BOSTON_CELTICS,95,120,4123,25
4123,2015-11-21,2015-11-20,HOUSTON_ROCKETS,MEMPHIS_GRIZZLIES,84,96,4124,12
4124,2015-11-21,2015-11-20,DETROIT_PISTONS,MINNESOTA_TIMBERWOLVES,96,86,4125,10
4125,2015-11-21,2015-11-20,SAN_ANTONIO_SPURS,NEW_ORLEANS_PELICANS,90,104,4126,14
4126,2015-11-21,2015-11-20,NEW_YORK_KNICKS,OKLAHOMA_CITY_THUNDER,93,90,4127,3
4127,2015-11-21,2015-11-20,UTAH_JAZZ,DALLAS_MAVERICKS,93,102,4128,9
4128,2015-11-21,2015-11-20,PHOENIX_SUNS,DENVER_NUGGETS,114,107,4129,7
4129,2015-11-21,2015-11-20,LOS_ANGELES_CLIPPERS,PORTLAND_TRAIL_BLAZERS,91,102,4130,11
4130,2015-11-21,2015-11-20,CHICAGO_BULLS,GOLDEN_STATE_WARRIORS,94,106,4131,12
4131,2015-11-21,2015-11-20,TORONTO_RAPTORS,LOS_ANGELES_LAKERS,102,91,4132,11
4132,2015-11-21,2015-11-20,SACRAMENTO_KINGS,ORLANDO_MAGIC,97,91,4133,6
4133,2015-11-22,2015-11-21,MILWAUKEE_BUCKS,INDIANA_PACERS,86,123,4134,37
4134,2015-11-22,2015-11-21,ATLANTA_HAWKS,CLEVELAND_CAVALIERS,97,109,4135,12
4135,2015-11-22,2015-11-21,WASHINGTON_WIZARDS,DETROIT_PISTONS,97,95,4136,2
4136,2015-11-22,2015-11-21,NEW_YORK_KNICKS,HOUSTON_ROCKETS,107,102,4137,5
4137,2015-11-22,2015-11-21,PHILADELPHIA_76ERS,MIAMI_HEAT,91,96,4138,5
4138,2015-11-22,2015-11-21,MEMPHIS_GRIZZLIES,SAN_ANTONIO_SPURS,82,92,4139,10
4139,2015-11-22,2015-11-21,TORONTO_RAPTORS,LOS_ANGELES_CLIPPERS,91,80,4140,11
4140,2015-11-22,2015-11-21,BOSTON_CELTICS,BROOKLYN_NETS,101,111,4141,10
4141,2015-11-22,2015-11-21,PHOENIX_SUNS,NEW_ORLEANS_PELICANS,116,122,4142,6
4142,2015-11-23,2015-11-22,DALLAS_MAVERICKS,OKLAHOMA_CITY_THUNDER,114,117,4143,3
4143,2015-11-23,2015-11-22,GOLDEN_STATE_WARRIORS,DENVER_NUGGETS,118,105,4144,13
4144,2015-11-23,2015-11-22,PORTLAND_TRAIL_BLAZERS,LOS_ANGELES_LAKERS,107,93,4145,14
4145,2015-11-24,2015-11-23,SACRAMENTO_KINGS,CHARLOTTE_HORNETS,122,127,4146,5
4146,2015-11-24,2015-11-23,ORLANDO_MAGIC,CLEVELAND_CAVALIERS,103,117,4147,14
4147,2015-11-24,2015-11-23,NEW_YORK_KNICKS,MIAMI_HEAT,78,95,4148,17
4148,2015-11-24,2015-11-23,DETROIT_PISTONS,MILWAUKEE_BUCKS,88,109,4149,21
4149,2015-11-24,2015-11-23,PHILADELPHIA_76ERS,MINNESOTA_TIMBERWOLVES,95,100,4150,5
4150,2015-11-24,2015-11-23,PHOENIX_SUNS,SAN_ANTONIO_SPURS,84,98,4151,14
4151,2015-11-24,2015-11-23,OKLAHOMA_CITY_THUNDER,UTAH_JAZZ,111,89,4152,22
4152,2015-11-25,2015-11-24,INDIANA_PACERS,WASHINGTON_WIZARDS,123,106,4153,17
4153,2015-11-25,2015-11-24,BOSTON_CELTICS,ATLANTA_HAWKS,97,121,4154,24
4154,2015-11-25,2015-11-24,DALLAS_MAVERICKS,MEMPHIS_GRIZZLIES,96,110,4155,14
4155,2015-11-25,2015-11-24,LOS_ANGELES_CLIPPERS,DENVER_NUGGETS,111,94,4156,17
4156,2015-11-25,2015-11-24,CHICAGO_BULLS,PORTLAND_TRAIL_BLAZERS,93,88,4157,5
4157,2015-11-25,2015-11-24,LOS_ANGELES_LAKERS,GOLDEN_STATE_WARRIORS,77,111,4158,34
4158,2015-11-26,2015-11-25,WASHINGTON_WIZARDS,CHARLOTTE_HORNETS,87,101,4159,14
4159,2015-11-26,2015-11-25,NEW_YORK_KNICKS,ORLANDO_MAGIC,91,100,4160,9
4160,2015-11-26,2015-11-25,PHILADELPHIA_76ERS,BOSTON_CELTICS,80,84,4161,4
4161,2015-11-26,2015-11-25,MIAMI_HEAT,DETROIT_PISTONS,81,104,4162,23
4162,2015-11-26,2015-11-25,CLEVELAND_CAVALIERS,TORONTO_RAPTORS,99,103,4163,4
4163,2015-11-26,2015-11-25,MEMPHIS_GRIZZLIES,HOUSTON_ROCKETS,102,93,4164,9
4164,2015-11-26,2015-11-25,SACRAMENTO_KINGS,MILWAUKEE_BUCKS,129,118,4165,11
4165,2015-11-26,2015-11-25,ATLANTA_HAWKS,MINNESOTA_TIMBERWOLVES,95,99,4166,4
4166,2015-11-26,2015-11-25,BROOKLYN_NETS,OKLAHOMA_CITY_THUNDER,99,110,4167,11
4167,2015-11-26,2015-11-25,DALLAS_MAVERICKS,SAN_ANTONIO_SPURS,83,88,4168,5
4168,2015-11-26,2015-11-25,NEW_ORLEANS_PELICANS,PHOENIX_SUNS,120,114,4169,6
4169,2015-11-26,2015-11-25,UTAH_JAZZ,LOS_ANGELES_CLIPPERS,102,91,4170,11
4170,2015-11-28,2015-11-27,CLEVELAND_CAVALIERS,CHARLOTTE_HORNETS,95,90,4171,5
4171,2015-11-28,2015-11-27,MILWAUKEE_BUCKS,ORLANDO_MAGIC,90,114,4172,24
4172,2015-11-28,2015-11-27,WASHINGTON_WIZARDS,BOSTON_CELTICS,78,111,4173,33
4173,2015-11-28,2015-11-27,MIAMI_HEAT,NEW_YORK_KNICKS,97,78,4174,19
4174,2015-11-28,2015-11-27,PHILADELPHIA_76ERS,HOUSTON_ROCKETS,114,116,4175,2
4175,2015-11-28,2015-11-27,CHICAGO_BULLS,INDIANA_PACERS,92,104,4176,12
4176,2015-11-28,2015-11-27,ATLANTA_HAWKS,MEMPHIS_GRIZZLIES,116,101,4177,15
4177,2015-11-28,2015-11-27,DETROIT_PISTONS,OKLAHOMA_CITY_THUNDER,87,103,4178,16
4178,2015-11-28,2015-11-27,SAN_ANTONIO_SPURS,DENVER_NUGGETS,91,80,4179,11
4179,2015-11-28,2015-11-27,GOLDEN_STATE_WARRIORS,PHOENIX_SUNS,135,116,4180,19
4180,2015-11-28,2015-11-27,MINNESOTA_TIMBERWOLVES,SACRAMENTO_KINGS,101,91,4181,10
4181,2015-11-28,2015-11-27,NEW_ORLEANS_PELICANS,LOS_ANGELES_CLIPPERS,90,111,4182,21
4182,2015-11-29,2015-11-28,TORONTO_RAPTORS,WASHINGTON_WIZARDS,84,82,4183,2
4183,2015-11-29,2015-11-28,BROOKLYN_NETS,CLEVELAND_CAVALIERS,88,90,4184,2
4184,2015-11-29,2015-11-28,DENVER_NUGGETS,DALLAS_MAVERICKS,81,92,4185,11
4185,2015-11-29,2015-11-28,ATLANTA_HAWKS,SAN_ANTONIO_SPURS,88,108,4186,20
4186,2015-11-29,2015-11-28,NEW_ORLEANS_PELICANS,UTAH_JAZZ,87,101,4187,14
4187,2015-11-29,2015-11-28,LOS_ANGELES_LAKERS,PORTLAND_TRAIL_BLAZERS,96,108,4188,12
4188,2015-11-29,2015-11-28,SACRAMENTO_KINGS,GOLDEN_STATE_WARRIORS,101,120,4189,19
4189,2015-11-29,2015-11-28,MILWAUKEE_BUCKS,CHARLOTTE_HORNETS,82,87,4190,5
4190,2015-11-29,2015-11-28,MINNESOTA_TIMBERWOLVES,LOS_ANGELES_CLIPPERS,99,107,4191,8
4191,2015-11-29,2015-11-28,DETROIT_PISTONS,BROOKLYN_NETS,83,87,4192,4
4192,2015-11-29,2015-11-28,PHILADELPHIA_76ERS,MEMPHIS_GRIZZLIES,84,92,4193,8
4193,2015-11-29,2015-11-28,BOSTON_CELTICS,ORLANDO_MAGIC,91,110,4194,19
4194,2015-11-29,2015-11-28,PHOENIX_SUNS,TORONTO_RAPTORS,107,102,4195,5
4195,2015-11-30,2015-11-29,HOUSTON_ROCKETS,NEW_YORK_KNICKS,116,111,4196,5
4196,2015-11-30,2015-11-29,INDIANA_PACERS,LOS_ANGELES_LAKERS,107,103,4197,4
4197,2015-12-01,2015-11-30,HOUSTON_ROCKETS,DETROIT_PISTONS,105,116,4198,11
4198,2015-12-01,2015-11-30,BOSTON_CELTICS,MIAMI_HEAT,105,95,4199,10
4199,2015-12-01,2015-11-30,OKLAHOMA_CITY_THUNDER,ATLANTA_HAWKS,100,106,4200,6
4200,2015-12-01,2015-11-30,SAN_ANTONIO_SPURS,CHICAGO_BULLS,89,92,4201,3
4201,2015-12-01,2015-11-30,DENVER_NUGGETS,MILWAUKEE_BUCKS,74,92,4202,18
4202,2015-12-01,2015-11-30,GOLDEN_STATE_WARRIORS,UTAH_JAZZ,106,103,4203,3
4203,2015-12-01,2015-11-30,DALLAS_MAVERICKS,SACRAMENTO_KINGS,98,112,4204,14
4204,2015-12-01,2015-11-30,PORTLAND_TRAIL_BLAZERS,LOS_ANGELES_CLIPPERS,87,102,4205,15
4205,2015-12-02,2015-12-01,WASHINGTON_WIZARDS,CLEVELAND_CAVALIERS,97,85,4206,12
4206,2015-12-02,2015-12-01,LOS_ANGELES_LAKERS,PHILADELPHIA_76ERS,91,103,4207,12
4207,2015-12-02,2015-12-01,PHOENIX_SUNS,BROOKLYN_NETS,91,94,4208,3
4208,2015-12-02,2015-12-01,ORLANDO_MAGIC,MINNESOTA_TIMBERWOLVES,96,93,4209,3
4209,2015-12-02,2015-12-01,MEMPHIS_GRIZZLIES,NEW_ORLEANS_PELICANS,113,104,4210,9
4210,2015-12-02,2015-12-01,DALLAS_MAVERICKS,PORTLAND_TRAIL_BLAZERS,115,112,4211,3
4211,2015-12-03,2015-12-02,GOLDEN_STATE_WARRIORS,CHARLOTTE_HORNETS,116,99,4212,17
4212,2015-12-03,2015-12-02,LOS_ANGELES_LAKERS,WASHINGTON_WIZARDS,108,104,4213,4
4213,2015-12-03,2015-12-02,PHOENIX_SUNS,DETROIT_PISTONS,122,127,4214,5
4214,2015-12-03,2015-12-02,PHILADELPHIA_76ERS,NEW_YORK_KNICKS,87,99,4215,12
4215,2015-12-03,2015-12-02,TORONTO_RAPTORS,ATLANTA_HAWKS,96,86,4216,10
4216,2015-12-03,2015-12-02,DENVER_NUGGETS,CHICAGO_BULLS,90,99,4217,9
4217,2015-12-03,2015-12-02,NEW_ORLEANS_PELICANS,HOUSTON_ROCKETS,101,108,4218,7
4218,2015-12-03,2015-12-02,MILWAUKEE_BUCKS,SAN_ANTONIO_SPURS,70,95,4219,25
4219,2015-12-03,2015-12-02,INDIANA_PACERS,LOS_ANGELES_CLIPPERS,103,91,4220,12
4220,2015-12-04,2015-12-03,OKLAHOMA_CITY_THUNDER,MIAMI_HEAT,95,97,4221,2
4221,2015-12-04,2015-12-03,DENVER_NUGGETS,TORONTO_RAPTORS,106,105,4222,1
4222,2015-12-04,2015-12-03,ORLANDO_MAGIC,UTAH_JAZZ,103,94,4223,9
4223,2015-12-04,2015-12-03,SAN_ANTONIO_SPURS,MEMPHIS_GRIZZLIES,103,83,4224,20
4224,2015-12-04,2015-12-03,INDIANA_PACERS,PORTLAND_TRAIL_BLAZERS,111,123,4225,12
4225,2015-12-04,2015-12-03,BOSTON_CELTICS,SACRAMENTO_KINGS,114,97,4226,17
4226,2015-12-05,2015-12-04,BROOKLYN_NETS,NEW_YORK_KNICKS,91,108,4227,17
4227,2015-12-05,2015-12-04,PHOENIX_SUNS,WASHINGTON_WIZARDS,106,109,4228,3
4228,2015-12-05,2015-12-04,MILWAUKEE_BUCKS,DETROIT_PISTONS,95,102,4229,7
4229,2015-12-05,2015-12-04,LOS_ANGELES_LAKERS,ATLANTA_HAWKS,87,100,4230,13
4230,2015-12-05,2015-12-04,HOUSTON_ROCKETS,DALLAS_MAVERICKS,100,96,4231,4
4231,2015-12-05,2015-12-04,CLEVELAND_CAVALIERS,NEW_ORLEANS_PELICANS,108,114,4232,6
4232,2015-12-05,2015-12-04,DENVER_NUGGETS,PHILADELPHIA_76ERS,108,105,4233,3
4233,2015-12-05,2015-12-04,GOLDEN_STATE_WARRIORS,TORONTO_RAPTORS,112,109,4234,3
4234,2015-12-06,2015-12-05,CHARLOTTE_HORNETS,CHICAGO_BULLS,102,96,4235,6
4235,2015-12-06,2015-12-05,SACRAMENTO_KINGS,HOUSTON_ROCKETS,113,120,4236,7
4236,2015-12-06,2015-12-05,CLEVELAND_CAVALIERS,MIAMI_HEAT,84,99,4237,15
4237,2015-12-06,2015-12-05,PORTLAND_TRAIL_BLAZERS,MINNESOTA_TIMBERWOLVES,109,103,4238,6
4238,2015-12-06,2015-12-05,NEW_YORK_KNICKS,MILWAUKEE_BUCKS,91,106,4239,15
4239,2015-12-06,2015-12-05,BOSTON_CELTICS,SAN_ANTONIO_SPURS,105,108,4240,3
4240,2015-12-06,2015-12-05,INDIANA_PACERS,UTAH_JAZZ,119,122,4241,3
4241,2015-12-06,2015-12-05,ORLANDO_MAGIC,LOS_ANGELES_CLIPPERS,101,103,4242,2
4242,2015-12-06,2015-12-05,PHOENIX_SUNS,MEMPHIS_GRIZZLIES,93,95,4243,2
4243,2015-12-06,2015-12-05,GOLDEN_STATE_WARRIORS,BROOKLYN_NETS,114,98,4244,16
4244,2015-12-06,2015-12-05,LOS_ANGELES_LAKERS,DETROIT_PISTONS,91,111,4245,20
4245,2015-12-06,2015-12-05,DALLAS_MAVERICKS,WASHINGTON_WIZARDS,116,104,4246,12
4246,2015-12-07,2015-12-06,SACRAMENTO_KINGS,OKLAHOMA_CITY_THUNDER,95,98,4247,3
4247,2015-12-08,2015-12-07,DETROIT_PISTONS,CHARLOTTE_HORNETS,84,104,4248,20
4248,2015-12-08,2015-12-07,SAN_ANTONIO_SPURS,PHILADELPHIA_76ERS,119,68,4249,51
4249,2015-12-08,2015-12-07,WASHINGTON_WIZARDS,MIAMI_HEAT,114,103,4250,11
4250,2015-12-08,2015-12-07,DALLAS_MAVERICKS,NEW_YORK_KNICKS,104,97,4251,7
4251,2015-12-08,2015-12-07,LOS_ANGELES_LAKERS,TORONTO_RAPTORS,93,102,4252,9
4252,2015-12-08,2015-12-07,PHOENIX_SUNS,CHICAGO_BULLS,103,101,4253,2
4253,2015-12-08,2015-12-07,PORTLAND_TRAIL_BLAZERS,MILWAUKEE_BUCKS,88,90,4254,2
4254,2015-12-08,2015-12-07,LOS_ANGELES_CLIPPERS,MINNESOTA_TIMBERWOLVES,110,106,4255,4
4255,2015-12-08,2015-12-07,BOSTON_CELTICS,NEW_ORLEANS_PELICANS,111,93,4256,18
4256,2015-12-09,2015-12-08,PORTLAND_TRAIL_BLAZERS,CLEVELAND_CAVALIERS,100,105,4257,5
4257,2015-12-09,2015-12-08,GOLDEN_STATE_WARRIORS,INDIANA_PACERS,131,123,4258,8
4258,2015-12-09,2015-12-08,HOUSTON_ROCKETS,BROOKLYN_NETS,105,110,4259,5
4259,2015-12-09,2015-12-08,OKLAHOMA_CITY_THUNDER,MEMPHIS_GRIZZLIES,125,88,4260,37
4260,2015-12-09,2015-12-08,ORLANDO_MAGIC,DENVER_NUGGETS,85,74,4261,11
4261,2015-12-09,2015-12-08,UTAH_JAZZ,SACRAMENTO_KINGS,106,114,4262,8
4262,2015-12-10,2015-12-09,CHICAGO_BULLS,BOSTON_CELTICS,100,105,4263,5
4263,2015-12-10,2015-12-09,MIAMI_HEAT,CHARLOTTE_HORNETS,81,99,4264,18
4264,2015-12-10,2015-12-09,HOUSTON_ROCKETS,WASHINGTON_WIZARDS,109,103,4265,6
4265,2015-12-10,2015-12-09,MEMPHIS_GRIZZLIES,DETROIT_PISTONS,93,92,4266,1
4266,2015-12-10,2015-12-09,SAN_ANTONIO_SPURS,TORONTO_RAPTORS,94,97,4267,3
4267,2015-12-10,2015-12-09,LOS_ANGELES_CLIPPERS,MILWAUKEE_BUCKS,109,95,4268,14
4268,2015-12-10,2015-12-09,LOS_ANGELES_LAKERS,MINNESOTA_TIMBERWOLVES,122,123,4269,1
4269,2015-12-10,2015-12-09,ORLANDO_MAGIC,PHOENIX_SUNS,104,107,4270,3
4270,2015-12-10,2015-12-09,NEW_YORK_KNICKS,UTAH_JAZZ,85,106,4271,21
4271,2015-12-10,2015-12-09,ATLANTA_HAWKS,DALLAS_MAVERICKS,98,95,4272,3
4272,2015-12-11,2015-12-10,PHILADELPHIA_76ERS,BROOKLYN_NETS,91,100,4273,9
4273,2015-12-11,2015-12-10,LOS_ANGELES_CLIPPERS,CHICAGO_BULLS,80,83,4274,3
4274,2015-12-11,2015-12-10,ATLANTA_HAWKS,OKLAHOMA_CITY_THUNDER,94,107,4275,13
4275,2015-12-11,2015-12-10,NEW_YORK_KNICKS,SACRAMENTO_KINGS,97,99,4276,2
4276,2015-12-12,2015-12-11,MIAMI_HEAT,INDIANA_PACERS,83,96,4277,13
4277,2015-12-12,2015-12-11,CLEVELAND_CAVALIERS,ORLANDO_MAGIC,111,76,4278,35
4278,2015-12-12,2015-12-11,DETROIT_PISTONS,PHILADELPHIA_76ERS,107,95,4279,12
4279,2015-12-12,2015-12-11,GOLDEN_STATE_WARRIORS,BOSTON_CELTICS,124,119,4280,5
4280,2015-12-12,2015-12-11,MILWAUKEE_BUCKS,TORONTO_RAPTORS,83,90,4281,7
4281,2015-12-12,2015-12-11,CHARLOTTE_HORNETS,MEMPHIS_GRIZZLIES,123,99,4282,24
4282,2015-12-12,2015-12-11,WASHINGTON_WIZARDS,NEW_ORLEANS_PELICANS,105,107,4283,2
4283,2015-12-12,2015-12-11,MINNESOTA_TIMBERWOLVES,DENVER_NUGGETS,108,111,4284,3
4284,2015-12-12,2015-12-11,OKLAHOMA_CITY_THUNDER,UTAH_JAZZ,94,90,4285,4
4285,2015-12-12,2015-12-11,PORTLAND_TRAIL_BLAZERS,PHOENIX_SUNS,106,96,4286,10
4286,2015-12-12,2015-12-11,LOS_ANGELES_LAKERS,SAN_ANTONIO_SPURS,87,109,4287,22
4287,2015-12-12,2015-12-11,LOS_ANGELES_CLIPPERS,BROOKLYN_NETS,105,100,4288,5
4288,2015-12-13,2015-12-12,BOSTON_CELTICS,CHARLOTTE_HORNETS,98,93,4289,5
4289,2015-12-13,2015-12-12,INDIANA_PACERS,DETROIT_PISTONS,96,118,4290,22
4290,2015-12-13,2015-12-12,SAN_ANTONIO_SPURS,ATLANTA_HAWKS,103,78,4291,25
4291,2015-12-13,2015-12-12,NEW_ORLEANS_PELICANS,CHICAGO_BULLS,94,98,4292,4
4292,2015-12-13,2015-12-12,LOS_ANGELES_LAKERS,HOUSTON_ROCKETS,97,126,4293,29
4293,2015-12-13,2015-12-12,WASHINGTON_WIZARDS,DALLAS_MAVERICKS,114,111,4294,3
4294,2015-12-13,2015-12-12,GOLDEN_STATE_WARRIORS,MILWAUKEE_BUCKS,95,108,4295,13
4295,2015-12-13,2015-12-12,NEW_YORK_KNICKS,PORTLAND_TRAIL_BLAZERS,112,110,4296,2
4296,2015-12-13,2015-12-12,MINNESOTA_TIMBERWOLVES,PHOENIX_SUNS,101,108,4297,7
4297,2015-12-13,2015-12-12,MEMPHIS_GRIZZLIES,MIAMI_HEAT,97,100,4298,3
4298,2015-12-13,2015-12-12,PHILADELPHIA_76ERS,TORONTO_RAPTORS,76,96,4299,20
4299,2015-12-14,2015-12-13,UTAH_JAZZ,OKLAHOMA_CITY_THUNDER,98,104,4300,6
4300,2015-12-15,2015-12-14,TORONTO_RAPTORS,INDIANA_PACERS,90,106,4301,16
4301,2015-12-15,2015-12-14,ORLANDO_MAGIC,BROOKLYN_NETS,105,82,4302,23
4302,2015-12-15,2015-12-14,LOS_ANGELES_CLIPPERS,DETROIT_PISTONS,105,103,4303,2
4303,2015-12-15,2015-12-14,MIAMI_HEAT,ATLANTA_HAWKS,100,88,4304,12
4304,2015-12-15,2015-12-14,PHILADELPHIA_76ERS,CHICAGO_BULLS,96,115,4305,19
4305,2015-12-15,2015-12-14,WASHINGTON_WIZARDS,MEMPHIS_GRIZZLIES,95,112,4306,17
4306,2015-12-15,2015-12-14,PHOENIX_SUNS,DALLAS_MAVERICKS,94,104,4307,10
4307,2015-12-15,2015-12-14,UTAH_JAZZ,SAN_ANTONIO_SPURS,81,118,4308,37
4308,2015-12-15,2015-12-14,HOUSTON_ROCKETS,DENVER_NUGGETS,108,114,4309,6
4309,2015-12-15,2015-12-14,NEW_ORLEANS_PELICANS,PORTLAND_TRAIL_BLAZERS,101,105,4310,4
4310,2015-12-16,2015-12-15,CLEVELAND_CAVALIERS,BOSTON_CELTICS,89,77,4311,12
4311,2015-12-16,2015-12-15,DENVER_NUGGETS,MINNESOTA_TIMBERWOLVES,112,100,4312,12
4312,2015-12-16,2015-12-15,HOUSTON_ROCKETS,SACRAMENTO_KINGS,97,107,4313,10
4313,2015-12-16,2015-12-15,MILWAUKEE_BUCKS,LOS_ANGELES_LAKERS,95,113,4314,18
4314,2015-12-17,2015-12-16,DALLAS_MAVERICKS,INDIANA_PACERS,81,107,4315,26
4315,2015-12-17,2015-12-16,CHARLOTTE_HORNETS,ORLANDO_MAGIC,98,113,4316,15
4316,2015-12-17,2015-12-16,MIAMI_HEAT,BROOKLYN_NETS,104,98,4317,6
4317,2015-12-17,2015-12-16,BOSTON_CELTICS,DETROIT_PISTONS,116,119,4318,3
4318,2015-12-17,2015-12-16,MINNESOTA_TIMBERWOLVES,NEW_YORK_KNICKS,102,107,4319,5
4319,2015-12-17,2015-12-16,PHILADELPHIA_76ERS,ATLANTA_HAWKS,106,127,4320,21
4320,2015-12-17,2015-12-16,MEMPHIS_GRIZZLIES,CHICAGO_BULLS,85,98,4321,13
4321,2015-12-17,2015-12-16,PORTLAND_TRAIL_BLAZERS,OKLAHOMA_CITY_THUNDER,90,106,4322,16
4322,2015-12-17,2015-12-16,WASHINGTON_WIZARDS,SAN_ANTONIO_SPURS,95,114,4323,19
4323,2015-12-17,2015-12-16,NEW_ORLEANS_PELICANS,UTAH_JAZZ,104,94,4324,10
4324,2015-12-17,2015-12-16,PHOENIX_SUNS,GOLDEN_STATE_WARRIORS,103,128,4325,25
4325,2015-12-17,2015-12-16,MILWAUKEE_BUCKS,LOS_ANGELES_CLIPPERS,90,103,4326,13
4326,2015-12-18,2015-12-17,TORONTO_RAPTORS,CHARLOTTE_HORNETS,99,109,4327,10
4327,2015-12-18,2015-12-17,OKLAHOMA_CITY_THUNDER,CLEVELAND_CAVALIERS,100,104,4328,4
4328,2015-12-18,2015-12-17,HOUSTON_ROCKETS,LOS_ANGELES_LAKERS,107,87,4329,20
4329,2015-12-19,2015-12-18,BROOKLYN_NETS,INDIANA_PACERS,97,104,4330,7
4330,2015-12-19,2015-12-18,PORTLAND_TRAIL_BLAZERS,ORLANDO_MAGIC,94,102,4331,8
4331,2015-12-19,2015-12-18,NEW_YORK_KNICKS,PHILADELPHIA_76ERS,107,97,4332,10
4332,2015-12-19,2015-12-18,ATLANTA_HAWKS,BOSTON_CELTICS,109,101,4333,8
4333,2015-12-19,2015-12-18,DETROIT_PISTONS,CHICAGO_BULLS,147,144,4334,3
4334,2015-12-19,2015-12-18,TORONTO_RAPTORS,MIAMI_HEAT,108,94,4335,14
4335,2015-12-19,2015-12-18,SACRAMENTO_KINGS,MINNESOTA_TIMBERWOLVES,95,99,4336,4
4336,2015-12-19,2015-12-18,LOS_ANGELES_CLIPPERS,SAN_ANTONIO_SPURS,107,115,4337,8
4337,2015-12-19,2015-12-18,MEMPHIS_GRIZZLIES,DALLAS_MAVERICKS,88,97,4338,9
4338,2015-12-19,2015-12-18,DENVER_NUGGETS,UTAH_JAZZ,88,97,4339,9
4339,2015-12-19,2015-12-18,MILWAUKEE_BUCKS,GOLDEN_STATE_WARRIORS,112,121,4340,9
4340,2015-12-19,2015-12-18,NEW_ORLEANS_PELICANS,PHOENIX_SUNS,88,104,4341,16
4341,2015-12-19,2015-12-18,LOS_ANGELES_LAKERS,OKLAHOMA_CITY_THUNDER,78,118,4342,40
4342,2015-12-20,2015-12-19,CHARLOTTE_HORNETS,WASHINGTON_WIZARDS,101,109,4343,8
4343,2015-12-20,2015-12-19,CHICAGO_BULLS,NEW_YORK_KNICKS,91,107,4344,16
4344,2015-12-20,2015-12-19,LOS_ANGELES_CLIPPERS,HOUSTON_ROCKETS,97,107,4345,10
4345,2015-12-20,2015-12-19,INDIANA_PACERS,MEMPHIS_GRIZZLIES,84,96,4346,12
4346,2015-12-20,2015-12-19,MINNESOTA_TIMBERWOLVES,BROOKLYN_NETS,100,85,4347,15
4347,2015-12-20,2015-12-19,PORTLAND_TRAIL_BLAZERS,MIAMI_HEAT,109,116,4348,7
4348,2015-12-20,2015-12-19,PHILADELPHIA_76ERS,CLEVELAND_CAVALIERS,86,108,4349,22
4349,2015-12-20,2015-12-19,MILWAUKEE_BUCKS,PHOENIX_SUNS,101,95,4350,6
4350,2015-12-20,2015-12-19,ATLANTA_HAWKS,ORLANDO_MAGIC,103,100,4351,3
4351,2015-12-20,2015-12-19,SACRAMENTO_KINGS,TORONTO_RAPTORS,104,94,4352,10
4352,2015-12-21,2015-12-20,NEW_ORLEANS_PELICANS,DENVER_NUGGETS,130,125,4353,5
4353,2015-12-22,2015-12-21,SACRAMENTO_KINGS,WASHINGTON_WIZARDS,99,113,4354,14
4354,2015-12-22,2015-12-21,MINNESOTA_TIMBERWOLVES,BOSTON_CELTICS,99,113,4355,14
4355,2015-12-22,2015-12-21,ORLANDO_MAGIC,NEW_YORK_KNICKS,107,99,4356,8
4356,2015-12-22,2015-12-21,PORTLAND_TRAIL_BLAZERS,ATLANTA_HAWKS,97,106,4357,9
4357,2015-12-22,2015-12-21,BROOKLYN_NETS,CHICAGO_BULLS,105,102,4358,3
4358,2015-12-22,2015-12-21,CHARLOTTE_HORNETS,HOUSTON_ROCKETS,95,102,4359,7
4359,2015-12-22,2015-12-21,INDIANA_PACERS,SAN_ANTONIO_SPURS,92,106,4360,14
4360,2015-12-22,2015-12-21,PHOENIX_SUNS,UTAH_JAZZ,89,110,4361,21
4361,2015-12-22,2015-12-21,OKLAHOMA_CITY_THUNDER,LOS_ANGELES_CLIPPERS,100,99,4362,1
4362,2015-12-23,2015-12-22,MEMPHIS_GRIZZLIES,PHILADELPHIA_76ERS,104,90,4363,14
4363,2015-12-23,2015-12-22,DETROIT_PISTONS,MIAMI_HEAT,93,92,4364,1
4364,2015-12-23,2015-12-22,DALLAS_MAVERICKS,TORONTO_RAPTORS,99,103,4365,4
4365,2015-12-23,2015-12-22,LOS_ANGELES_LAKERS,DENVER_NUGGETS,111,107,4366,4
4366,2015-12-24,2015-12-23,BOSTON_CELTICS,CHARLOTTE_HORNETS,102,89,4367,13
4367,2015-12-24,2015-12-23,NEW_YORK_KNICKS,CLEVELAND_CAVALIERS,84,91,4368,7
4368,2015-12-24,2015-12-23,SACRAMENTO_KINGS,INDIANA_PACERS,108,106,4369,2
4369,2015-12-24,2015-12-23,HOUSTON_ROCKETS,ORLANDO_MAGIC,101,104,4370,3
4370,2015-12-24,2015-12-23,MEMPHIS_GRIZZLIES,WASHINGTON_WIZARDS,91,100,4371,9
4371,2015-12-24,2015-12-23,DALLAS_MAVERICKS,BROOKLYN_NETS,119,118,4372,1
4372,2015-12-24,2015-12-23,DETROIT_PISTONS,ATLANTA_HAWKS,100,107,4373,7
4373,2015-12-24,2015-12-23,PHILADELPHIA_76ERS,MILWAUKEE_BUCKS,100,113,4374,13
4374,2015-12-24,2015-12-23,SAN_ANTONIO_SPURS,MINNESOTA_TIMBERWOLVES,108,83,4375,25
4375,2015-12-24,2015-12-23,PORTLAND_TRAIL_BLAZERS,NEW_ORLEANS_PELICANS,89,115,4376,26
4376,2015-12-24,2015-12-23,DENVER_NUGGETS,PHOENIX_SUNS,104,96,4377,8
4377,2015-12-24,2015-12-23,UTAH_JAZZ,GOLDEN_STATE_WARRIORS,85,103,4378,18
4378,2015-12-24,2015-12-23,OKLAHOMA_CITY_THUNDER,LOS_ANGELES_LAKERS,120,85,4379,35
4379,2015-12-25,2015-12-24,NEW_ORLEANS_PELICANS,MIAMI_HEAT,88,94,4380,6
4380,2015-12-25,2015-12-24,CHICAGO_BULLS,OKLAHOMA_CITY_THUNDER,105,96,4381,9
4381,2015-12-25,2015-12-24,CLEVELAND_CAVALIERS,GOLDEN_STATE_WARRIORS,83,89,4382,6
4382,2015-12-26,2015-12-25,SAN_ANTONIO_SPURS,HOUSTON_ROCKETS,84,88,4383,4
4383,2015-12-26,2015-12-25,LOS_ANGELES_CLIPPERS,LOS_ANGELES_LAKERS,94,84,4384,10
4384,2015-12-26,2015-12-25,WASHINGTON_WIZARDS,BROOKLYN_NETS,111,96,4385,15
4385,2015-12-26,2015-12-25,TORONTO_RAPTORS,MILWAUKEE_BUCKS,111,90,4386,21
4386,2015-12-27,2015-12-26,MEMPHIS_GRIZZLIES,CHARLOTTE_HORNETS,92,98,4387,6
4387,2015-12-27,2015-12-26,HOUSTON_ROCKETS,NEW_ORLEANS_PELICANS,108,110,4388,2
4388,2015-12-27,2015-12-26,MIAMI_HEAT,ORLANDO_MAGIC,108,101,4389,7
4389,2015-12-27,2015-12-26,NEW_YORK_KNICKS,ATLANTA_HAWKS,98,117,4390,19
4390,2015-12-27,2015-12-26,BOSTON_CELTICS,DETROIT_PISTONS,99,93,4391,6
4391,2015-12-27,2015-12-26,INDIANA_PACERS,MINNESOTA_TIMBERWOLVES,102,88,4392,14
4392,2015-12-27,2015-12-26,CHICAGO_BULLS,DALLAS_MAVERICKS,111,118,4393,7
4393,2015-12-27,2015-12-26,DENVER_NUGGETS,SAN_ANTONIO_SPURS,86,101,4394,15
4394,2015-12-27,2015-12-26,PHILADELPHIA_76ERS,PHOENIX_SUNS,111,104,4395,7
4395,2015-12-27,2015-12-26,LOS_ANGELES_CLIPPERS,UTAH_JAZZ,109,104,4396,5
4396,2015-12-27,2015-12-26,CLEVELAND_CAVALIERS,PORTLAND_TRAIL_BLAZERS,76,105,4397,29
4397,2015-12-27,2015-12-26,LOS_ANGELES_LAKERS,MEMPHIS_GRIZZLIES,96,112,4398,16
4398,2015-12-28,2015-12-27,NEW_YORK_KNICKS,BOSTON_CELTICS,91,100,4399,9
4399,2015-12-28,2015-12-27,DENVER_NUGGETS,OKLAHOMA_CITY_THUNDER,112,122,4400,10
4400,2015-12-28,2015-12-27,PORTLAND_TRAIL_BLAZERS,SACRAMENTO_KINGS,98,94,4401,4
4401,2015-12-29,2015-12-28,LOS_ANGELES_LAKERS,CHARLOTTE_HORNETS,98,108,4402,10
4402,2015-12-29,2015-12-28,ATLANTA_HAWKS,INDIANA_PACERS,87,93,4403,6
4403,2015-12-29,2015-12-28,NEW_ORLEANS_PELICANS,ORLANDO_MAGIC,89,104,4404,15
4404,2015-12-29,2015-12-28,LOS_ANGELES_CLIPPERS,WASHINGTON_WIZARDS,108,91,4405,17
4405,2015-12-29,2015-12-28,BROOKLYN_NETS,MIAMI_HEAT,111,105,4406,6
4406,2015-12-29,2015-12-28,TORONTO_RAPTORS,CHICAGO_BULLS,97,104,4407,7
4407,2015-12-29,2015-12-28,MILWAUKEE_BUCKS,DALLAS_MAVERICKS,93,103,4408,10
4408,2015-12-29,2015-12-28,MINNESOTA_TIMBERWOLVES,SAN_ANTONIO_SPURS,95,101,4409,6
4409,2015-12-29,2015-12-28,CLEVELAND_CAVALIERS,PHOENIX_SUNS,101,97,4410,4
4410,2015-12-29,2015-12-28,PHILADELPHIA_76ERS,UTAH_JAZZ,91,95,4411,4
4411,2015-12-29,2015-12-28,SACRAMENTO_KINGS,GOLDEN_STATE_WARRIORS,103,122,4412,19
4412,2015-12-30,2015-12-29,DETROIT_PISTONS,NEW_YORK_KNICKS,96,108,4413,12
4413,2015-12-30,2015-12-29,ATLANTA_HAWKS,HOUSTON_ROCKETS,121,115,4414,6
4414,2015-12-30,2015-12-29,MIAMI_HEAT,MEMPHIS_GRIZZLIES,90,99,4415,9
4415,2015-12-30,2015-12-29,MILWAUKEE_BUCKS,OKLAHOMA_CITY_THUNDER,123,131,4416,8
4416,2015-12-30,2015-12-29,CLEVELAND_CAVALIERS,DENVER_NUGGETS,93,87,4417,6
4417,2015-12-31,2015-12-30,LOS_ANGELES_CLIPPERS,CHARLOTTE_HORNETS,122,117,4418,5
4418,2015-12-31,2015-12-30,BROOKLYN_NETS,ORLANDO_MAGIC,93,100,4419,7
4419,2015-12-31,2015-12-30,LOS_ANGELES_LAKERS,BOSTON_CELTICS,112,104,4420,8
4420,2015-12-31,2015-12-30,WASHINGTON_WIZARDS,TORONTO_RAPTORS,91,94,4421,3
4421,2015-12-31,2015-12-30,INDIANA_PACERS,CHICAGO_BULLS,100,102,4422,2
4422,2015-12-31,2015-12-30,UTAH_JAZZ,MINNESOTA_TIMBERWOLVES,80,94,4423,14
4423,2015-12-31,2015-12-30,GOLDEN_STATE_WARRIORS,DALLAS_MAVERICKS,91,114,4424,23
4424,2015-12-31,2015-12-30,PHOENIX_SUNS,SAN_ANTONIO_SPURS,79,112,4425,33
4425,2015-12-31,2015-12-30,DENVER_NUGGETS,PORTLAND_TRAIL_BLAZERS,103,110,4426,7
4426,2015-12-31,2015-12-30,PHILADELPHIA_76ERS,SACRAMENTO_KINGS,110,105,4427,5
4427,2015-12-31,2015-12-30,MINNESOTA_TIMBERWOLVES,DETROIT_PISTONS,90,115,4428,25
4428,2015-12-31,2015-12-30,MILWAUKEE_BUCKS,INDIANA_PACERS,120,116,4429,4
4429,2016-01-01,2015-12-31,GOLDEN_STATE_WARRIORS,HOUSTON_ROCKETS,114,110,4430,4
4430,2016-01-01,2015-12-31,LOS_ANGELES_CLIPPERS,NEW_ORLEANS_PELICANS,95,89,4431,6
4431,2016-01-01,2015-12-31,PHOENIX_SUNS,OKLAHOMA_CITY_THUNDER,106,110,4432,4
4432,2016-01-01,2015-12-31,PORTLAND_TRAIL_BLAZERS,UTAH_JAZZ,96,109,4433,13
4433,2016-01-02,2016-01-01,ORLANDO_MAGIC,WASHINGTON_WIZARDS,91,103,4434,12
4434,2016-01-02,2016-01-01,DALLAS_MAVERICKS,MIAMI_HEAT,82,106,4435,24
4435,2016-01-02,2016-01-01,CHARLOTTE_HORNETS,TORONTO_RAPTORS,94,104,4436,10
4436,2016-01-02,2016-01-01,NEW_YORK_KNICKS,CHICAGO_BULLS,81,108,4437,27
4437,2016-01-02,2016-01-01,PHILADELPHIA_76ERS,LOS_ANGELES_LAKERS,84,93,4438,9
4438,2016-01-02,2016-01-01,BROOKLYN_NETS,BOSTON_CELTICS,100,97,4439,3
4439,2016-01-02,2016-01-01,PHOENIX_SUNS,SACRAMENTO_KINGS,119,142,4440,23
4440,2016-01-03,2016-01-02,OKLAHOMA_CITY_THUNDER,CHARLOTTE_HORNETS,109,90,4441,19
4441,2016-01-03,2016-01-02,DETROIT_PISTONS,INDIANA_PACERS,82,94,4442,12
4442,2016-01-03,2016-01-02,ORLANDO_MAGIC,CLEVELAND_CAVALIERS,79,104,4443,25
4443,2016-01-03,2016-01-02,MILWAUKEE_BUCKS,MINNESOTA_TIMBERWOLVES,95,85,4444,10
4444,2016-01-03,2016-01-02,NEW_ORLEANS_PELICANS,DALLAS_MAVERICKS,105,98,4445,7
4445,2016-01-03,2016-01-02,HOUSTON_ROCKETS,SAN_ANTONIO_SPURS,103,121,4446,18
4446,2016-01-03,2016-01-02,MEMPHIS_GRIZZLIES,UTAH_JAZZ,87,92,4447,5
4447,2016-01-03,2016-01-02,DENVER_NUGGETS,GOLDEN_STATE_WARRIORS,108,111,4448,3
4448,2016-01-03,2016-01-02,PHILADELPHIA_76ERS,LOS_ANGELES_CLIPPERS,99,130,4449,31
4449,2016-01-03,2016-01-02,ATLANTA_HAWKS,NEW_YORK_KNICKS,97,111,4450,14
4450,2016-01-03,2016-01-02,CHICAGO_BULLS,TORONTO_RAPTORS,115,113,4451,2
4451,2016-01-03,2016-01-02,MIAMI_HEAT,WASHINGTON_WIZARDS,97,75,4452,22
4452,2016-01-04,2016-01-03,PORTLAND_TRAIL_BLAZERS,DENVER_NUGGETS,112,106,4453,6
4453,2016-01-04,2016-01-03,PHOENIX_SUNS,LOS_ANGELES_LAKERS,77,97,4454,20
4454,2016-01-05,2016-01-04,TORONTO_RAPTORS,CLEVELAND_CAVALIERS,100,122,4455,22
4455,2016-01-05,2016-01-04,MINNESOTA_TIMBERWOLVES,PHILADELPHIA_76ERS,99,109,4456,10
4456,2016-01-05,2016-01-04,BOSTON_CELTICS,BROOKLYN_NETS,103,94,4457,9
4457,2016-01-05,2016-01-04,ORLANDO_MAGIC,DETROIT_PISTONS,89,115,4458,26
4458,2016-01-05,2016-01-04,INDIANA_PACERS,MIAMI_HEAT,100,103,4459,3
4459,2016-01-05,2016-01-04,SAN_ANTONIO_SPURS,MILWAUKEE_BUCKS,123,98,4460,25
4460,2016-01-05,2016-01-04,SACRAMENTO_KINGS,OKLAHOMA_CITY_THUNDER,116,104,4461,12
4461,2016-01-05,2016-01-04,HOUSTON_ROCKETS,UTAH_JAZZ,93,91,4462,2
4462,2016-01-05,2016-01-04,MEMPHIS_GRIZZLIES,PORTLAND_TRAIL_BLAZERS,91,78,4463,13
4463,2016-01-05,2016-01-04,CHARLOTTE_HORNETS,GOLDEN_STATE_WARRIORS,101,111,4464,10
4464,2016-01-06,2016-01-05,NEW_YORK_KNICKS,ATLANTA_HAWKS,107,101,4465,6
4465,2016-01-06,2016-01-05,MILWAUKEE_BUCKS,CHICAGO_BULLS,106,117,4466,11
4466,2016-01-06,2016-01-05,SACRAMENTO_KINGS,DALLAS_MAVERICKS,116,117,4467,1
4467,2016-01-06,2016-01-05,GOLDEN_STATE_WARRIORS,LOS_ANGELES_LAKERS,109,88,4468,21
4468,2016-01-07,2016-01-06,NEW_YORK_KNICKS,MIAMI_HEAT,98,90,4469,8
4469,2016-01-07,2016-01-06,INDIANA_PACERS,ORLANDO_MAGIC,95,86,4470,9
4470,2016-01-07,2016-01-06,CLEVELAND_CAVALIERS,WASHINGTON_WIZARDS,121,115,4471,6
4471,2016-01-07,2016-01-06,DETROIT_PISTONS,BOSTON_CELTICS,99,94,4472,5
4472,2016-01-07,2016-01-06,TORONTO_RAPTORS,BROOKLYN_NETS,91,74,4473,17
4473,2016-01-07,2016-01-06,DENVER_NUGGETS,MINNESOTA_TIMBERWOLVES,78,74,4474,4
4474,2016-01-07,2016-01-06,DALLAS_MAVERICKS,NEW_ORLEANS_PELICANS,100,91,4475,9
4475,2016-01-07,2016-01-06,UTAH_JAZZ,SAN_ANTONIO_SPURS,98,123,4476,25
4476,2016-01-07,2016-01-06,CHARLOTTE_HORNETS,PHOENIX_SUNS,102,111,4477,9
4477,2016-01-07,2016-01-06,MEMPHIS_GRIZZLIES,OKLAHOMA_CITY_THUNDER,94,112,4478,18
4478,2016-01-07,2016-01-06,LOS_ANGELES_CLIPPERS,PORTLAND_TRAIL_BLAZERS,109,98,4479,11
4479,2016-01-08,2016-01-07,ATLANTA_HAWKS,PHILADELPHIA_76ERS,126,98,4480,28
4480,2016-01-08,2016-01-07,BOSTON_CELTICS,CHICAGO_BULLS,92,101,4481,9
4481,2016-01-08,2016-01-07,UTAH_JAZZ,HOUSTON_ROCKETS,94,103,4482,9
4482,2016-01-08,2016-01-07,LOS_ANGELES_LAKERS,SACRAMENTO_KINGS,115,118,4483,3
4483,2016-01-09,2016-01-08,TORONTO_RAPTORS,WASHINGTON_WIZARDS,97,88,4484,9
4484,2016-01-09,2016-01-08,ORLANDO_MAGIC,BROOKLYN_NETS,83,77,4485,6
4485,2016-01-09,2016-01-08,DENVER_NUGGETS,MEMPHIS_GRIZZLIES,84,91,4486,7
4486,2016-01-09,2016-01-08,DALLAS_MAVERICKS,MILWAUKEE_BUCKS,95,96,4487,1
4487,2016-01-09,2016-01-08,CLEVELAND_CAVALIERS,MINNESOTA_TIMBERWOLVES,125,99,4488,26
4488,2016-01-09,2016-01-08,INDIANA_PACERS,NEW_ORLEANS_PELICANS,91,86,4489,5
4489,2016-01-09,2016-01-08,NEW_YORK_KNICKS,SAN_ANTONIO_SPURS,99,100,4490,1
4490,2016-01-09,2016-01-08,MIAMI_HEAT,PHOENIX_SUNS,103,95,4491,8
4491,2016-01-09,2016-01-08,GOLDEN_STATE_WARRIORS,PORTLAND_TRAIL_BLAZERS,128,108,4492,20
4492,2016-01-09,2016-01-08,OKLAHOMA_CITY_THUNDER,LOS_ANGELES_LAKERS,117,113,4493,4
4493,2016-01-09,2016-01-08,CHARLOTTE_HORNETS,LOS_ANGELES_CLIPPERS,83,97,4494,14
4494,2016-01-09,2016-01-08,CHICAGO_BULLS,ATLANTA_HAWKS,105,120,4495,15
4495,2016-01-10,2016-01-09,WASHINGTON_WIZARDS,ORLANDO_MAGIC,105,99,4496,6
4496,2016-01-10,2016-01-09,BROOKLYN_NETS,DETROIT_PISTONS,89,103,4497,14
4497,2016-01-10,2016-01-09,TORONTO_RAPTORS,PHILADELPHIA_76ERS,108,95,4498,13
4498,2016-01-10,2016-01-09,MIAMI_HEAT,UTAH_JAZZ,83,98,4499,15
4499,2016-01-10,2016-01-09,GOLDEN_STATE_WARRIORS,SACRAMENTO_KINGS,128,116,4500,12
4500,2016-01-10,2016-01-09,NEW_ORLEANS_PELICANS,LOS_ANGELES_CLIPPERS,111,114,4501,3
4501,2016-01-10,2016-01-09,DALLAS_MAVERICKS,MINNESOTA_TIMBERWOLVES,93,87,4502,6
4502,2016-01-10,2016-01-09,BOSTON_CELTICS,MEMPHIS_GRIZZLIES,98,101,4503,3
4503,2016-01-10,2016-01-09,CLEVELAND_CAVALIERS,PHILADELPHIA_76ERS,95,85,4504,10
4504,2016-01-11,2016-01-10,INDIANA_PACERS,HOUSTON_ROCKETS,103,107,4505,4
4505,2016-01-11,2016-01-10,MILWAUKEE_BUCKS,NEW_YORK_KNICKS,88,100,4506,12
4506,2016-01-11,2016-01-10,CHARLOTTE_HORNETS,DENVER_NUGGETS,92,95,4507,3
4507,2016-01-11,2016-01-10,OKLAHOMA_CITY_THUNDER,PORTLAND_TRAIL_BLAZERS,110,115,4508,5
4508,2016-01-11,2016-01-10,UTAH_JAZZ,LOS_ANGELES_LAKERS,86,74,4509,12
4509,2016-01-12,2016-01-11,SAN_ANTONIO_SPURS,BROOKLYN_NETS,106,79,4510,27
4510,2016-01-12,2016-01-11,WASHINGTON_WIZARDS,CHICAGO_BULLS,114,100,4511,14
4511,2016-01-12,2016-01-11,MIAMI_HEAT,GOLDEN_STATE_WARRIORS,103,111,4512,8
4512,2016-01-13,2016-01-12,PHOENIX_SUNS,INDIANA_PACERS,97,116,4513,19
4513,2016-01-13,2016-01-12,SAN_ANTONIO_SPURS,DETROIT_PISTONS,109,99,4514,10
4514,2016-01-13,2016-01-12,BOSTON_CELTICS,NEW_YORK_KNICKS,114,120,4515,6
4515,2016-01-13,2016-01-12,HOUSTON_ROCKETS,MEMPHIS_GRIZZLIES,107,91,4516,16
4516,2016-01-13,2016-01-12,CHICAGO_BULLS,MILWAUKEE_BUCKS,101,106,4517,5
4517,2016-01-13,2016-01-12,OKLAHOMA_CITY_THUNDER,MINNESOTA_TIMBERWOLVES,101,96,4518,5
4518,2016-01-13,2016-01-12,CLEVELAND_CAVALIERS,DALLAS_MAVERICKS,110,107,4519,3
4519,2016-01-13,2016-01-12,NEW_ORLEANS_PELICANS,LOS_ANGELES_LAKERS,91,95,4520,4
4520,2016-01-14,2016-01-13,ATLANTA_HAWKS,CHARLOTTE_HORNETS,84,107,4521,23
4521,2016-01-14,2016-01-13,MILWAUKEE_BUCKS,WASHINGTON_WIZARDS,101,106,4522,5
4522,2016-01-14,2016-01-13,NEW_YORK_KNICKS,BROOKLYN_NETS,104,110,4523,6
4523,2016-01-14,2016-01-13,INDIANA_PACERS,BOSTON_CELTICS,94,103,4524,9
4524,2016-01-14,2016-01-13,MINNESOTA_TIMBERWOLVES,HOUSTON_ROCKETS,104,107,4525,3
4525,2016-01-14,2016-01-13,DALLAS_MAVERICKS,OKLAHOMA_CITY_THUNDER,89,108,4526,19
4526,2016-01-14,2016-01-13,GOLDEN_STATE_WARRIORS,DENVER_NUGGETS,110,112,4527,2
4527,2016-01-14,2016-01-13,UTAH_JAZZ,PORTLAND_TRAIL_BLAZERS,85,99,4528,14
4528,2016-01-14,2016-01-13,NEW_ORLEANS_PELICANS,SACRAMENTO_KINGS,109,97,4529,12
4529,2016-01-14,2016-01-13,MIAMI_HEAT,LOS_ANGELES_CLIPPERS,90,104,4530,14
4530,2016-01-14,2016-01-13,TORONTO_RAPTORS,ORLANDO_MAGIC,106,103,4531,3
4531,2016-01-15,2016-01-14,CHICAGO_BULLS,PHILADELPHIA_76ERS,115,111,4532,4
4532,2016-01-15,2016-01-14,DETROIT_PISTONS,MEMPHIS_GRIZZLIES,101,103,4533,2
4533,2016-01-15,2016-01-14,CLEVELAND_CAVALIERS,SAN_ANTONIO_SPURS,95,99,4534,4
4534,2016-01-15,2016-01-14,SACRAMENTO_KINGS,UTAH_JAZZ,103,101,4535,2
4535,2016-01-15,2016-01-14,LOS_ANGELES_LAKERS,GOLDEN_STATE_WARRIORS,98,116,4536,18
4536,2016-01-16,2016-01-15,WASHINGTON_WIZARDS,INDIANA_PACERS,118,104,4537,14
4537,2016-01-16,2016-01-15,MINNESOTA_TIMBERWOLVES,OKLAHOMA_CITY_THUNDER,93,113,4538,20
4538,2016-01-16,2016-01-15,PHOENIX_SUNS,BOSTON_CELTICS,103,117,4539,14
4539,2016-01-16,2016-01-15,PORTLAND_TRAIL_BLAZERS,BROOKLYN_NETS,116,104,4540,12
4540,2016-01-16,2016-01-15,DALLAS_MAVERICKS,CHICAGO_BULLS,83,77,4541,6
4541,2016-01-16,2016-01-15,ATLANTA_HAWKS,MILWAUKEE_BUCKS,101,108,4542,7
4542,2016-01-16,2016-01-15,CHARLOTTE_HORNETS,NEW_ORLEANS_PELICANS,107,109,4543,2
4543,2016-01-16,2016-01-15,MIAMI_HEAT,DENVER_NUGGETS,98,95,4544,3
4544,2016-01-16,2016-01-15,CLEVELAND_CAVALIERS,HOUSTON_ROCKETS,91,77,4545,14
4545,2016-01-17,2016-01-16,MILWAUKEE_BUCKS,CHARLOTTE_HORNETS,105,92,4546,13
4546,2016-01-17,2016-01-16,BROOKLYN_NETS,ATLANTA_HAWKS,86,114,4547,28
4547,2016-01-17,2016-01-16,GOLDEN_STATE_WARRIORS,DETROIT_PISTONS,95,113,4548,18
4548,2016-01-17,2016-01-16,PORTLAND_TRAIL_BLAZERS,PHILADELPHIA_76ERS,89,114,4549,25
4549,2016-01-17,2016-01-16,BOSTON_CELTICS,WASHINGTON_WIZARDS,119,117,4550,2
4550,2016-01-17,2016-01-16,NEW_YORK_KNICKS,MEMPHIS_GRIZZLIES,95,103,4551,8
4551,2016-01-17,2016-01-16,LOS_ANGELES_LAKERS,UTAH_JAZZ,82,109,4552,27
4552,2016-01-17,2016-01-16,SACRAMENTO_KINGS,LOS_ANGELES_CLIPPERS,110,103,4553,7
4553,2016-01-17,2016-01-16,PHOENIX_SUNS,MINNESOTA_TIMBERWOLVES,87,117,4554,30
4554,2016-01-18,2016-01-17,MIAMI_HEAT,OKLAHOMA_CITY_THUNDER,74,99,4555,25
4555,2016-01-18,2016-01-17,DALLAS_MAVERICKS,SAN_ANTONIO_SPURS,83,112,4556,29
4556,2016-01-18,2016-01-17,INDIANA_PACERS,DENVER_NUGGETS,126,129,4557,3
4557,2016-01-18,2016-01-17,HOUSTON_ROCKETS,LOS_ANGELES_LAKERS,112,95,4558,17
4558,2016-01-18,2016-01-17,PHILADELPHIA_76ERS,NEW_YORK_KNICKS,113,119,4559,6
4559,2016-01-18,2016-01-17,UTAH_JAZZ,CHARLOTTE_HORNETS,119,124,4560,5
4560,2016-01-18,2016-01-17,PORTLAND_TRAIL_BLAZERS,WASHINGTON_WIZARDS,108,98,4561,10
4561,2016-01-18,2016-01-17,NEW_ORLEANS_PELICANS,MEMPHIS_GRIZZLIES,99,101,4562,2
4562,2016-01-18,2016-01-17,CHICAGO_BULLS,DETROIT_PISTONS,111,101,4563,10
4563,2016-01-18,2016-01-17,ORLANDO_MAGIC,ATLANTA_HAWKS,81,98,4564,17
4564,2016-01-19,2016-01-18,BROOKLYN_NETS,TORONTO_RAPTORS,100,112,4565,12
4565,2016-01-19,2016-01-18,GOLDEN_STATE_WARRIORS,CLEVELAND_CAVALIERS,132,98,4566,34
4566,2016-01-19,2016-01-18,BOSTON_CELTICS,DALLAS_MAVERICKS,113,118,4567,5
4567,2016-01-19,2016-01-18,HOUSTON_ROCKETS,LOS_ANGELES_CLIPPERS,132,140,4568,8
4568,2016-01-20,2016-01-19,MILWAUKEE_BUCKS,MIAMI_HEAT,91,79,4569,12
4569,2016-01-20,2016-01-19,MINNESOTA_TIMBERWOLVES,NEW_ORLEANS_PELICANS,99,114,4570,15
4570,2016-01-20,2016-01-19,OKLAHOMA_CITY_THUNDER,DENVER_NUGGETS,110,104,4571,6
4571,2016-01-20,2016-01-19,INDIANA_PACERS,PHOENIX_SUNS,97,94,4572,3
4572,2016-01-21,2016-01-20,PHILADELPHIA_76ERS,ORLANDO_MAGIC,96,87,4573,9
4573,2016-01-21,2016-01-20,MIAMI_HEAT,WASHINGTON_WIZARDS,87,106,4574,19
4574,2016-01-21,2016-01-20,CLEVELAND_CAVALIERS,BROOKLYN_NETS,91,78,4575,13
4575,2016-01-21,2016-01-20,UTAH_JAZZ,NEW_YORK_KNICKS,111,118,4576,7
4576,2016-01-21,2016-01-20,BOSTON_CELTICS,TORONTO_RAPTORS,109,115,4577,6
4577,2016-01-21,2016-01-20,GOLDEN_STATE_WARRIORS,CHICAGO_BULLS,125,94,4578,31
4578,2016-01-21,2016-01-20,DETROIT_PISTONS,HOUSTON_ROCKETS,123,114,4579,9
4579,2016-01-21,2016-01-20,CHARLOTTE_HORNETS,OKLAHOMA_CITY_THUNDER,95,109,4580,14
4580,2016-01-21,2016-01-20,MINNESOTA_TIMBERWOLVES,DALLAS_MAVERICKS,94,106,4581,12
4581,2016-01-21,2016-01-20,SACRAMENTO_KINGS,LOS_ANGELES_LAKERS,112,93,4582,19
4582,2016-01-21,2016-01-20,ATLANTA_HAWKS,PORTLAND_TRAIL_BLAZERS,104,98,4583,6
4583,2016-01-22,2016-01-21,LOS_ANGELES_CLIPPERS,CLEVELAND_CAVALIERS,102,115,4584,13
4584,2016-01-22,2016-01-21,DETROIT_PISTONS,NEW_ORLEANS_PELICANS,99,115,4585,16
4585,2016-01-22,2016-01-21,MEMPHIS_GRIZZLIES,DENVER_NUGGETS,102,101,4586,1
4586,2016-01-22,2016-01-21,ATLANTA_HAWKS,SACRAMENTO_KINGS,88,91,4587,3
4587,2016-01-22,2016-01-21,SAN_ANTONIO_SPURS,PHOENIX_SUNS,117,89,4588,28
4588,2016-01-23,2016-01-22,CHARLOTTE_HORNETS,ORLANDO_MAGIC,120,116,4589,4
4589,2016-01-23,2016-01-22,CHICAGO_BULLS,BOSTON_CELTICS,101,110,4590,9
4590,2016-01-23,2016-01-22,UTAH_JAZZ,BROOKLYN_NETS,108,86,4591,22
4591,2016-01-23,2016-01-22,LOS_ANGELES_CLIPPERS,NEW_YORK_KNICKS,116,88,4592,28
4592,2016-01-23,2016-01-22,MILWAUKEE_BUCKS,HOUSTON_ROCKETS,98,102,4593,4
4593,2016-01-23,2016-01-22,MIAMI_HEAT,TORONTO_RAPTORS,81,101,4594,20
4594,2016-01-23,2016-01-22,OKLAHOMA_CITY_THUNDER,DALLAS_MAVERICKS,109,106,4595,3
4595,2016-01-23,2016-01-22,INDIANA_PACERS,GOLDEN_STATE_WARRIORS,110,122,4596,12
4596,2016-01-23,2016-01-22,SAN_ANTONIO_SPURS,LOS_ANGELES_LAKERS,108,95,4597,13
4597,2016-01-24,2016-01-23,NEW_YORK_KNICKS,CHARLOTTE_HORNETS,84,97,4598,13
4598,2016-01-24,2016-01-23,MILWAUKEE_BUCKS,NEW_ORLEANS_PELICANS,99,116,4599,17
4599,2016-01-24,2016-01-23,MEMPHIS_GRIZZLIES,MINNESOTA_TIMBERWOLVES,101,106,4600,5
4600,2016-01-24,2016-01-23,CHICAGO_BULLS,CLEVELAND_CAVALIERS,96,83,4601,13
4601,2016-01-24,2016-01-23,ATLANTA_HAWKS,PHOENIX_SUNS,95,98,4602,3
4602,2016-01-24,2016-01-23,DETROIT_PISTONS,DENVER_NUGGETS,101,104,4603,3
4603,2016-01-24,2016-01-23,LOS_ANGELES_LAKERS,PORTLAND_TRAIL_BLAZERS,103,121,4604,18
4604,2016-01-24,2016-01-23,INDIANA_PACERS,SACRAMENTO_KINGS,97,108,4605,11
4605,2016-01-24,2016-01-23,DALLAS_MAVERICKS,HOUSTON_ROCKETS,104,115,4606,11
4606,2016-01-24,2016-01-23,LOS_ANGELES_CLIPPERS,TORONTO_RAPTORS,94,112,4607,18
4607,2016-01-25,2016-01-24,BOSTON_CELTICS,PHILADELPHIA_76ERS,112,92,4608,20
4608,2016-01-25,2016-01-24,OKLAHOMA_CITY_THUNDER,BROOKLYN_NETS,106,116,4609,10
4609,2016-01-26,2016-01-25,MINNESOTA_TIMBERWOLVES,CLEVELAND_CAVALIERS,107,114,4610,7
4610,2016-01-26,2016-01-25,BOSTON_CELTICS,WASHINGTON_WIZARDS,116,91,4611,25
4611,2016-01-26,2016-01-25,MIAMI_HEAT,CHICAGO_BULLS,89,84,4612,5
4612,2016-01-26,2016-01-25,ORLANDO_MAGIC,MEMPHIS_GRIZZLIES,102,108,4613,6
4613,2016-01-26,2016-01-25,HOUSTON_ROCKETS,NEW_ORLEANS_PELICANS,112,111,4614,1
4614,2016-01-26,2016-01-25,ATLANTA_HAWKS,DENVER_NUGGETS,119,105,4615,14
4615,2016-01-26,2016-01-25,DETROIT_PISTONS,UTAH_JAZZ,95,92,4616,3
4616,2016-01-26,2016-01-25,CHARLOTTE_HORNETS,SACRAMENTO_KINGS,129,128,4617,1
4617,2016-01-26,2016-01-25,SAN_ANTONIO_SPURS,GOLDEN_STATE_WARRIORS,90,120,4618,30
4618,2016-01-27,2016-01-26,LOS_ANGELES_CLIPPERS,INDIANA_PACERS,91,89,4619,2
4619,2016-01-27,2016-01-26,PHOENIX_SUNS,PHILADELPHIA_76ERS,103,113,4620,10
4620,2016-01-27,2016-01-26,MIAMI_HEAT,BROOKLYN_NETS,102,98,4621,4
4621,2016-01-27,2016-01-26,OKLAHOMA_CITY_THUNDER,NEW_YORK_KNICKS,128,122,4622,6
4622,2016-01-27,2016-01-26,WASHINGTON_WIZARDS,TORONTO_RAPTORS,89,106,4623,17
4623,2016-01-27,2016-01-26,ORLANDO_MAGIC,MILWAUKEE_BUCKS,100,107,4624,7
4624,2016-01-27,2016-01-26,SACRAMENTO_KINGS,PORTLAND_TRAIL_BLAZERS,97,112,4625,15
4625,2016-01-27,2016-01-26,DALLAS_MAVERICKS,LOS_ANGELES_LAKERS,92,90,4626,2
4626,2016-01-28,2016-01-27,PHOENIX_SUNS,CLEVELAND_CAVALIERS,93,115,4627,22
4627,2016-01-28,2016-01-27,DENVER_NUGGETS,BOSTON_CELTICS,103,111,4628,8
4628,2016-01-28,2016-01-27,PHILADELPHIA_76ERS,DETROIT_PISTONS,97,110,4629,13
4629,2016-01-28,2016-01-27,LOS_ANGELES_CLIPPERS,ATLANTA_HAWKS,85,83,4630,2
4630,2016-01-28,2016-01-27,OKLAHOMA_CITY_THUNDER,MINNESOTA_TIMBERWOLVES,126,123,4631,3
4631,2016-01-28,2016-01-27,HOUSTON_ROCKETS,SAN_ANTONIO_SPURS,99,130,4632,31
4632,2016-01-28,2016-01-27,CHARLOTTE_HORNETS,UTAH_JAZZ,73,102,4633,29
4633,2016-01-28,2016-01-27,DALLAS_MAVERICKS,GOLDEN_STATE_WARRIORS,107,127,4634,20
4634,2016-01-29,2016-01-28,ATLANTA_HAWKS,INDIANA_PACERS,92,111,4635,19
4635,2016-01-29,2016-01-28,DENVER_NUGGETS,WASHINGTON_WIZARDS,117,113,4636,4
4636,2016-01-29,2016-01-28,MILWAUKEE_BUCKS,MEMPHIS_GRIZZLIES,83,103,4637,20
4637,2016-01-29,2016-01-28,SACRAMENTO_KINGS,NEW_ORLEANS_PELICANS,105,114,4638,9
4638,2016-01-29,2016-01-28,NEW_YORK_KNICKS,TORONTO_RAPTORS,93,103,4639,10
4639,2016-01-29,2016-01-28,CHICAGO_BULLS,LOS_ANGELES_LAKERS,114,91,4640,23
4640,2016-01-30,2016-01-29,ORLANDO_MAGIC,BOSTON_CELTICS,94,113,4641,19
4641,2016-01-30,2016-01-29,CLEVELAND_CAVALIERS,DETROIT_PISTONS,114,106,4642,8
4642,2016-01-30,2016-01-29,PHOENIX_SUNS,NEW_YORK_KNICKS,84,102,4643,18
4643,2016-01-30,2016-01-29,MIAMI_HEAT,MILWAUKEE_BUCKS,107,103,4644,4
4644,2016-01-30,2016-01-29,HOUSTON_ROCKETS,OKLAHOMA_CITY_THUNDER,108,116,4645,8
4645,2016-01-30,2016-01-29,BROOKLYN_NETS,DALLAS_MAVERICKS,79,91,4646,12
4646,2016-01-30,2016-01-29,MINNESOTA_TIMBERWOLVES,UTAH_JAZZ,90,103,4647,13
4647,2016-01-30,2016-01-29,CHARLOTTE_HORNETS,PORTLAND_TRAIL_BLAZERS,91,109,4648,18
4648,2016-01-30,2016-01-29,LOS_ANGELES_LAKERS,LOS_ANGELES_CLIPPERS,93,105,4649,12
4649,2016-01-30,2016-01-29,GOLDEN_STATE_WARRIORS,PHILADELPHIA_76ERS,108,105,4650,3
4650,2016-01-30,2016-01-29,DETROIT_PISTONS,TORONTO_RAPTORS,107,111,4651,4
4651,2016-01-31,2016-01-30,DENVER_NUGGETS,INDIANA_PACERS,105,109,4652,4
4652,2016-01-31,2016-01-30,BROOKLYN_NETS,NEW_ORLEANS_PELICANS,103,105,4653,2
4653,2016-01-31,2016-01-30,WASHINGTON_WIZARDS,HOUSTON_ROCKETS,123,122,4654,1
4654,2016-01-31,2016-01-30,SACRAMENTO_KINGS,MEMPHIS_GRIZZLIES,117,121,4655,4
4655,2016-01-31,2016-01-30,SAN_ANTONIO_SPURS,CLEVELAND_CAVALIERS,103,117,4656,14
4656,2016-01-31,2016-01-30,CHICAGO_BULLS,LOS_ANGELES_CLIPPERS,93,120,4657,27
4657,2016-01-31,2016-01-30,ATLANTA_HAWKS,MIAMI_HEAT,87,105,4658,18
4658,2016-01-31,2016-01-30,BOSTON_CELTICS,ORLANDO_MAGIC,114,119,4659,5
4659,2016-02-01,2016-01-31,PHOENIX_SUNS,DALLAS_MAVERICKS,78,91,4660,13
4660,2016-02-01,2016-01-31,GOLDEN_STATE_WARRIORS,NEW_YORK_KNICKS,116,95,4661,21
4661,2016-02-01,2016-01-31,MINNESOTA_TIMBERWOLVES,PORTLAND_TRAIL_BLAZERS,93,96,4662,3
4662,2016-02-01,2016-01-31,CHARLOTTE_HORNETS,LOS_ANGELES_LAKERS,101,82,4663,19
4663,2016-02-02,2016-02-01,CLEVELAND_CAVALIERS,INDIANA_PACERS,111,106,4664,5
4664,2016-02-02,2016-02-01,DETROIT_PISTONS,BROOKLYN_NETS,105,100,4665,5
4665,2016-02-02,2016-02-01,DALLAS_MAVERICKS,ATLANTA_HAWKS,97,112,4666,15
4666,2016-02-02,2016-02-01,MEMPHIS_GRIZZLIES,NEW_ORLEANS_PELICANS,110,95,4667,15
4667,2016-02-02,2016-02-01,WASHINGTON_WIZARDS,OKLAHOMA_CITY_THUNDER,98,114,4668,16
4668,2016-02-02,2016-02-01,ORLANDO_MAGIC,SAN_ANTONIO_SPURS,92,107,4669,15
4669,2016-02-02,2016-02-01,TORONTO_RAPTORS,DENVER_NUGGETS,93,112,4670,19
4670,2016-02-02,2016-02-01,CHICAGO_BULLS,UTAH_JAZZ,96,105,4671,9
4671,2016-02-02,2016-02-01,MILWAUKEE_BUCKS,SACRAMENTO_KINGS,104,111,4672,7
4672,2016-02-03,2016-02-02,BOSTON_CELTICS,NEW_YORK_KNICKS,97,89,4673,8
4673,2016-02-03,2016-02-02,MIAMI_HEAT,HOUSTON_ROCKETS,102,115,4674,13
4674,2016-02-03,2016-02-02,TORONTO_RAPTORS,PHOENIX_SUNS,104,97,4675,7
4675,2016-02-03,2016-02-02,MILWAUKEE_BUCKS,PORTLAND_TRAIL_BLAZERS,95,107,4676,12
4676,2016-02-03,2016-02-02,MINNESOTA_TIMBERWOLVES,LOS_ANGELES_LAKERS,115,119,4677,4
4677,2016-02-04,2016-02-03,CLEVELAND_CAVALIERS,CHARLOTTE_HORNETS,97,106,4678,9
4678,2016-02-04,2016-02-03,ATLANTA_HAWKS,PHILADELPHIA_76ERS,124,86,4679,38
4679,2016-02-04,2016-02-03,DETROIT_PISTONS,BOSTON_CELTICS,95,102,4680,7
4680,2016-02-04,2016-02-03,INDIANA_PACERS,BROOKLYN_NETS,114,100,4681,14
4681,2016-02-04,2016-02-03,ORLANDO_MAGIC,OKLAHOMA_CITY_THUNDER,114,117,4682,3
4682,2016-02-04,2016-02-03,GOLDEN_STATE_WARRIORS,WASHINGTON_WIZARDS,134,121,4683,13
4683,2016-02-04,2016-02-03,MIAMI_HEAT,DALLAS_MAVERICKS,93,90,4684,3
4684,2016-02-04,2016-02-03,NEW_ORLEANS_PELICANS,SAN_ANTONIO_SPURS,97,110,4685,13
4685,2016-02-04,2016-02-03,DENVER_NUGGETS,UTAH_JAZZ,81,85,4686,4
4686,2016-02-04,2016-02-03,CHICAGO_BULLS,SACRAMENTO_KINGS,107,102,4687,5
4687,2016-02-04,2016-02-03,MINNESOTA_TIMBERWOLVES,LOS_ANGELES_CLIPPERS,108,102,4688,6
4688,2016-02-05,2016-02-04,NEW_YORK_KNICKS,DETROIT_PISTONS,105,111,4689,6
4689,2016-02-05,2016-02-04,HOUSTON_ROCKETS,PHOENIX_SUNS,111,105,4690,6
4690,2016-02-05,2016-02-04,LOS_ANGELES_LAKERS,NEW_ORLEANS_PELICANS,99,96,4691,3
4691,2016-02-05,2016-02-04,TORONTO_RAPTORS,PORTLAND_TRAIL_BLAZERS,110,103,4692,7
4692,2016-02-06,2016-02-05,INDIANA_PACERS,ATLANTA_HAWKS,96,102,4693,6
4693,2016-02-06,2016-02-05,MIAMI_HEAT,CHARLOTTE_HORNETS,98,95,4694,3
4694,2016-02-06,2016-02-05,LOS_ANGELES_CLIPPERS,ORLANDO_MAGIC,107,93,4695,14
4695,2016-02-06,2016-02-05,PHILADELPHIA_76ERS,WASHINGTON_WIZARDS,94,106,4696,12
4696,2016-02-06,2016-02-05,SACRAMENTO_KINGS,BROOKLYN_NETS,119,128,4697,9
4697,2016-02-06,2016-02-05,BOSTON_CELTICS,CLEVELAND_CAVALIERS,104,103,4698,1
4698,2016-02-06,2016-02-05,MEMPHIS_GRIZZLIES,NEW_YORK_KNICKS,91,85,4699,6
4699,2016-02-06,2016-02-05,CHICAGO_BULLS,DENVER_NUGGETS,110,115,4700,5
4700,2016-02-06,2016-02-05,MILWAUKEE_BUCKS,UTAH_JAZZ,81,84,4701,3
4701,2016-02-06,2016-02-05,SAN_ANTONIO_SPURS,DALLAS_MAVERICKS,116,90,4702,26
4702,2016-02-06,2016-02-05,PORTLAND_TRAIL_BLAZERS,HOUSTON_ROCKETS,96,79,4703,17
4703,2016-02-07,2016-02-06,WASHINGTON_WIZARDS,CHARLOTTE_HORNETS,104,108,4704,4
4704,2016-02-07,2016-02-06,DETROIT_PISTONS,INDIANA_PACERS,104,112,4705,8
4705,2016-02-07,2016-02-06,NEW_ORLEANS_PELICANS,CLEVELAND_CAVALIERS,84,99,4706,15
4706,2016-02-07,2016-02-06,BROOKLYN_NETS,PHILADELPHIA_76ERS,98,103,4707,5
4707,2016-02-07,2016-02-06,DALLAS_MAVERICKS,MEMPHIS_GRIZZLIES,114,110,4708,4
4708,2016-02-07,2016-02-06,CHICAGO_BULLS,MINNESOTA_TIMBERWOLVES,105,112,4709,7
4709,2016-02-07,2016-02-06,LOS_ANGELES_LAKERS,SAN_ANTONIO_SPURS,102,106,4710,4
4710,2016-02-07,2016-02-06,OKLAHOMA_CITY_THUNDER,GOLDEN_STATE_WARRIORS,108,116,4711,8
4711,2016-02-07,2016-02-06,UTAH_JAZZ,PHOENIX_SUNS,98,89,4712,9
4712,2016-02-07,2016-02-06,SACRAMENTO_KINGS,BOSTON_CELTICS,119,128,4713,9
4713,2016-02-07,2016-02-06,DENVER_NUGGETS,NEW_YORK_KNICKS,101,96,4714,5
4714,2016-02-07,2016-02-06,ATLANTA_HAWKS,ORLANDO_MAGIC,94,96,4715,2
4715,2016-02-07,2016-02-06,LOS_ANGELES_CLIPPERS,MIAMI_HEAT,100,93,4716,7
4716,2016-02-09,2016-02-08,CHICAGO_BULLS,CHARLOTTE_HORNETS,91,108,4717,17
4717,2016-02-09,2016-02-08,SACRAMENTO_KINGS,CLEVELAND_CAVALIERS,100,120,4718,20
4718,2016-02-09,2016-02-08,LOS_ANGELES_LAKERS,INDIANA_PACERS,87,89,4719,2
4719,2016-02-09,2016-02-08,LOS_ANGELES_CLIPPERS,PHILADELPHIA_76ERS,98,92,4720,6
4720,2016-02-09,2016-02-08,DENVER_NUGGETS,BROOKLYN_NETS,104,105,4721,1
4721,2016-02-09,2016-02-08,TORONTO_RAPTORS,DETROIT_PISTONS,103,89,4722,14
4722,2016-02-09,2016-02-08,ORLANDO_MAGIC,ATLANTA_HAWKS,117,110,4723,7
4723,2016-02-09,2016-02-08,PORTLAND_TRAIL_BLAZERS,MEMPHIS_GRIZZLIES,112,106,4724,6
4724,2016-02-09,2016-02-08,NEW_ORLEANS_PELICANS,MINNESOTA_TIMBERWOLVES,116,102,4725,14
4725,2016-02-09,2016-02-08,OKLAHOMA_CITY_THUNDER,PHOENIX_SUNS,122,106,4726,16
4726,2016-02-10,2016-02-09,SAN_ANTONIO_SPURS,MIAMI_HEAT,119,101,4727,18
4727,2016-02-10,2016-02-09,BOSTON_CELTICS,MILWAUKEE_BUCKS,111,112,4728,1
4728,2016-02-10,2016-02-09,WASHINGTON_WIZARDS,NEW_YORK_KNICKS,111,108,4729,3
4729,2016-02-10,2016-02-09,UTAH_JAZZ,DALLAS_MAVERICKS,121,119,4730,2
4730,2016-02-10,2016-02-09,HOUSTON_ROCKETS,GOLDEN_STATE_WARRIORS,110,123,4731,13
4731,2016-02-11,2016-02-10,CHARLOTTE_HORNETS,INDIANA_PACERS,117,95,4732,22
4732,2016-02-11,2016-02-10,SAN_ANTONIO_SPURS,ORLANDO_MAGIC,98,96,4733,2
4733,2016-02-11,2016-02-10,SACRAMENTO_KINGS,PHILADELPHIA_76ERS,114,110,4734,4
4734,2016-02-11,2016-02-10,LOS_ANGELES_CLIPPERS,BOSTON_CELTICS,134,139,4735,5
4735,2016-02-11,2016-02-10,MEMPHIS_GRIZZLIES,BROOKLYN_NETS,109,90,4736,19
4736,2016-02-11,2016-02-10,DENVER_NUGGETS,DETROIT_PISTONS,103,92,4737,11
4737,2016-02-11,2016-02-10,ATLANTA_HAWKS,CHICAGO_BULLS,113,90,4738,23
4738,2016-02-11,2016-02-10,LOS_ANGELES_LAKERS,CLEVELAND_CAVALIERS,111,120,4739,9
4739,2016-02-11,2016-02-10,TORONTO_RAPTORS,MINNESOTA_TIMBERWOLVES,112,117,4740,5
4740,2016-02-11,2016-02-10,UTAH_JAZZ,NEW_ORLEANS_PELICANS,96,100,4741,4
4741,2016-02-11,2016-02-10,GOLDEN_STATE_WARRIORS,PHOENIX_SUNS,112,104,4742,8
4742,2016-02-11,2016-02-10,HOUSTON_ROCKETS,PORTLAND_TRAIL_BLAZERS,103,116,4743,13
4743,2016-02-12,2016-02-11,WASHINGTON_WIZARDS,MILWAUKEE_BUCKS,92,99,4744,7
4744,2016-02-12,2016-02-11,NEW_ORLEANS_PELICANS,OKLAHOMA_CITY_THUNDER,95,121,4745,26
4745,2016-02-19,2016-02-18,UTAH_JAZZ,WASHINGTON_WIZARDS,89,103,4746,14
4746,2016-02-19,2016-02-18,CHICAGO_BULLS,CLEVELAND_CAVALIERS,95,106,4747,11
4747,2016-02-19,2016-02-18,SAN_ANTONIO_SPURS,LOS_ANGELES_CLIPPERS,86,105,4748,19
4748,2016-02-20,2016-02-19,DALLAS_MAVERICKS,ORLANDO_MAGIC,104,110,4749,6
4749,2016-02-20,2016-02-19,DETROIT_PISTONS,WASHINGTON_WIZARDS,86,98,4750,12
4750,2016-02-20,2016-02-19,NEW_YORK_KNICKS,BROOKLYN_NETS,98,109,4751,11
4751,2016-02-20,2016-02-19,MIAMI_HEAT,ATLANTA_HAWKS,115,111,4752,4
4752,2016-02-20,2016-02-19,TORONTO_RAPTORS,CHICAGO_BULLS,106,116,4753,10
4753,2016-02-20,2016-02-19,MINNESOTA_TIMBERWOLVES,MEMPHIS_GRIZZLIES,104,109,4754,5
4754,2016-02-20,2016-02-19,CHARLOTTE_HORNETS,MILWAUKEE_BUCKS,98,95,4755,3
4755,2016-02-20,2016-02-19,PHILADELPHIA_76ERS,NEW_ORLEANS_PELICANS,114,121,4756,7
4756,2016-02-20,2016-02-19,INDIANA_PACERS,OKLAHOMA_CITY_THUNDER,101,98,4757,3
4757,2016-02-20,2016-02-19,HOUSTON_ROCKETS,PHOENIX_SUNS,116,100,4758,16
4758,2016-02-20,2016-02-19,GOLDEN_STATE_WARRIORS,PORTLAND_TRAIL_BLAZERS,105,137,4759,32
4759,2016-02-20,2016-02-19,DENVER_NUGGETS,SACRAMENTO_KINGS,110,116,4760,6
4760,2016-02-20,2016-02-19,SAN_ANTONIO_SPURS,LOS_ANGELES_LAKERS,119,113,4761,6
4761,2016-02-20,2016-02-19,BOSTON_CELTICS,UTAH_JAZZ,93,111,4762,18
4762,2016-02-21,2016-02-20,MILWAUKEE_BUCKS,ATLANTA_HAWKS,117,109,4763,8
4763,2016-02-21,2016-02-20,WASHINGTON_WIZARDS,MIAMI_HEAT,94,114,4764,20
4764,2016-02-21,2016-02-20,NEW_YORK_KNICKS,MINNESOTA_TIMBERWOLVES,103,95,4765,8
4765,2016-02-21,2016-02-20,GOLDEN_STATE_WARRIORS,LOS_ANGELES_CLIPPERS,115,112,4766,3
4766,2016-02-21,2016-02-20,NEW_ORLEANS_PELICANS,DETROIT_PISTONS,111,106,4767,5
4767,2016-02-21,2016-02-20,CLEVELAND_CAVALIERS,OKLAHOMA_CITY_THUNDER,115,92,4768,23
4768,2016-02-21,2016-02-20,BOSTON_CELTICS,DENVER_NUGGETS,121,101,4769,20
4769,2016-02-21,2016-02-20,SAN_ANTONIO_SPURS,PHOENIX_SUNS,118,111,4770,7
4770,2016-02-21,2016-02-20,CHARLOTTE_HORNETS,BROOKLYN_NETS,104,96,4771,8
4771,2016-02-21,2016-02-20,INDIANA_PACERS,ORLANDO_MAGIC,105,102,4772,3
4772,2016-02-21,2016-02-20,MEMPHIS_GRIZZLIES,TORONTO_RAPTORS,85,98,4773,13
4773,2016-02-22,2016-02-21,PHILADELPHIA_76ERS,DALLAS_MAVERICKS,103,129,4774,26
4774,2016-02-22,2016-02-21,LOS_ANGELES_LAKERS,CHICAGO_BULLS,115,126,4775,11
4775,2016-02-22,2016-02-21,UTAH_JAZZ,PORTLAND_TRAIL_BLAZERS,111,115,4776,4
4776,2016-02-23,2016-02-22,DETROIT_PISTONS,CLEVELAND_CAVALIERS,96,88,4777,8
4777,2016-02-23,2016-02-22,INDIANA_PACERS,MIAMI_HEAT,93,101,4778,8
4778,2016-02-23,2016-02-22,TORONTO_RAPTORS,NEW_YORK_KNICKS,122,95,4779,27
4779,2016-02-23,2016-02-22,GOLDEN_STATE_WARRIORS,ATLANTA_HAWKS,102,92,4780,10
4780,2016-02-23,2016-02-22,LOS_ANGELES_LAKERS,MILWAUKEE_BUCKS,101,108,4781,7
4781,2016-02-23,2016-02-22,BOSTON_CELTICS,MINNESOTA_TIMBERWOLVES,122,124,4782,2
4782,2016-02-23,2016-02-22,PHOENIX_SUNS,LOS_ANGELES_CLIPPERS,84,124,4783,40
4783,2016-02-24,2016-02-23,ORLANDO_MAGIC,PHILADELPHIA_76ERS,124,115,4784,9
4784,2016-02-24,2016-02-23,NEW_ORLEANS_PELICANS,WASHINGTON_WIZARDS,89,109,4785,20
4785,2016-02-24,2016-02-23,SACRAMENTO_KINGS,DENVER_NUGGETS,114,110,4786,4
4786,2016-02-24,2016-02-23,HOUSTON_ROCKETS,UTAH_JAZZ,114,117,4787,3
4787,2016-02-24,2016-02-23,BROOKLYN_NETS,PORTLAND_TRAIL_BLAZERS,104,112,4788,8
4788,2016-02-25,2016-02-24,CHARLOTTE_HORNETS,CLEVELAND_CAVALIERS,103,114,4789,11
4789,2016-02-25,2016-02-24,NEW_YORK_KNICKS,INDIANA_PACERS,105,108,4790,3
4790,2016-02-25,2016-02-24,PHILADELPHIA_76ERS,DETROIT_PISTONS,91,111,4791,20
4791,2016-02-25,2016-02-24,GOLDEN_STATE_WARRIORS,MIAMI_HEAT,118,112,4792,6
4792,2016-02-25,2016-02-24,MINNESOTA_TIMBERWOLVES,TORONTO_RAPTORS,105,114,4793,9
4793,2016-02-25,2016-02-24,WASHINGTON_WIZARDS,CHICAGO_BULLS,104,109,4794,5
4794,2016-02-25,2016-02-24,LOS_ANGELES_LAKERS,MEMPHIS_GRIZZLIES,119,128,4795,9
4795,2016-02-25,2016-02-24,OKLAHOMA_CITY_THUNDER,DALLAS_MAVERICKS,116,103,4796,13
4796,2016-02-25,2016-02-24,DENVER_NUGGETS,LOS_ANGELES_CLIPPERS,87,81,4797,6
4797,2016-02-25,2016-02-24,SAN_ANTONIO_SPURS,SACRAMENTO_KINGS,108,92,4798,16
4798,2016-02-26,2016-02-25,GOLDEN_STATE_WARRIORS,ORLANDO_MAGIC,130,114,4799,16
4799,2016-02-26,2016-02-25,MILWAUKEE_BUCKS,BOSTON_CELTICS,107,112,4800,5
4800,2016-02-26,2016-02-25,OKLAHOMA_CITY_THUNDER,NEW_ORLEANS_PELICANS,119,123,4801,4
4801,2016-02-26,2016-02-25,BROOKLYN_NETS,PHOENIX_SUNS,116,106,4802,10
4802,2016-02-26,2016-02-25,HOUSTON_ROCKETS,PORTLAND_TRAIL_BLAZERS,119,105,4803,14
4803,2016-02-26,2016-02-25,SAN_ANTONIO_SPURS,UTAH_JAZZ,96,78,4804,18
4804,2016-02-27,2016-02-26,CHARLOTTE_HORNETS,INDIANA_PACERS,96,95,4805,1
4805,2016-02-27,2016-02-26,WASHINGTON_WIZARDS,PHILADELPHIA_76ERS,103,94,4806,9
4806,2016-02-27,2016-02-26,ORLANDO_MAGIC,NEW_YORK_KNICKS,95,108,4807,13
4807,2016-02-27,2016-02-26,CLEVELAND_CAVALIERS,TORONTO_RAPTORS,97,99,4808,2
4808,2016-02-27,2016-02-26,CHICAGO_BULLS,ATLANTA_HAWKS,88,103,4809,15
4809,2016-02-27,2016-02-26,DENVER_NUGGETS,DALLAS_MAVERICKS,116,122,4810,6
4810,2016-02-27,2016-02-26,LOS_ANGELES_CLIPPERS,SACRAMENTO_KINGS,117,107,4811,10
4811,2016-02-27,2016-02-26,MEMPHIS_GRIZZLIES,LOS_ANGELES_LAKERS,112,95,4812,17
4812,2016-02-27,2016-02-26,MIAMI_HEAT,BOSTON_CELTICS,89,101,4813,12
4813,2016-02-28,2016-02-27,MINNESOTA_TIMBERWOLVES,NEW_ORLEANS_PELICANS,112,110,4814,2
4814,2016-02-28,2016-02-27,PORTLAND_TRAIL_BLAZERS,CHICAGO_BULLS,103,95,4815,8
4815,2016-02-28,2016-02-27,SAN_ANTONIO_SPURS,HOUSTON_ROCKETS,104,94,4816,10
4816,2016-02-28,2016-02-27,DETROIT_PISTONS,MILWAUKEE_BUCKS,102,91,4817,11
4817,2016-02-28,2016-02-27,GOLDEN_STATE_WARRIORS,OKLAHOMA_CITY_THUNDER,121,118,4818,3
4818,2016-02-28,2016-02-27,MEMPHIS_GRIZZLIES,PHOENIX_SUNS,106,111,4819,5
4819,2016-02-28,2016-02-27,BROOKLYN_NETS,UTAH_JAZZ,98,96,4820,2
4820,2016-02-28,2016-02-27,CLEVELAND_CAVALIERS,WASHINGTON_WIZARDS,99,113,4821,14
4821,2016-02-28,2016-02-27,CHARLOTTE_HORNETS,ATLANTA_HAWKS,76,87,4822,11
4822,2016-02-28,2016-02-27,TORONTO_RAPTORS,DETROIT_PISTONS,101,114,4823,13
4823,2016-02-28,2016-02-27,PORTLAND_TRAIL_BLAZERS,INDIANA_PACERS,111,102,4824,9
4824,2016-02-28,2016-02-27,PHILADELPHIA_76ERS,ORLANDO_MAGIC,116,130,4825,14
4825,2016-02-29,2016-02-28,MINNESOTA_TIMBERWOLVES,DALLAS_MAVERICKS,101,128,4826,27
4826,2016-02-29,2016-02-28,MIAMI_HEAT,NEW_YORK_KNICKS,98,81,4827,17
4827,2016-03-01,2016-02-29,INDIANA_PACERS,CLEVELAND_CAVALIERS,96,100,4828,4
4828,2016-03-01,2016-02-29,PHILADELPHIA_76ERS,WASHINGTON_WIZARDS,108,116,4829,8
4829,2016-03-01,2016-02-29,UTAH_JAZZ,BOSTON_CELTICS,95,100,4830,5
4830,2016-03-01,2016-02-29,HOUSTON_ROCKETS,MILWAUKEE_BUCKS,121,128,4831,7
4831,2016-03-01,2016-02-29,MEMPHIS_GRIZZLIES,DENVER_NUGGETS,103,96,4832,7
4832,2016-03-01,2016-02-29,OKLAHOMA_CITY_THUNDER,SACRAMENTO_KINGS,131,116,4833,15
4833,2016-03-01,2016-02-29,BROOKLYN_NETS,LOS_ANGELES_CLIPPERS,95,105,4834,10
4834,2016-03-02,2016-03-01,PHOENIX_SUNS,CHARLOTTE_HORNETS,92,126,4835,34
4835,2016-03-02,2016-03-01,CHICAGO_BULLS,MIAMI_HEAT,111,129,4836,18
4836,2016-03-02,2016-03-01,PORTLAND_TRAIL_BLAZERS,NEW_YORK_KNICKS,104,85,4837,19
4837,2016-03-02,2016-03-01,ORLANDO_MAGIC,DALLAS_MAVERICKS,108,121,4838,13
4838,2016-03-02,2016-03-01,ATLANTA_HAWKS,GOLDEN_STATE_WARRIORS,105,109,4839,4
4839,2016-03-02,2016-03-01,BROOKLYN_NETS,LOS_ANGELES_LAKERS,101,107,4840,6
4840,2016-03-03,2016-03-02,CHICAGO_BULLS,ORLANDO_MAGIC,89,102,4841,13
4841,2016-03-03,2016-03-02,CHARLOTTE_HORNETS,PHILADELPHIA_76ERS,119,99,4842,20
4842,2016-03-03,2016-03-02,PORTLAND_TRAIL_BLAZERS,BOSTON_CELTICS,93,116,4843,23
4843,2016-03-03,2016-03-02,UTAH_JAZZ,TORONTO_RAPTORS,94,104,4844,10
4844,2016-03-03,2016-03-02,NEW_ORLEANS_PELICANS,HOUSTON_ROCKETS,95,100,4845,5
4845,2016-03-03,2016-03-02,SACRAMENTO_KINGS,MEMPHIS_GRIZZLIES,98,104,4846,6
4846,2016-03-03,2016-03-02,INDIANA_PACERS,MILWAUKEE_BUCKS,104,99,4847,5
4847,2016-03-03,2016-03-02,WASHINGTON_WIZARDS,MINNESOTA_TIMBERWOLVES,104,98,4848,6
4848,2016-03-03,2016-03-02,DETROIT_PISTONS,SAN_ANTONIO_SPURS,81,97,4849,16
4849,2016-03-03,2016-03-02,LOS_ANGELES_LAKERS,DENVER_NUGGETS,107,117,4850,10
4850,2016-03-03,2016-03-02,OKLAHOMA_CITY_THUNDER,LOS_ANGELES_CLIPPERS,98,103,4851,5
4851,2016-03-04,2016-03-03,PHOENIX_SUNS,MIAMI_HEAT,92,108,4852,16
4852,2016-03-04,2016-03-03,SAN_ANTONIO_SPURS,NEW_ORLEANS_PELICANS,94,86,4853,8
4853,2016-03-04,2016-03-03,SACRAMENTO_KINGS,DALLAS_MAVERICKS,104,101,4854,3
4854,2016-03-04,2016-03-03,OKLAHOMA_CITY_THUNDER,GOLDEN_STATE_WARRIORS,106,121,4855,15
4855,2016-03-05,2016-03-04,INDIANA_PACERS,CHARLOTTE_HORNETS,101,108,4856,7
4856,2016-03-05,2016-03-04,PHOENIX_SUNS,ORLANDO_MAGIC,102,84,4857,18
4857,2016-03-05,2016-03-04,MIAMI_HEAT,PHILADELPHIA_76ERS,112,102,4858,10
4858,2016-03-05,2016-03-04,NEW_YORK_KNICKS,BOSTON_CELTICS,104,105,4859,1
4859,2016-03-05,2016-03-04,PORTLAND_TRAIL_BLAZERS,TORONTO_RAPTORS,115,117,4860,2
4860,2016-03-05,2016-03-04,WASHINGTON_WIZARDS,CLEVELAND_CAVALIERS,83,108,4861,25
4861,2016-03-05,2016-03-04,UTAH_JAZZ,MEMPHIS_GRIZZLIES,88,94,4862,6
4862,2016-03-05,2016-03-04,MINNESOTA_TIMBERWOLVES,MILWAUKEE_BUCKS,101,116,4863,15
4863,2016-03-05,2016-03-04,BROOKLYN_NETS,DENVER_NUGGETS,121,120,4864,1
4864,2016-03-05,2016-03-04,ATLANTA_HAWKS,LOS_ANGELES_LAKERS,106,77,4865,29
4865,2016-03-06,2016-03-05,BOSTON_CELTICS,CLEVELAND_CAVALIERS,103,120,4866,17
4866,2016-03-06,2016-03-05,UTAH_JAZZ,NEW_ORLEANS_PELICANS,106,94,4867,12
4867,2016-03-06,2016-03-05,DETROIT_PISTONS,NEW_YORK_KNICKS,89,102,4868,13
4868,2016-03-06,2016-03-05,INDIANA_PACERS,WASHINGTON_WIZARDS,100,99,4869,1
4869,2016-03-06,2016-03-05,BROOKLYN_NETS,MINNESOTA_TIMBERWOLVES,118,132,4870,14
4870,2016-03-06,2016-03-05,HOUSTON_ROCKETS,CHICAGO_BULLS,100,108,4871,8
4871,2016-03-06,2016-03-05,SACRAMENTO_KINGS,SAN_ANTONIO_SPURS,94,104,4872,10
4872,2016-03-06,2016-03-05,ATLANTA_HAWKS,LOS_ANGELES_CLIPPERS,107,97,4873,10
4873,2016-03-06,2016-03-05,GOLDEN_STATE_WARRIORS,LOS_ANGELES_LAKERS,95,112,4874,17
4874,2016-03-06,2016-03-05,OKLAHOMA_CITY_THUNDER,MILWAUKEE_BUCKS,104,96,4875,8
4875,2016-03-06,2016-03-05,PHOENIX_SUNS,MEMPHIS_GRIZZLIES,109,100,4876,9
4876,2016-03-06,2016-03-05,DALLAS_MAVERICKS,DENVER_NUGGETS,114,116,4877,2
4877,2016-03-06,2016-03-05,PORTLAND_TRAIL_BLAZERS,DETROIT_PISTONS,103,123,4878,20
4878,2016-03-06,2016-03-05,PHILADELPHIA_76ERS,MIAMI_HEAT,98,103,4879,5
4879,2016-03-06,2016-03-05,HOUSTON_ROCKETS,TORONTO_RAPTORS,113,107,4880,6
4880,2016-03-08,2016-03-07,MINNESOTA_TIMBERWOLVES,CHARLOTTE_HORNETS,103,108,4881,5
4881,2016-03-08,2016-03-07,MEMPHIS_GRIZZLIES,CLEVELAND_CAVALIERS,106,103,4882,3
4882,2016-03-08,2016-03-07,SAN_ANTONIO_SPURS,INDIANA_PACERS,91,99,4883,8
4883,2016-03-08,2016-03-07,MILWAUKEE_BUCKS,CHICAGO_BULLS,90,100,4884,10
4884,2016-03-08,2016-03-07,SACRAMENTO_KINGS,NEW_ORLEANS_PELICANS,112,115,4885,3
4885,2016-03-08,2016-03-07,LOS_ANGELES_CLIPPERS,DALLAS_MAVERICKS,109,90,4886,19
4886,2016-03-08,2016-03-07,ORLANDO_MAGIC,GOLDEN_STATE_WARRIORS,113,119,4887,6
4887,2016-03-09,2016-03-08,BROOKLYN_NETS,TORONTO_RAPTORS,99,104,4888,5
4888,2016-03-09,2016-03-08,SAN_ANTONIO_SPURS,MINNESOTA_TIMBERWOLVES,116,91,4889,25
4889,2016-03-09,2016-03-08,NEW_YORK_KNICKS,DENVER_NUGGETS,94,110,4890,16
4890,2016-03-09,2016-03-08,ATLANTA_HAWKS,UTAH_JAZZ,91,84,4891,7
4891,2016-03-09,2016-03-08,WASHINGTON_WIZARDS,PORTLAND_TRAIL_BLAZERS,109,116,4892,7
4892,2016-03-09,2016-03-08,ORLANDO_MAGIC,LOS_ANGELES_LAKERS,98,107,4893,9
4893,2016-03-10,2016-03-09,MEMPHIS_GRIZZLIES,BOSTON_CELTICS,96,116,4894,20
4894,2016-03-10,2016-03-09,NEW_ORLEANS_PELICANS,CHARLOTTE_HORNETS,113,122,4895,9
4895,2016-03-10,2016-03-09,HOUSTON_ROCKETS,PHILADELPHIA_76ERS,118,104,4896,14
4896,2016-03-10,2016-03-09,MIAMI_HEAT,MILWAUKEE_BUCKS,108,114,4897,6
4897,2016-03-10,2016-03-09,DETROIT_PISTONS,DALLAS_MAVERICKS,102,96,4898,6
4898,2016-03-10,2016-03-09,NEW_YORK_KNICKS,PHOENIX_SUNS,128,97,4899,31
4899,2016-03-10,2016-03-09,LOS_ANGELES_CLIPPERS,OKLAHOMA_CITY_THUNDER,108,120,4900,12
4900,2016-03-10,2016-03-09,CLEVELAND_CAVALIERS,SACRAMENTO_KINGS,120,111,4901,9
4901,2016-03-10,2016-03-09,UTAH_JAZZ,GOLDEN_STATE_WARRIORS,94,115,4902,21
4902,2016-03-11,2016-03-10,ATLANTA_HAWKS,TORONTO_RAPTORS,96,104,4903,8
4903,2016-03-11,2016-03-10,CHICAGO_BULLS,SAN_ANTONIO_SPURS,101,109,4904,8
4904,2016-03-11,2016-03-10,PHOENIX_SUNS,DENVER_NUGGETS,98,116,4905,18
4905,2016-03-11,2016-03-10,CLEVELAND_CAVALIERS,LOS_ANGELES_LAKERS,120,108,4906,12
4906,2016-03-12,2016-03-11,DETROIT_PISTONS,CHARLOTTE_HORNETS,103,118,4907,15
4907,2016-03-12,2016-03-11,BROOKLYN_NETS,PHILADELPHIA_76ERS,89,95,4908,6
4908,2016-03-12,2016-03-11,HOUSTON_ROCKETS,BOSTON_CELTICS,102,98,4909,4
4909,2016-03-12,2016-03-11,MIAMI_HEAT,CHICAGO_BULLS,118,96,4910,22
4910,2016-03-12,2016-03-11,NEW_ORLEANS_PELICANS,MEMPHIS_GRIZZLIES,114,121,4911,7
4911,2016-03-12,2016-03-11,MINNESOTA_TIMBERWOLVES,OKLAHOMA_CITY_THUNDER,99,96,4912,3
4912,2016-03-12,2016-03-11,WASHINGTON_WIZARDS,UTAH_JAZZ,93,114,4913,21
4913,2016-03-12,2016-03-11,ORLANDO_MAGIC,SACRAMENTO_KINGS,107,100,4914,7
4914,2016-03-12,2016-03-11,PORTLAND_TRAIL_BLAZERS,GOLDEN_STATE_WARRIORS,112,128,4915,16
4915,2016-03-12,2016-03-11,NEW_YORK_KNICKS,LOS_ANGELES_CLIPPERS,94,101,4916,7
4916,2016-03-12,2016-03-11,INDIANA_PACERS,DALLAS_MAVERICKS,112,105,4917,7
4917,2016-03-13,2016-03-12,HOUSTON_ROCKETS,CHARLOTTE_HORNETS,109,125,4918,16
4918,2016-03-13,2016-03-12,DETROIT_PISTONS,PHILADELPHIA_76ERS,125,111,4919,14
4919,2016-03-13,2016-03-12,MIAMI_HEAT,TORONTO_RAPTORS,104,112,4920,8
4920,2016-03-13,2016-03-12,MEMPHIS_GRIZZLIES,ATLANTA_HAWKS,83,95,4921,12
4921,2016-03-13,2016-03-12,NEW_ORLEANS_PELICANS,MILWAUKEE_BUCKS,92,103,4922,11
4922,2016-03-13,2016-03-12,OKLAHOMA_CITY_THUNDER,SAN_ANTONIO_SPURS,85,93,4923,8
4923,2016-03-13,2016-03-12,WASHINGTON_WIZARDS,DENVER_NUGGETS,100,116,4924,16
4924,2016-03-13,2016-03-12,PHOENIX_SUNS,GOLDEN_STATE_WARRIORS,116,123,4925,7
4925,2016-03-13,2016-03-12,ORLANDO_MAGIC,PORTLAND_TRAIL_BLAZERS,84,121,4926,37
4926,2016-03-13,2016-03-12,CLEVELAND_CAVALIERS,LOS_ANGELES_CLIPPERS,114,90,4927,24
4927,2016-03-13,2016-03-12,INDIANA_PACERS,ATLANTA_HAWKS,75,104,4928,29
4928,2016-03-13,2016-03-12,UTAH_JAZZ,SACRAMENTO_KINGS,108,99,4929,9
4929,2016-03-14,2016-03-13,MILWAUKEE_BUCKS,BROOKLYN_NETS,109,100,4930,9
4930,2016-03-14,2016-03-13,NEW_YORK_KNICKS,LOS_ANGELES_LAKERS,90,87,4931,3
4931,2016-03-14,2016-03-13,DALLAS_MAVERICKS,CHARLOTTE_HORNETS,107,96,4932,11
4932,2016-03-14,2016-03-13,DENVER_NUGGETS,MIAMI_HEAT,119,124,4933,5
4933,2016-03-14,2016-03-13,CHICAGO_BULLS,TORONTO_RAPTORS,109,107,4934,2
4934,2016-03-15,2016-03-14,MEMPHIS_GRIZZLIES,HOUSTON_ROCKETS,81,130,4935,49
4935,2016-03-15,2016-03-14,PORTLAND_TRAIL_BLAZERS,OKLAHOMA_CITY_THUNDER,94,128,4936,34
4936,2016-03-15,2016-03-14,DETROIT_PISTONS,WASHINGTON_WIZARDS,81,124,4937,43
4937,2016-03-15,2016-03-14,MINNESOTA_TIMBERWOLVES,PHOENIX_SUNS,104,107,4938,3
4938,2016-03-15,2016-03-14,NEW_ORLEANS_PELICANS,GOLDEN_STATE_WARRIORS,107,125,4939,18
4939,2016-03-15,2016-03-14,CLEVELAND_CAVALIERS,UTAH_JAZZ,85,94,4940,9
4940,2016-03-15,2016-03-14,BOSTON_CELTICS,INDIANA_PACERS,98,103,4941,5
4941,2016-03-15,2016-03-14,DENVER_NUGGETS,ORLANDO_MAGIC,110,116,4942,6
4942,2016-03-15,2016-03-14,PHILADELPHIA_76ERS,BROOKLYN_NETS,114,131,4943,17
4943,2016-03-16,2016-03-15,TORONTO_RAPTORS,MILWAUKEE_BUCKS,107,89,4944,18
4944,2016-03-16,2016-03-15,LOS_ANGELES_CLIPPERS,SAN_ANTONIO_SPURS,87,108,4945,21
4945,2016-03-16,2016-03-15,SACRAMENTO_KINGS,LOS_ANGELES_LAKERS,106,98,4946,8
4946,2016-03-16,2016-03-15,OKLAHOMA_CITY_THUNDER,BOSTON_CELTICS,130,109,4947,21
4947,2016-03-16,2016-03-15,ORLANDO_MAGIC,CHARLOTTE_HORNETS,99,107,4948,8
4948,2016-03-16,2016-03-15,DALLAS_MAVERICKS,CLEVELAND_CAVALIERS,98,99,4949,1
4949,2016-03-16,2016-03-15,CHICAGO_BULLS,WASHINGTON_WIZARDS,96,117,4950,21
4950,2016-03-16,2016-03-15,ATLANTA_HAWKS,DETROIT_PISTONS,118,114,4951,4
4951,2016-03-17,2016-03-16,MINNESOTA_TIMBERWOLVES,MEMPHIS_GRIZZLIES,114,108,4952,6
4952,2016-03-17,2016-03-16,LOS_ANGELES_CLIPPERS,HOUSTON_ROCKETS,122,106,4953,16
4953,2016-03-17,2016-03-16,NEW_ORLEANS_PELICANS,SACRAMENTO_KINGS,123,108,4954,15
4954,2016-03-17,2016-03-16,NEW_YORK_KNICKS,GOLDEN_STATE_WARRIORS,85,121,4955,36
4955,2016-03-17,2016-03-16,TORONTO_RAPTORS,INDIANA_PACERS,101,94,4956,7
4956,2016-03-17,2016-03-16,WASHINGTON_WIZARDS,PHILADELPHIA_76ERS,99,94,4957,5
4957,2016-03-17,2016-03-16,CHARLOTTE_HORNETS,MIAMI_HEAT,109,106,4958,3
4958,2016-03-18,2016-03-17,DENVER_NUGGETS,ATLANTA_HAWKS,98,116,4959,18
4959,2016-03-18,2016-03-17,BROOKLYN_NETS,CHICAGO_BULLS,102,118,4960,16
4960,2016-03-18,2016-03-17,MEMPHIS_GRIZZLIES,MILWAUKEE_BUCKS,86,96,4961,10
4961,2016-03-18,2016-03-17,PORTLAND_TRAIL_BLAZERS,SAN_ANTONIO_SPURS,110,118,4962,8
4962,2016-03-18,2016-03-17,PHOENIX_SUNS,UTAH_JAZZ,69,103,4963,34
4963,2016-03-18,2016-03-17,CLEVELAND_CAVALIERS,ORLANDO_MAGIC,109,103,4964,6
4964,2016-03-18,2016-03-17,OKLAHOMA_CITY_THUNDER,PHILADELPHIA_76ERS,111,97,4965,14
4965,2016-03-18,2016-03-17,SACRAMENTO_KINGS,DETROIT_PISTONS,108,115,4966,7
4966,2016-03-18,2016-03-17,BOSTON_CELTICS,TORONTO_RAPTORS,91,105,4967,14
4967,2016-03-19,2016-03-18,MINNESOTA_TIMBERWOLVES,HOUSTON_ROCKETS,111,116,4968,5
4968,2016-03-19,2016-03-18,PORTLAND_TRAIL_BLAZERS,NEW_ORLEANS_PELICANS,117,112,4969,5
4969,2016-03-19,2016-03-18,GOLDEN_STATE_WARRIORS,DALLAS_MAVERICKS,130,112,4970,18
4970,2016-03-19,2016-03-18,PHOENIX_SUNS,LOS_ANGELES_LAKERS,95,90,4971,5
4971,2016-03-19,2016-03-18,DENVER_NUGGETS,CHARLOTTE_HORNETS,101,93,4972,8
4972,2016-03-19,2016-03-18,BROOKLYN_NETS,DETROIT_PISTONS,103,115,4973,12
4973,2016-03-19,2016-03-18,OKLAHOMA_CITY_THUNDER,INDIANA_PACERS,115,111,4974,4
4974,2016-03-19,2016-03-18,NEW_YORK_KNICKS,WASHINGTON_WIZARDS,89,99,4975,10
4975,2016-03-19,2016-03-18,HOUSTON_ROCKETS,ATLANTA_HAWKS,97,109,4976,12
4976,2016-03-19,2016-03-18,CLEVELAND_CAVALIERS,MIAMI_HEAT,101,122,4977,21
4977,2016-03-20,2016-03-19,UTAH_JAZZ,CHICAGO_BULLS,85,92,4978,7
4978,2016-03-20,2016-03-19,LOS_ANGELES_CLIPPERS,MEMPHIS_GRIZZLIES,102,113,4979,11
4979,2016-03-20,2016-03-19,GOLDEN_STATE_WARRIORS,SAN_ANTONIO_SPURS,79,87,4980,8
4980,2016-03-20,2016-03-19,PORTLAND_TRAIL_BLAZERS,DALLAS_MAVERICKS,120,132,4981,12
4981,2016-03-20,2016-03-19,ORLANDO_MAGIC,TORONTO_RAPTORS,100,105,4982,5
4982,2016-03-20,2016-03-19,LOS_ANGELES_CLIPPERS,NEW_ORLEANS_PELICANS,105,109,4983,4
4983,2016-03-20,2016-03-19,BOSTON_CELTICS,PHILADELPHIA_76ERS,120,105,4984,15
4984,2016-03-20,2016-03-19,UTAH_JAZZ,MILWAUKEE_BUCKS,94,85,4985,9
4985,2016-03-20,2016-03-19,SACRAMENTO_KINGS,NEW_YORK_KNICKS,88,80,4986,8
4986,2016-03-21,2016-03-20,SAN_ANTONIO_SPURS,CHARLOTTE_HORNETS,88,91,4987,3
4987,2016-03-21,2016-03-20,DENVER_NUGGETS,CLEVELAND_CAVALIERS,91,124,4988,33
4988,2016-03-21,2016-03-20,PHILADELPHIA_76ERS,INDIANA_PACERS,75,91,4989,16
4989,2016-03-21,2016-03-20,ORLANDO_MAGIC,BOSTON_CELTICS,96,107,4990,11
4990,2016-03-21,2016-03-20,MILWAUKEE_BUCKS,DETROIT_PISTONS,91,92,4991,1
4991,2016-03-22,2016-03-21,WASHINGTON_WIZARDS,ATLANTA_HAWKS,117,102,4992,15
4992,2016-03-22,2016-03-21,SACRAMENTO_KINGS,CHICAGO_BULLS,102,109,4993,7
4993,2016-03-22,2016-03-21,GOLDEN_STATE_WARRIORS,MINNESOTA_TIMBERWOLVES,109,104,4994,5
4994,2016-03-22,2016-03-21,MEMPHIS_GRIZZLIES,PHOENIX_SUNS,103,97,4995,6
4995,2016-03-22,2016-03-21,CHARLOTTE_HORNETS,BROOKLYN_NETS,105,100,4996,5
4996,2016-03-23,2016-03-22,MIAMI_HEAT,NEW_ORLEANS_PELICANS,113,99,4997,14
4997,2016-03-23,2016-03-22,HOUSTON_ROCKETS,OKLAHOMA_CITY_THUNDER,107,111,4998,4
4998,2016-03-23,2016-03-22,MEMPHIS_GRIZZLIES,LOS_ANGELES_LAKERS,100,107,4999,7
4999,2016-03-23,2016-03-22,MILWAUKEE_BUCKS,CLEVELAND_CAVALIERS,104,113,5000,9
5000,2016-03-23,2016-03-22,ATLANTA_HAWKS,WASHINGTON_WIZARDS,122,101,5001,21
5001,2016-03-23,2016-03-22,TORONTO_RAPTORS,BOSTON_CELTICS,79,91,5002,12
5002,2016-03-23,2016-03-22,ORLANDO_MAGIC,DETROIT_PISTONS,102,118,5003,16
5003,2016-03-24,2016-03-23,NEW_YORK_KNICKS,CHICAGO_BULLS,115,107,5004,8
5004,2016-03-24,2016-03-23,UTAH_JAZZ,HOUSTON_ROCKETS,89,87,5005,2
5005,2016-03-24,2016-03-23,SACRAMENTO_KINGS,MINNESOTA_TIMBERWOLVES,104,113,5006,9
5006,2016-03-24,2016-03-23,MIAMI_HEAT,SAN_ANTONIO_SPURS,88,112,5007,24
5007,2016-03-24,2016-03-23,PHILADELPHIA_76ERS,DENVER_NUGGETS,103,104,5008,1
5008,2016-03-24,2016-03-23,LOS_ANGELES_LAKERS,PHOENIX_SUNS,107,119,5009,12
5009,2016-03-24,2016-03-23,DALLAS_MAVERICKS,PORTLAND_TRAIL_BLAZERS,103,109,5010,6
5010,2016-03-24,2016-03-23,LOS_ANGELES_CLIPPERS,GOLDEN_STATE_WARRIORS,98,114,5011,16
5011,2016-03-24,2016-03-23,NEW_ORLEANS_PELICANS,INDIANA_PACERS,84,92,5012,8
5012,2016-03-24,2016-03-23,CLEVELAND_CAVALIERS,BROOKLYN_NETS,95,104,5013,9
5013,2016-03-24,2016-03-23,CHICAGO_BULLS,NEW_YORK_KNICKS,94,106,5014,12
5014,2016-03-25,2016-03-24,UTAH_JAZZ,OKLAHOMA_CITY_THUNDER,91,113,5015,22
5015,2016-03-25,2016-03-24,PORTLAND_TRAIL_BLAZERS,LOS_ANGELES_CLIPPERS,94,96,5016,2
5016,2016-03-25,2016-03-24,MINNESOTA_TIMBERWOLVES,WASHINGTON_WIZARDS,132,129,5017,3
5017,2016-03-25,2016-03-24,CHARLOTTE_HORNETS,DETROIT_PISTONS,105,112,5018,7
5018,2016-03-26,2016-03-25,MILWAUKEE_BUCKS,ATLANTA_HAWKS,90,101,5019,11
5019,2016-03-26,2016-03-25,TORONTO_RAPTORS,HOUSTON_ROCKETS,109,112,5020,3
5020,2016-03-26,2016-03-25,ORLANDO_MAGIC,MIAMI_HEAT,97,108,5021,11
5021,2016-03-26,2016-03-25,MEMPHIS_GRIZZLIES,SAN_ANTONIO_SPURS,104,110,5022,6
5022,2016-03-26,2016-03-25,PHOENIX_SUNS,SACRAMENTO_KINGS,94,116,5023,22
5023,2016-03-26,2016-03-25,DALLAS_MAVERICKS,GOLDEN_STATE_WARRIORS,120,128,5024,8
5024,2016-03-26,2016-03-25,DENVER_NUGGETS,LOS_ANGELES_LAKERS,116,105,5025,11
5025,2016-03-26,2016-03-25,INDIANA_PACERS,BROOKLYN_NETS,110,120,5026,10
5026,2016-03-26,2016-03-25,TORONTO_RAPTORS,NEW_ORLEANS_PELICANS,115,91,5027,24
5027,2016-03-26,2016-03-25,CHICAGO_BULLS,ORLANDO_MAGIC,89,111,5028,22
5028,2016-03-26,2016-03-25,ATLANTA_HAWKS,DETROIT_PISTONS,112,95,5029,17
5029,2016-03-26,2016-03-25,CLEVELAND_CAVALIERS,NEW_YORK_KNICKS,107,93,5030,14
5030,2016-03-27,2016-03-26,UTAH_JAZZ,MINNESOTA_TIMBERWOLVES,93,84,5031,9
5031,2016-03-27,2016-03-26,SAN_ANTONIO_SPURS,OKLAHOMA_CITY_THUNDER,92,111,5032,19
5032,2016-03-27,2016-03-26,CHARLOTTE_HORNETS,MILWAUKEE_BUCKS,115,91,5033,24
5033,2016-03-27,2016-03-26,BOSTON_CELTICS,PHOENIX_SUNS,102,99,5034,3
5034,2016-03-27,2016-03-26,PHILADELPHIA_76ERS,PORTLAND_TRAIL_BLAZERS,105,108,5035,3
5035,2016-03-27,2016-03-26,DENVER_NUGGETS,LOS_ANGELES_CLIPPERS,90,105,5036,15
5036,2016-03-27,2016-03-26,HOUSTON_ROCKETS,INDIANA_PACERS,101,104,5037,3
5037,2016-03-27,2016-03-26,DALLAS_MAVERICKS,SACRAMENTO_KINGS,111,133,5038,22
5038,2016-03-28,2016-03-27,PHILADELPHIA_76ERS,GOLDEN_STATE_WARRIORS,105,117,5039,12
5039,2016-03-28,2016-03-27,WASHINGTON_WIZARDS,LOS_ANGELES_LAKERS,101,88,5040,13
5040,2016-03-28,2016-03-27,BROOKLYN_NETS,MIAMI_HEAT,99,110,5041,11
5041,2016-03-28,2016-03-27,OKLAHOMA_CITY_THUNDER,TORONTO_RAPTORS,119,100,5042,19
5042,2016-03-29,2016-03-28,ATLANTA_HAWKS,CHICAGO_BULLS,102,100,5043,2
5043,2016-03-29,2016-03-28,SAN_ANTONIO_SPURS,MEMPHIS_GRIZZLIES,101,87,5044,14
5044,2016-03-29,2016-03-28,PHOENIX_SUNS,MINNESOTA_TIMBERWOLVES,116,121,5045,5
5045,2016-03-29,2016-03-28,NEW_YORK_KNICKS,NEW_ORLEANS_PELICANS,91,99,5046,8
5046,2016-03-29,2016-03-28,DALLAS_MAVERICKS,DENVER_NUGGETS,97,88,5047,9
5047,2016-03-29,2016-03-28,LOS_ANGELES_LAKERS,UTAH_JAZZ,75,123,5048,48
5048,2016-03-29,2016-03-28,SACRAMENTO_KINGS,PORTLAND_TRAIL_BLAZERS,93,105,5049,12
5049,2016-03-29,2016-03-28,BOSTON_CELTICS,LOS_ANGELES_CLIPPERS,90,114,5050,24
5050,2016-03-29,2016-03-28,CHICAGO_BULLS,INDIANA_PACERS,98,96,5051,2
5051,2016-03-29,2016-03-28,BROOKLYN_NETS,ORLANDO_MAGIC,105,139,5052,34
5052,2016-03-29,2016-03-28,CHARLOTTE_HORNETS,PHILADELPHIA_76ERS,100,85,5053,15
5053,2016-03-29,2016-03-28,OKLAHOMA_CITY_THUNDER,DETROIT_PISTONS,82,88,5054,6
5054,2016-03-30,2016-03-29,HOUSTON_ROCKETS,CLEVELAND_CAVALIERS,106,100,5055,6
5055,2016-03-30,2016-03-29,WASHINGTON_WIZARDS,GOLDEN_STATE_WARRIORS,94,102,5056,8
5056,2016-03-30,2016-03-29,ATLANTA_HAWKS,TORONTO_RAPTORS,97,105,5057,8
5057,2016-03-31,2016-03-30,DENVER_NUGGETS,MEMPHIS_GRIZZLIES,109,105,5058,4
5058,2016-03-31,2016-03-30,PHOENIX_SUNS,MILWAUKEE_BUCKS,94,105,5059,11
5059,2016-03-31,2016-03-30,LOS_ANGELES_CLIPPERS,MINNESOTA_TIMBERWOLVES,99,79,5060,20
5060,2016-03-31,2016-03-30,NEW_YORK_KNICKS,DALLAS_MAVERICKS,89,91,5061,2
5061,2016-03-31,2016-03-30,NEW_ORLEANS_PELICANS,SAN_ANTONIO_SPURS,92,100,5062,8
5062,2016-03-31,2016-03-30,GOLDEN_STATE_WARRIORS,UTAH_JAZZ,103,96,5063,7
5063,2016-03-31,2016-03-30,WASHINGTON_WIZARDS,SACRAMENTO_KINGS,111,120,5064,9
5064,2016-03-31,2016-03-30,MIAMI_HEAT,LOS_ANGELES_LAKERS,100,102,5065,2
5065,2016-03-31,2016-03-30,BROOKLYN_NETS,CLEVELAND_CAVALIERS,87,107,5066,20
5066,2016-03-31,2016-03-30,CHICAGO_BULLS,HOUSTON_ROCKETS,103,100,5067,3
5067,2016-03-31,2016-03-30,ORLANDO_MAGIC,INDIANA_PACERS,114,94,5068,20
5068,2016-04-01,2016-03-31,DENVER_NUGGETS,NEW_ORLEANS_PELICANS,95,101,5069,6
5069,2016-04-01,2016-03-31,LOS_ANGELES_CLIPPERS,OKLAHOMA_CITY_THUNDER,117,119,5070,2
5070,2016-04-01,2016-03-31,BOSTON_CELTICS,PORTLAND_TRAIL_BLAZERS,109,116,5071,7
5071,2016-04-01,2016-03-31,PHILADELPHIA_76ERS,CHARLOTTE_HORNETS,91,100,5072,9
5072,2016-04-01,2016-03-31,DALLAS_MAVERICKS,DETROIT_PISTONS,98,89,5073,9
5073,2016-04-01,2016-03-31,BROOKLYN_NETS,NEW_YORK_KNICKS,91,105,5074,14
5074,2016-04-02,2016-04-01,CLEVELAND_CAVALIERS,ATLANTA_HAWKS,110,108,5075,2
5075,2016-04-02,2016-04-01,TORONTO_RAPTORS,MEMPHIS_GRIZZLIES,99,95,5076,4
5076,2016-04-02,2016-04-01,ORLANDO_MAGIC,MILWAUKEE_BUCKS,110,113,5077,3
5077,2016-04-02,2016-04-01,MINNESOTA_TIMBERWOLVES,UTAH_JAZZ,85,98,5078,13
5078,2016-04-02,2016-04-01,MIAMI_HEAT,SACRAMENTO_KINGS,112,106,5079,6
5079,2016-04-02,2016-04-01,BOSTON_CELTICS,GOLDEN_STATE_WARRIORS,109,106,5080,3
5080,2016-04-02,2016-04-01,WASHINGTON_WIZARDS,PHOENIX_SUNS,106,99,5081,7
5081,2016-04-02,2016-04-01,INDIANA_PACERS,PHILADELPHIA_76ERS,115,102,5082,13
5082,2016-04-03,2016-04-02,DETROIT_PISTONS,CHICAGO_BULLS,94,90,5083,4
5083,2016-04-03,2016-04-02,TORONTO_RAPTORS,SAN_ANTONIO_SPURS,95,102,5084,7
5084,2016-04-03,2016-04-02,SACRAMENTO_KINGS,DENVER_NUGGETS,115,106,5085,9
5085,2016-04-03,2016-04-02,MIAMI_HEAT,PORTLAND_TRAIL_BLAZERS,93,110,5086,17
5086,2016-04-03,2016-04-02,NEW_ORLEANS_PELICANS,BROOKLYN_NETS,106,87,5087,19
5087,2016-04-03,2016-04-02,CHARLOTTE_HORNETS,CLEVELAND_CAVALIERS,103,112,5088,9
5088,2016-04-03,2016-04-02,OKLAHOMA_CITY_THUNDER,HOUSTON_ROCKETS,110,118,5089,8
5089,2016-04-03,2016-04-02,WASHINGTON_WIZARDS,LOS_ANGELES_CLIPPERS,109,114,5090,5
5090,2016-04-03,2016-04-02,DALLAS_MAVERICKS,MINNESOTA_TIMBERWOLVES,88,78,5091,10
5091,2016-04-03,2016-04-02,MEMPHIS_GRIZZLIES,ORLANDO_MAGIC,107,119,5092,12
5092,2016-04-03,2016-04-02,UTAH_JAZZ,PHOENIX_SUNS,101,86,5093,15
5093,2016-04-03,2016-04-02,CHICAGO_BULLS,MILWAUKEE_BUCKS,102,98,5094,4
5094,2016-04-03,2016-04-02,INDIANA_PACERS,NEW_YORK_KNICKS,92,87,5095,5
5095,2016-04-04,2016-04-03,PORTLAND_TRAIL_BLAZERS,GOLDEN_STATE_WARRIORS,111,136,5096,25
5096,2016-04-04,2016-04-03,BOSTON_CELTICS,LOS_ANGELES_LAKERS,107,100,5097,7
5097,2016-04-05,2016-04-04,NEW_ORLEANS_PELICANS,PHILADELPHIA_76ERS,93,107,5098,14
5098,2016-04-05,2016-04-04,CHARLOTTE_HORNETS,TORONTO_RAPTORS,90,96,5099,6
5099,2016-04-06,2016-04-05,PHOENIX_SUNS,ATLANTA_HAWKS,90,103,5100,13
5100,2016-04-06,2016-04-05,CHICAGO_BULLS,MEMPHIS_GRIZZLIES,92,108,5101,16
5101,2016-04-06,2016-04-05,DETROIT_PISTONS,MIAMI_HEAT,89,107,5102,18
5102,2016-04-06,2016-04-05,CLEVELAND_CAVALIERS,MILWAUKEE_BUCKS,109,80,5103,29
5103,2016-04-06,2016-04-05,OKLAHOMA_CITY_THUNDER,DENVER_NUGGETS,124,102,5104,22
5104,2016-04-06,2016-04-05,SAN_ANTONIO_SPURS,UTAH_JAZZ,88,86,5105,2
5105,2016-04-06,2016-04-05,PORTLAND_TRAIL_BLAZERS,SACRAMENTO_KINGS,115,107,5106,8
5106,2016-04-06,2016-04-05,MINNESOTA_TIMBERWOLVES,GOLDEN_STATE_WARRIORS,124,117,5107,7
5107,2016-04-06,2016-04-05,LOS_ANGELES_LAKERS,LOS_ANGELES_CLIPPERS,81,103,5108,22
5108,2016-04-06,2016-04-05,CLEVELAND_CAVALIERS,INDIANA_PACERS,109,123,5109,14
5109,2016-04-06,2016-04-05,DETROIT_PISTONS,ORLANDO_MAGIC,108,104,5110,4
5110,2016-04-06,2016-04-05,BROOKLYN_NETS,WASHINGTON_WIZARDS,103,121,5111,18
5111,2016-04-06,2016-04-05,NEW_ORLEANS_PELICANS,BOSTON_CELTICS,97,104,5112,7
5112,2016-04-06,2016-04-05,CHARLOTTE_HORNETS,NEW_YORK_KNICKS,111,97,5113,14
5113,2016-04-07,2016-04-06,HOUSTON_ROCKETS,DALLAS_MAVERICKS,86,88,5114,2
5114,2016-04-07,2016-04-06,OKLAHOMA_CITY_THUNDER,PORTLAND_TRAIL_BLAZERS,115,120,5115,5
5115,2016-04-07,2016-04-06,LOS_ANGELES_CLIPPERS,LOS_ANGELES_LAKERS,91,81,5116,10
5116,2016-04-08,2016-04-07,TORONTO_RAPTORS,ATLANTA_HAWKS,87,95,5117,8
5117,2016-04-08,2016-04-07,PHOENIX_SUNS,HOUSTON_ROCKETS,124,115,5118,9
5118,2016-04-08,2016-04-07,CHICAGO_BULLS,MIAMI_HEAT,98,106,5119,8
5119,2016-04-08,2016-04-07,MINNESOTA_TIMBERWOLVES,SACRAMENTO_KINGS,105,97,5120,8
5120,2016-04-08,2016-04-07,SAN_ANTONIO_SPURS,GOLDEN_STATE_WARRIORS,101,112,5121,11
5121,2016-04-08,2016-04-07,BROOKLYN_NETS,CHARLOTTE_HORNETS,99,113,5122,14
5122,2016-04-08,2016-04-07,MIAMI_HEAT,ORLANDO_MAGIC,109,112,5123,3
5123,2016-04-08,2016-04-07,NEW_YORK_KNICKS,PHILADELPHIA_76ERS,109,102,5124,7
5124,2016-04-08,2016-04-07,MILWAUKEE_BUCKS,BOSTON_CELTICS,109,124,5125,15
5125,2016-04-08,2016-04-07,WASHINGTON_WIZARDS,DETROIT_PISTONS,99,112,5126,13
5126,2016-04-08,2016-04-07,INDIANA_PACERS,TORONTO_RAPTORS,98,111,5127,13
5127,2016-04-09,2016-04-08,LOS_ANGELES_LAKERS,NEW_ORLEANS_PELICANS,102,110,5128,8
5128,2016-04-09,2016-04-08,MEMPHIS_GRIZZLIES,DALLAS_MAVERICKS,93,103,5129,10
5129,2016-04-09,2016-04-08,SAN_ANTONIO_SPURS,DENVER_NUGGETS,98,102,5130,4
5130,2016-04-09,2016-04-08,LOS_ANGELES_CLIPPERS,UTAH_JAZZ,102,99,5131,3
5131,2016-04-09,2016-04-08,PHOENIX_SUNS,NEW_ORLEANS_PELICANS,121,100,5132,21
5132,2016-04-09,2016-04-08,BOSTON_CELTICS,ATLANTA_HAWKS,107,118,5133,11
5133,2016-04-10,2016-04-09,GOLDEN_STATE_WARRIORS,MEMPHIS_GRIZZLIES,100,99,5134,1
5134,2016-04-10,2016-04-09,CLEVELAND_CAVALIERS,CHICAGO_BULLS,102,105,5135,3
5135,2016-04-10,2016-04-09,MINNESOTA_TIMBERWOLVES,PORTLAND_TRAIL_BLAZERS,106,105,5136,1
5136,2016-04-10,2016-04-09,OKLAHOMA_CITY_THUNDER,SACRAMENTO_KINGS,112,114,5137,2
5137,2016-04-10,2016-04-09,CHARLOTTE_HORNETS,WASHINGTON_WIZARDS,98,113,5138,15
5138,2016-04-10,2016-04-09,LOS_ANGELES_LAKERS,HOUSTON_ROCKETS,110,130,5139,20
5139,2016-04-10,2016-04-09,DALLAS_MAVERICKS,LOS_ANGELES_CLIPPERS,91,98,5140,7
5140,2016-04-10,2016-04-09,UTAH_JAZZ,DENVER_NUGGETS,100,84,5141,16
5141,2016-04-10,2016-04-09,MILWAUKEE_BUCKS,PHILADELPHIA_76ERS,109,108,5142,1
5142,2016-04-10,2016-04-09,BROOKLYN_NETS,INDIANA_PACERS,105,129,5143,24
5143,2016-04-10,2016-04-09,ORLANDO_MAGIC,MIAMI_HEAT,96,118,5144,22
5144,2016-04-10,2016-04-09,GOLDEN_STATE_WARRIORS,SAN_ANTONIO_SPURS,92,86,5145,6
5145,2016-04-10,2016-04-09,TORONTO_RAPTORS,NEW_YORK_KNICKS,93,89,5146,4
5146,2016-04-11,2016-04-10,ATLANTA_HAWKS,CLEVELAND_CAVALIERS,94,109,5147,15
5147,2016-04-11,2016-04-10,MILWAUKEE_BUCKS,ORLANDO_MAGIC,98,107,5148,9
5148,2016-04-11,2016-04-10,CHARLOTTE_HORNETS,BOSTON_CELTICS,114,100,5149,14
5149,2016-04-11,2016-04-10,WASHINGTON_WIZARDS,BROOKLYN_NETS,120,111,5150,9
5150,2016-04-12,2016-04-11,HOUSTON_ROCKETS,MINNESOTA_TIMBERWOLVES,129,105,5151,24
5151,2016-04-12,2016-04-11,CHICAGO_BULLS,NEW_ORLEANS_PELICANS,121,116,5152,5
5152,2016-04-12,2016-04-11,LOS_ANGELES_LAKERS,OKLAHOMA_CITY_THUNDER,79,112,5153,33
5153,2016-04-12,2016-04-11,DALLAS_MAVERICKS,UTAH_JAZZ,101,92,5154,9
5154,2016-04-12,2016-04-11,SACRAMENTO_KINGS,PHOENIX_SUNS,105,101,5155,4
5155,2016-04-12,2016-04-11,NEW_YORK_KNICKS,INDIANA_PACERS,90,102,5156,12
5156,2016-04-12,2016-04-11,MIAMI_HEAT,DETROIT_PISTONS,99,93,5157,6
5157,2016-04-12,2016-04-11,PHILADELPHIA_76ERS,TORONTO_RAPTORS,98,122,5158,24
5158,2016-04-13,2016-04-12,OKLAHOMA_CITY_THUNDER,SAN_ANTONIO_SPURS,98,102,5159,4
5159,2016-04-13,2016-04-12,MEMPHIS_GRIZZLIES,LOS_ANGELES_CLIPPERS,84,110,5160,26
5160,2016-04-14,2016-04-13,MIAMI_HEAT,BOSTON_CELTICS,88,98,5161,10
5161,2016-04-14,2016-04-13,TORONTO_RAPTORS,BROOKLYN_NETS,103,96,5162,7
5162,2016-04-14,2016-04-13,PHILADELPHIA_76ERS,CHICAGO_BULLS,105,115,5163,10
5163,2016-04-14,2016-04-13,ORLANDO_MAGIC,CHARLOTTE_HORNETS,103,117,5164,14
5164,2016-04-14,2016-04-13,DETROIT_PISTONS,CLEVELAND_CAVALIERS,112,110,5165,2
5165,2016-04-14,2016-04-13,SAN_ANTONIO_SPURS,DALLAS_MAVERICKS,96,91,5166,5
5166,2016-04-14,2016-04-13,SACRAMENTO_KINGS,HOUSTON_ROCKETS,81,116,5167,35
5167,2016-04-14,2016-04-13,INDIANA_PACERS,MILWAUKEE_BUCKS,97,92,5168,5
5168,2016-04-14,2016-04-13,NEW_ORLEANS_PELICANS,MINNESOTA_TIMBERWOLVES,109,144,5169,35
5169,2016-04-14,2016-04-13,ATLANTA_HAWKS,WASHINGTON_WIZARDS,98,109,5170,11
5170,2016-04-14,2016-04-13,MEMPHIS_GRIZZLIES,GOLDEN_STATE_WARRIORS,104,125,5171,21
5171,2016-04-14,2016-04-13,UTAH_JAZZ,LOS_ANGELES_LAKERS,96,101,5172,5
5172,2016-04-14,2016-04-13,LOS_ANGELES_CLIPPERS,PHOENIX_SUNS,105,114,5173,9
5173,2016-04-14,2016-04-13,DENVER_NUGGETS,PORTLAND_TRAIL_BLAZERS,99,107,5174,8
5174,2016-04-16,2016-04-15,INDIANA_PACERS,TORONTO_RAPTORS,100,90,5175,10
5175,2016-04-16,2016-04-15,HOUSTON_ROCKETS,GOLDEN_STATE_WARRIORS,78,104,5176,26
5176,2016-04-16,2016-04-15,BOSTON_CELTICS,ATLANTA_HAWKS,101,102,5177,1
5177,2016-04-17,2016-04-16,DALLAS_MAVERICKS,OKLAHOMA_CITY_THUNDER,70,108,5178,38
5178,2016-04-17,2016-04-16,DETROIT_PISTONS,CLEVELAND_CAVALIERS,101,106,5179,5
5179,2016-04-17,2016-04-16,CHARLOTTE_HORNETS,MIAMI_HEAT,91,123,5180,32
5180,2016-04-18,2016-04-17,MEMPHIS_GRIZZLIES,SAN_ANTONIO_SPURS,74,106,5181,32
5181,2016-04-18,2016-04-17,PORTLAND_TRAIL_BLAZERS,LOS_ANGELES_CLIPPERS,95,115,5182,20
5182,2016-04-18,2016-04-17,INDIANA_PACERS,TORONTO_RAPTORS,87,98,5183,11
5183,2016-04-19,2016-04-18,DALLAS_MAVERICKS,OKLAHOMA_CITY_THUNDER,85,84,5184,1
5184,2016-04-19,2016-04-18,HOUSTON_ROCKETS,GOLDEN_STATE_WARRIORS,106,115,5185,9
5185,2016-04-19,2016-04-18,BOSTON_CELTICS,ATLANTA_HAWKS,72,89,5186,17
5186,2016-04-20,2016-04-19,MEMPHIS_GRIZZLIES,SAN_ANTONIO_SPURS,68,94,5187,26
5187,2016-04-20,2016-04-19,CHARLOTTE_HORNETS,MIAMI_HEAT,103,115,5188,12
5188,2016-04-21,2016-04-20,DETROIT_PISTONS,CLEVELAND_CAVALIERS,90,107,5189,17
5189,2016-04-21,2016-04-20,PORTLAND_TRAIL_BLAZERS,LOS_ANGELES_CLIPPERS,81,102,5190,21
5190,2016-04-21,2016-04-20,OKLAHOMA_CITY_THUNDER,DALLAS_MAVERICKS,131,102,5191,29
5191,2016-04-21,2016-04-20,TORONTO_RAPTORS,INDIANA_PACERS,101,85,5192,16
5192,2016-04-22,2016-04-21,GOLDEN_STATE_WARRIORS,HOUSTON_ROCKETS,96,97,5193,1
5193,2016-04-22,2016-04-21,CLEVELAND_CAVALIERS,DETROIT_PISTONS,101,91,5194,10
5194,2016-04-23,2016-04-22,ATLANTA_HAWKS,BOSTON_CELTICS,103,111,5195,8
5195,2016-04-23,2016-04-22,SAN_ANTONIO_SPURS,MEMPHIS_GRIZZLIES,96,87,5196,9
5196,2016-04-23,2016-04-22,TORONTO_RAPTORS,INDIANA_PACERS,83,100,5197,17
5197,2016-04-23,2016-04-22,MIAMI_HEAT,CHARLOTTE_HORNETS,80,96,5198,16
5198,2016-04-24,2016-04-23,OKLAHOMA_CITY_THUNDER,DALLAS_MAVERICKS,119,108,5199,11
5199,2016-04-24,2016-04-23,LOS_ANGELES_CLIPPERS,PORTLAND_TRAIL_BLAZERS,88,96,5200,8
5200,2016-04-24,2016-04-23,SAN_ANTONIO_SPURS,MEMPHIS_GRIZZLIES,116,95,5201,21
5201,2016-04-24,2016-04-23,GOLDEN_STATE_WARRIORS,HOUSTON_ROCKETS,121,94,5202,27
5202,2016-04-24,2016-04-23,ATLANTA_HAWKS,BOSTON_CELTICS,95,104,5203,9
5203,2016-04-25,2016-04-24,CLEVELAND_CAVALIERS,DETROIT_PISTONS,100,98,5204,2
5204,2016-04-25,2016-04-24,MIAMI_HEAT,CHARLOTTE_HORNETS,85,89,5205,4
5205,2016-04-26,2016-04-25,DALLAS_MAVERICKS,OKLAHOMA_CITY_THUNDER,104,118,5206,14
5206,2016-04-26,2016-04-25,LOS_ANGELES_CLIPPERS,PORTLAND_TRAIL_BLAZERS,84,98,5207,14
5207,2016-04-26,2016-04-25,INDIANA_PACERS,TORONTO_RAPTORS,99,102,5208,3
5208,2016-04-27,2016-04-26,BOSTON_CELTICS,ATLANTA_HAWKS,83,110,5209,27
5209,2016-04-28,2016-04-27,CHARLOTTE_HORNETS,MIAMI_HEAT,90,88,5210,2
5210,2016-04-28,2016-04-27,PORTLAND_TRAIL_BLAZERS,LOS_ANGELES_CLIPPERS,108,98,5211,10
5211,2016-04-28,2016-04-27,HOUSTON_ROCKETS,GOLDEN_STATE_WARRIORS,81,114,5212,33
5212,2016-04-29,2016-04-28,ATLANTA_HAWKS,BOSTON_CELTICS,104,92,5213,12
5213,2016-04-29,2016-04-28,TORONTO_RAPTORS,INDIANA_PACERS,83,101,5214,18
5214,2016-04-30,2016-04-29,MIAMI_HEAT,CHARLOTTE_HORNETS,97,90,5215,7
5215,2016-04-30,2016-04-29,LOS_ANGELES_CLIPPERS,PORTLAND_TRAIL_BLAZERS,103,106,5216,3
5216,2016-05-01,2016-04-30,OKLAHOMA_CITY_THUNDER,SAN_ANTONIO_SPURS,92,124,5217,32
5217,2016-05-01,2016-04-30,CHARLOTTE_HORNETS,MIAMI_HEAT,73,106,5218,33
5218,2016-05-01,2016-04-30,PORTLAND_TRAIL_BLAZERS,GOLDEN_STATE_WARRIORS,106,118,5219,12
5219,2016-05-02,2016-05-01,INDIANA_PACERS,TORONTO_RAPTORS,84,89,5220,5
5220,2016-05-02,2016-05-01,ATLANTA_HAWKS,CLEVELAND_CAVALIERS,93,104,5221,11
5221,2016-05-03,2016-05-02,OKLAHOMA_CITY_THUNDER,SAN_ANTONIO_SPURS,98,97,5222,1
5222,2016-05-04,2016-05-03,MIAMI_HEAT,TORONTO_RAPTORS,102,96,5223,6
5223,2016-05-04,2016-05-03,PORTLAND_TRAIL_BLAZERS,GOLDEN_STATE_WARRIORS,99,110,5224,11
5224,2016-05-05,2016-05-04,ATLANTA_HAWKS,CLEVELAND_CAVALIERS,98,123,5225,25
5225,2016-05-06,2016-05-05,MIAMI_HEAT,TORONTO_RAPTORS,92,96,5226,4
5226,2016-05-06,2016-05-05,CLEVELAND_CAVALIERS,ATLANTA_HAWKS,121,108,5227,13
5227,2016-05-07,2016-05-06,SAN_ANTONIO_SPURS,OKLAHOMA_CITY_THUNDER,100,96,5228,4
5228,2016-05-07,2016-05-06,TORONTO_RAPTORS,MIAMI_HEAT,95,91,5229,4
5229,2016-05-08,2016-05-07,GOLDEN_STATE_WARRIORS,PORTLAND_TRAIL_BLAZERS,108,120,5230,12
5230,2016-05-08,2016-05-07,CLEVELAND_CAVALIERS,ATLANTA_HAWKS,100,99,5231,1
5231,2016-05-09,2016-05-08,SAN_ANTONIO_SPURS,OKLAHOMA_CITY_THUNDER,97,111,5232,14
5232,2016-05-10,2016-05-09,TORONTO_RAPTORS,MIAMI_HEAT,87,94,5233,7
5233,2016-05-10,2016-05-09,GOLDEN_STATE_WARRIORS,PORTLAND_TRAIL_BLAZERS,132,125,5234,7
5234,2016-05-11,2016-05-10,OKLAHOMA_CITY_THUNDER,SAN_ANTONIO_SPURS,95,91,5235,4
5235,2016-05-12,2016-05-11,MIAMI_HEAT,TORONTO_RAPTORS,91,99,5236,8
5236,2016-05-12,2016-05-11,PORTLAND_TRAIL_BLAZERS,GOLDEN_STATE_WARRIORS,121,125,5237,4
5237,2016-05-13,2016-05-12,SAN_ANTONIO_SPURS,OKLAHOMA_CITY_THUNDER,99,113,5238,14
5238,2016-05-14,2016-05-13,TORONTO_RAPTORS,MIAMI_HEAT,91,103,5239,12
5239,2016-05-15,2016-05-14,MIAMI_HEAT,TORONTO_RAPTORS,89,116,5240,27
5240,2016-05-17,2016-05-16,OKLAHOMA_CITY_THUNDER,GOLDEN_STATE_WARRIORS,108,102,5241,6
5241,2016-05-18,2016-05-17,TORONTO_RAPTORS,CLEVELAND_CAVALIERS,84,115,5242,31
5242,2016-05-19,2016-05-18,OKLAHOMA_CITY_THUNDER,GOLDEN_STATE_WARRIORS,91,118,5243,27
5243,2016-05-20,2016-05-19,TORONTO_RAPTORS,CLEVELAND_CAVALIERS,89,108,5244,19
5244,2016-05-22,2016-05-21,CLEVELAND_CAVALIERS,TORONTO_RAPTORS,84,99,5245,15
5245,2016-05-23,2016-05-22,GOLDEN_STATE_WARRIORS,OKLAHOMA_CITY_THUNDER,105,133,5246,28
5246,2016-05-24,2016-05-23,CLEVELAND_CAVALIERS,TORONTO_RAPTORS,99,105,5247,6
5247,2016-05-25,2016-05-24,GOLDEN_STATE_WARRIORS,OKLAHOMA_CITY_THUNDER,94,118,5248,24
5248,2016-05-26,2016-05-25,TORONTO_RAPTORS,CLEVELAND_CAVALIERS,78,116,5249,38
5249,2016-05-27,2016-05-26,OKLAHOMA_CITY_THUNDER,GOLDEN_STATE_WARRIORS,111,120,5250,9
5250,2016-05-28,2016-05-27,CLEVELAND_CAVALIERS,TORONTO_RAPTORS,113,87,5251,26
5251,2016-05-29,2016-05-28,GOLDEN_STATE_WARRIORS,OKLAHOMA_CITY_THUNDER,108,101,5252,7
5252,2016-05-31,2016-05-30,OKLAHOMA_CITY_THUNDER,GOLDEN_STATE_WARRIORS,88,96,5253,8
5253,2016-06-03,2016-06-02,CLEVELAND_CAVALIERS,GOLDEN_STATE_WARRIORS,89,104,5254,15
5254,2016-06-06,2016-06-05,CLEVELAND_CAVALIERS,GOLDEN_STATE_WARRIORS,77,110,5255,33
5255,2016-06-09,2016-06-08,GOLDEN_STATE_WARRIORS,CLEVELAND_CAVALIERS,90,120,5256,30
5256,2016-06-11,2016-06-10,GOLDEN_STATE_WARRIORS,CLEVELAND_CAVALIERS,108,97,5257,11
5257,2016-06-14,2016-06-13,CLEVELAND_CAVALIERS,GOLDEN_STATE_WARRIORS,112,97,5258,15
5258,2016-06-17,2016-06-16,GOLDEN_STATE_WARRIORS,CLEVELAND_CAVALIERS,101,115,5259,14
5259,2016-06-20,2016-06-19,CLEVELAND_CAVALIERS,GOLDEN_STATE_WARRIORS,93,89,5260,4
5260,2016-10-25,2016-10-24,NEW_YORK_KNICKS,CLEVELAND_CAVALIERS,88,117,5261,29
5261,2016-10-26,2016-10-25,UTAH_JAZZ,PORTLAND_TRAIL_BLAZERS,104,113,5262,9
5262,2016-10-26,2016-10-25,SAN_ANTONIO_SPURS,GOLDEN_STATE_WARRIORS,129,100,5263,29
5263,2016-10-26,2016-10-25,DALLAS_MAVERICKS,INDIANA_PACERS,121,130,5264,9
5264,2016-10-26,2016-10-25,MIAMI_HEAT,ORLANDO_MAGIC,108,96,5265,12
5265,2016-10-26,2016-10-25,BROOKLYN_NETS,BOSTON_CELTICS,117,122,5266,5
5266,2016-10-26,2016-10-25,DETROIT_PISTONS,TORONTO_RAPTORS,91,109,5267,18
5267,2016-10-27,2016-10-26,DENVER_NUGGETS,NEW_ORLEANS_PELICANS,107,102,5268,5
5268,2016-10-27,2016-10-26,CHARLOTTE_HORNETS,MILWAUKEE_BUCKS,107,96,5269,11
5269,2016-10-27,2016-10-26,MINNESOTA_TIMBERWOLVES,MEMPHIS_GRIZZLIES,98,102,5270,4
5270,2016-10-27,2016-10-26,OKLAHOMA_CITY_THUNDER,PHILADELPHIA_76ERS,103,97,5271,6
5271,2016-10-27,2016-10-26,SACRAMENTO_KINGS,PHOENIX_SUNS,113,94,5272,19
5272,2016-10-27,2016-10-26,HOUSTON_ROCKETS,LOS_ANGELES_LAKERS,114,120,5273,6
5273,2016-10-27,2016-10-26,WASHINGTON_WIZARDS,ATLANTA_HAWKS,99,114,5274,15
5274,2016-10-28,2016-10-27,BOSTON_CELTICS,CHICAGO_BULLS,99,105,5275,6
5275,2016-10-28,2016-10-27,LOS_ANGELES_CLIPPERS,PORTLAND_TRAIL_BLAZERS,114,106,5276,8
5276,2016-10-28,2016-10-27,SAN_ANTONIO_SPURS,SACRAMENTO_KINGS,102,94,5277,8
5277,2016-10-28,2016-10-27,CLEVELAND_CAVALIERS,TORONTO_RAPTORS,94,91,5278,3
5278,2016-10-28,2016-10-27,INDIANA_PACERS,BROOKLYN_NETS,94,103,5279,9
5279,2016-10-28,2016-10-27,ORLANDO_MAGIC,DETROIT_PISTONS,82,108,5280,26
5280,2016-10-29,2016-10-28,PHOENIX_SUNS,OKLAHOMA_CITY_THUNDER,110,113,5281,3
5281,2016-10-29,2016-10-28,CHARLOTTE_HORNETS,MIAMI_HEAT,97,91,5282,6
5282,2016-10-29,2016-10-28,HOUSTON_ROCKETS,DALLAS_MAVERICKS,106,98,5283,8
5283,2016-10-29,2016-10-28,LOS_ANGELES_LAKERS,UTAH_JAZZ,89,96,5284,7
5284,2016-10-29,2016-10-28,GOLDEN_STATE_WARRIORS,NEW_ORLEANS_PELICANS,122,114,5285,8
5285,2016-10-29,2016-10-28,ATLANTA_HAWKS,PHILADELPHIA_76ERS,104,72,5286,32
5286,2016-10-29,2016-10-28,BOSTON_CELTICS,CHARLOTTE_HORNETS,104,98,5287,6
5287,2016-10-29,2016-10-28,ORLANDO_MAGIC,CLEVELAND_CAVALIERS,99,105,5288,6
5288,2016-10-29,2016-10-28,MEMPHIS_GRIZZLIES,NEW_YORK_KNICKS,104,111,5289,7
5289,2016-10-30,2016-10-29,NEW_ORLEANS_PELICANS,SAN_ANTONIO_SPURS,79,98,5290,19
5290,2016-10-30,2016-10-29,BROOKLYN_NETS,MILWAUKEE_BUCKS,108,110,5291,2
5291,2016-10-30,2016-10-29,INDIANA_PACERS,CHICAGO_BULLS,101,118,5292,17
5292,2016-10-30,2016-10-29,PORTLAND_TRAIL_BLAZERS,DENVER_NUGGETS,115,113,5293,2
5293,2016-10-30,2016-10-29,MINNESOTA_TIMBERWOLVES,SACRAMENTO_KINGS,103,106,5294,3
5294,2016-10-30,2016-10-29,UTAH_JAZZ,LOS_ANGELES_CLIPPERS,75,88,5295,13
5295,2016-10-30,2016-10-29,MILWAUKEE_BUCKS,DETROIT_PISTONS,83,98,5296,15
5296,2016-10-30,2016-10-29,GOLDEN_STATE_WARRIORS,PHOENIX_SUNS,106,100,5297,6
5297,2016-10-30,2016-10-29,SAN_ANTONIO_SPURS,MIAMI_HEAT,106,99,5298,7
5298,2016-10-30,2016-10-29,LOS_ANGELES_LAKERS,OKLAHOMA_CITY_THUNDER,96,113,5299,17
5299,2016-10-31,2016-10-30,WASHINGTON_WIZARDS,MEMPHIS_GRIZZLIES,103,112,5300,9
5300,2016-10-31,2016-10-30,DALLAS_MAVERICKS,HOUSTON_ROCKETS,92,93,5301,1
5301,2016-10-31,2016-10-30,SACRAMENTO_KINGS,ATLANTA_HAWKS,95,106,5302,11
5302,2016-10-31,2016-10-30,CHICAGO_BULLS,BROOKLYN_NETS,118,88,5303,30
5303,2016-10-31,2016-10-30,DENVER_NUGGETS,TORONTO_RAPTORS,102,105,5304,3
5304,2016-11-01,2016-10-31,PHOENIX_SUNS,LOS_ANGELES_CLIPPERS,98,116,5305,18
5305,2016-11-01,2016-10-31,HOUSTON_ROCKETS,CLEVELAND_CAVALIERS,120,128,5306,8
5306,2016-11-01,2016-10-31,LOS_ANGELES_LAKERS,INDIANA_PACERS,108,115,5307,7
5307,2016-11-01,2016-10-31,ORLANDO_MAGIC,PHILADELPHIA_76ERS,103,101,5308,2
5308,2016-11-01,2016-10-31,NEW_YORK_KNICKS,DETROIT_PISTONS,89,102,5309,13
5309,2016-11-01,2016-10-31,SACRAMENTO_KINGS,MIAMI_HEAT,96,108,5310,12
5310,2016-11-02,2016-11-01,MEMPHIS_GRIZZLIES,MINNESOTA_TIMBERWOLVES,80,116,5311,36
5311,2016-11-02,2016-11-01,MILWAUKEE_BUCKS,NEW_ORLEANS_PELICANS,117,113,5312,4
5312,2016-11-02,2016-11-01,UTAH_JAZZ,SAN_ANTONIO_SPURS,106,91,5313,15
5313,2016-11-02,2016-11-01,GOLDEN_STATE_WARRIORS,PORTLAND_TRAIL_BLAZERS,127,104,5314,23
5314,2016-11-02,2016-11-01,PHILADELPHIA_76ERS,CHARLOTTE_HORNETS,93,109,5315,16
5315,2016-11-02,2016-11-01,TORONTO_RAPTORS,WASHINGTON_WIZARDS,113,103,5316,10
5316,2016-11-02,2016-11-01,LOS_ANGELES_LAKERS,ATLANTA_HAWKS,123,116,5317,7
5317,2016-11-02,2016-11-01,DETROIT_PISTONS,BROOKLYN_NETS,101,109,5318,8
5318,2016-11-02,2016-11-01,HOUSTON_ROCKETS,NEW_YORK_KNICKS,118,99,5319,19
5319,2016-11-03,2016-11-02,CHICAGO_BULLS,BOSTON_CELTICS,100,107,5320,7
5320,2016-11-03,2016-11-02,NEW_ORLEANS_PELICANS,MEMPHIS_GRIZZLIES,83,89,5321,6
5321,2016-11-03,2016-11-02,DALLAS_MAVERICKS,UTAH_JAZZ,81,97,5322,16
5322,2016-11-03,2016-11-02,PORTLAND_TRAIL_BLAZERS,PHOENIX_SUNS,115,118,5323,3
5323,2016-11-03,2016-11-02,OKLAHOMA_CITY_THUNDER,LOS_ANGELES_CLIPPERS,85,83,5324,2
5324,2016-11-03,2016-11-02,SACRAMENTO_KINGS,ORLANDO_MAGIC,94,102,5325,8
5325,2016-11-04,2016-11-03,BOSTON_CELTICS,CLEVELAND_CAVALIERS,122,128,5326,6
5326,2016-11-04,2016-11-03,INDIANA_PACERS,MILWAUKEE_BUCKS,107,125,5327,18
5327,2016-11-04,2016-11-03,DENVER_NUGGETS,MINNESOTA_TIMBERWOLVES,102,99,5328,3
5328,2016-11-04,2016-11-03,OKLAHOMA_CITY_THUNDER,GOLDEN_STATE_WARRIORS,96,122,5329,26
5329,2016-11-04,2016-11-03,ATLANTA_HAWKS,WASHINGTON_WIZARDS,92,95,5330,3
5330,2016-11-04,2016-11-03,CHARLOTTE_HORNETS,BROOKLYN_NETS,99,95,5331,4
5331,2016-11-04,2016-11-03,MIAMI_HEAT,TORONTO_RAPTORS,87,96,5332,9
5332,2016-11-05,2016-11-04,NEW_YORK_KNICKS,CHICAGO_BULLS,117,104,5333,13
5333,2016-11-05,2016-11-04,LOS_ANGELES_CLIPPERS,MEMPHIS_GRIZZLIES,99,88,5334,11
5334,2016-11-05,2016-11-04,PHOENIX_SUNS,NEW_ORLEANS_PELICANS,112,111,5335,1
5335,2016-11-05,2016-11-04,PORTLAND_TRAIL_BLAZERS,DALLAS_MAVERICKS,105,95,5336,10
5336,2016-11-05,2016-11-04,SAN_ANTONIO_SPURS,UTAH_JAZZ,100,86,5337,14
5337,2016-11-05,2016-11-04,GOLDEN_STATE_WARRIORS,LOS_ANGELES_LAKERS,97,117,5338,20
5338,2016-11-05,2016-11-04,MINNESOTA_TIMBERWOLVES,OKLAHOMA_CITY_THUNDER,92,112,5339,20
5339,2016-11-05,2016-11-04,DENVER_NUGGETS,DETROIT_PISTONS,86,103,5340,17
5340,2016-11-05,2016-11-04,CHICAGO_BULLS,INDIANA_PACERS,94,111,5341,17
5341,2016-11-05,2016-11-04,WASHINGTON_WIZARDS,ORLANDO_MAGIC,86,88,5342,2
5342,2016-11-05,2016-11-04,CLEVELAND_CAVALIERS,PHILADELPHIA_76ERS,102,101,5343,1
5343,2016-11-05,2016-11-04,HOUSTON_ROCKETS,ATLANTA_HAWKS,97,112,5344,15
5344,2016-11-06,2016-11-05,SACRAMENTO_KINGS,MILWAUKEE_BUCKS,91,117,5345,26
5345,2016-11-06,2016-11-05,LOS_ANGELES_CLIPPERS,SAN_ANTONIO_SPURS,116,92,5346,24
5346,2016-11-06,2016-11-05,UTAH_JAZZ,NEW_YORK_KNICKS,114,109,5347,5
5347,2016-11-06,2016-11-05,PORTLAND_TRAIL_BLAZERS,MEMPHIS_GRIZZLIES,100,94,5348,6
5348,2016-11-06,2016-11-05,SACRAMENTO_KINGS,TORONTO_RAPTORS,96,91,5349,5
5349,2016-11-07,2016-11-06,MILWAUKEE_BUCKS,DALLAS_MAVERICKS,75,86,5350,11
5350,2016-11-07,2016-11-06,DENVER_NUGGETS,BOSTON_CELTICS,123,107,5351,16
5351,2016-11-07,2016-11-06,PHOENIX_SUNS,LOS_ANGELES_LAKERS,108,119,5352,11
5352,2016-11-08,2016-11-07,INDIANA_PACERS,CHARLOTTE_HORNETS,100,122,5353,22
5353,2016-11-08,2016-11-07,UTAH_JAZZ,PHILADELPHIA_76ERS,109,84,5354,25
5354,2016-11-08,2016-11-07,HOUSTON_ROCKETS,WASHINGTON_WIZARDS,114,106,5355,8
5355,2016-11-08,2016-11-07,ORLANDO_MAGIC,CHICAGO_BULLS,80,112,5356,32
5356,2016-11-08,2016-11-07,MIAMI_HEAT,OKLAHOMA_CITY_THUNDER,85,97,5357,12
5357,2016-11-08,2016-11-07,NEW_ORLEANS_PELICANS,GOLDEN_STATE_WARRIORS,106,116,5358,10
5358,2016-11-08,2016-11-07,DETROIT_PISTONS,LOS_ANGELES_CLIPPERS,82,114,5359,32
5359,2016-11-09,2016-11-08,ATLANTA_HAWKS,CLEVELAND_CAVALIERS,110,106,5360,4
5360,2016-11-09,2016-11-08,MINNESOTA_TIMBERWOLVES,BROOKLYN_NETS,110,119,5361,9
5361,2016-11-09,2016-11-08,DENVER_NUGGETS,MEMPHIS_GRIZZLIES,107,108,5362,1
5362,2016-11-09,2016-11-08,PHOENIX_SUNS,PORTLAND_TRAIL_BLAZERS,121,124,5363,3
5363,2016-11-09,2016-11-08,DALLAS_MAVERICKS,LOS_ANGELES_LAKERS,109,97,5364,12
5364,2016-11-09,2016-11-08,NEW_ORLEANS_PELICANS,SACRAMENTO_KINGS,94,102,5365,8
5365,2016-11-10,2016-11-09,UTAH_JAZZ,CHARLOTTE_HORNETS,98,104,5366,6
5366,2016-11-10,2016-11-09,PHILADELPHIA_76ERS,INDIANA_PACERS,115,122,5367,7
5367,2016-11-10,2016-11-09,BROOKLYN_NETS,NEW_YORK_KNICKS,96,110,5368,14
5368,2016-11-10,2016-11-09,MINNESOTA_TIMBERWOLVES,ORLANDO_MAGIC,123,107,5369,16
5369,2016-11-10,2016-11-09,BOSTON_CELTICS,WASHINGTON_WIZARDS,93,118,5370,25
5370,2016-11-10,2016-11-09,CHICAGO_BULLS,ATLANTA_HAWKS,107,115,5371,8
5371,2016-11-10,2016-11-09,TORONTO_RAPTORS,OKLAHOMA_CITY_THUNDER,112,102,5372,10
5372,2016-11-10,2016-11-09,DETROIT_PISTONS,PHOENIX_SUNS,100,107,5373,7
5373,2016-11-10,2016-11-09,HOUSTON_ROCKETS,SAN_ANTONIO_SPURS,101,99,5374,2
5374,2016-11-10,2016-11-09,DALLAS_MAVERICKS,GOLDEN_STATE_WARRIORS,95,116,5375,21
5375,2016-11-10,2016-11-09,PORTLAND_TRAIL_BLAZERS,LOS_ANGELES_CLIPPERS,80,111,5376,31
5376,2016-11-11,2016-11-10,CHICAGO_BULLS,MIAMI_HEAT,98,95,5377,3
5377,2016-11-11,2016-11-10,NEW_ORLEANS_PELICANS,MILWAUKEE_BUCKS,112,106,5378,6
5378,2016-11-11,2016-11-10,GOLDEN_STATE_WARRIORS,DENVER_NUGGETS,125,101,5379,24
5379,2016-11-11,2016-11-10,LOS_ANGELES_LAKERS,SACRAMENTO_KINGS,101,91,5380,10
5380,2016-11-12,2016-11-11,TORONTO_RAPTORS,CHARLOTTE_HORNETS,113,111,5381,2
5381,2016-11-12,2016-11-11,UTAH_JAZZ,ORLANDO_MAGIC,87,74,5382,13
5382,2016-11-12,2016-11-11,INDIANA_PACERS,PHILADELPHIA_76ERS,105,109,5383,4
5383,2016-11-12,2016-11-11,CLEVELAND_CAVALIERS,WASHINGTON_WIZARDS,105,94,5384,11
5384,2016-11-12,2016-11-11,NEW_YORK_KNICKS,BOSTON_CELTICS,87,115,5385,28
5385,2016-11-12,2016-11-11,LOS_ANGELES_CLIPPERS,OKLAHOMA_CITY_THUNDER,110,108,5386,2
5386,2016-11-12,2016-11-11,DETROIT_PISTONS,SAN_ANTONIO_SPURS,86,96,5387,10
5387,2016-11-12,2016-11-11,SACRAMENTO_KINGS,PORTLAND_TRAIL_BLAZERS,120,122,5388,2
5388,2016-11-13,2016-11-12,BOSTON_CELTICS,INDIANA_PACERS,105,99,5389,6
5389,2016-11-13,2016-11-12,LOS_ANGELES_LAKERS,NEW_ORLEANS_PELICANS,126,99,5390,27
5390,2016-11-13,2016-11-12,PHILADELPHIA_76ERS,ATLANTA_HAWKS,96,117,5391,21
5391,2016-11-13,2016-11-12,NEW_YORK_KNICKS,TORONTO_RAPTORS,107,118,5392,11
5392,2016-11-13,2016-11-12,WASHINGTON_WIZARDS,CHICAGO_BULLS,95,106,5393,11
5393,2016-11-13,2016-11-12,SAN_ANTONIO_SPURS,HOUSTON_ROCKETS,106,100,5394,6
5394,2016-11-13,2016-11-12,UTAH_JAZZ,MIAMI_HEAT,102,91,5395,11
5395,2016-11-13,2016-11-12,LOS_ANGELES_CLIPPERS,MINNESOTA_TIMBERWOLVES,119,105,5396,14
5396,2016-11-13,2016-11-12,MEMPHIS_GRIZZLIES,MILWAUKEE_BUCKS,96,106,5397,10
5397,2016-11-13,2016-11-12,DETROIT_PISTONS,DENVER_NUGGETS,106,95,5398,11
5398,2016-11-13,2016-11-12,BROOKLYN_NETS,PHOENIX_SUNS,122,104,5399,18
5399,2016-11-13,2016-11-12,CHARLOTTE_HORNETS,CLEVELAND_CAVALIERS,93,100,5400,7
5400,2016-11-14,2016-11-13,LOS_ANGELES_LAKERS,MINNESOTA_TIMBERWOLVES,99,125,5401,26
5401,2016-11-14,2016-11-13,ORLANDO_MAGIC,OKLAHOMA_CITY_THUNDER,119,117,5402,2
5402,2016-11-14,2016-11-13,PHOENIX_SUNS,GOLDEN_STATE_WARRIORS,120,133,5403,13
5403,2016-11-14,2016-11-13,DENVER_NUGGETS,PORTLAND_TRAIL_BLAZERS,105,112,5404,7
5404,2016-11-15,2016-11-14,ORLANDO_MAGIC,INDIANA_PACERS,69,88,5405,19
5405,2016-11-15,2016-11-14,OKLAHOMA_CITY_THUNDER,DETROIT_PISTONS,88,104,5406,16
5406,2016-11-15,2016-11-14,DALLAS_MAVERICKS,NEW_YORK_KNICKS,77,93,5407,16
5407,2016-11-15,2016-11-14,PHILADELPHIA_76ERS,HOUSTON_ROCKETS,88,115,5408,27
5408,2016-11-15,2016-11-14,BOSTON_CELTICS,NEW_ORLEANS_PELICANS,105,106,5409,1
5409,2016-11-15,2016-11-14,MIAMI_HEAT,SAN_ANTONIO_SPURS,90,94,5410,4
5410,2016-11-15,2016-11-14,MEMPHIS_GRIZZLIES,UTAH_JAZZ,102,96,5411,6
5411,2016-11-15,2016-11-14,BROOKLYN_NETS,LOS_ANGELES_CLIPPERS,95,127,5412,32
5412,2016-11-16,2016-11-15,TORONTO_RAPTORS,CLEVELAND_CAVALIERS,117,121,5413,4
5413,2016-11-16,2016-11-15,ATLANTA_HAWKS,MIAMI_HEAT,93,90,5414,3
5414,2016-11-16,2016-11-15,CHARLOTTE_HORNETS,MINNESOTA_TIMBERWOLVES,115,108,5415,7
5415,2016-11-16,2016-11-15,CHICAGO_BULLS,PORTLAND_TRAIL_BLAZERS,113,88,5416,25
5416,2016-11-16,2016-11-15,BROOKLYN_NETS,LOS_ANGELES_LAKERS,118,125,5417,7
5417,2016-11-17,2016-11-16,CLEVELAND_CAVALIERS,INDIANA_PACERS,93,103,5418,10
5418,2016-11-17,2016-11-16,NEW_ORLEANS_PELICANS,ORLANDO_MAGIC,82,89,5419,7
5419,2016-11-17,2016-11-16,WASHINGTON_WIZARDS,PHILADELPHIA_76ERS,102,109,5420,7
5420,2016-11-17,2016-11-16,MILWAUKEE_BUCKS,ATLANTA_HAWKS,100,107,5421,7
5421,2016-11-17,2016-11-16,DALLAS_MAVERICKS,BOSTON_CELTICS,83,90,5422,7
5422,2016-11-17,2016-11-16,DETROIT_PISTONS,NEW_YORK_KNICKS,102,105,5423,3
5423,2016-11-17,2016-11-16,HOUSTON_ROCKETS,OKLAHOMA_CITY_THUNDER,103,105,5424,2
5424,2016-11-17,2016-11-16,GOLDEN_STATE_WARRIORS,TORONTO_RAPTORS,127,121,5425,6
5425,2016-11-17,2016-11-16,PHOENIX_SUNS,DENVER_NUGGETS,104,120,5426,16
5426,2016-11-17,2016-11-16,MEMPHIS_GRIZZLIES,LOS_ANGELES_CLIPPERS,111,107,5427,4
5427,2016-11-17,2016-11-16,SAN_ANTONIO_SPURS,SACRAMENTO_KINGS,110,105,5428,5
5428,2016-11-18,2016-11-17,NEW_YORK_KNICKS,WASHINGTON_WIZARDS,112,119,5429,7
5429,2016-11-18,2016-11-17,MILWAUKEE_BUCKS,MIAMI_HEAT,73,96,5430,23
5430,2016-11-18,2016-11-17,PORTLAND_TRAIL_BLAZERS,HOUSTON_ROCKETS,109,126,5431,17
5431,2016-11-18,2016-11-17,PHILADELPHIA_76ERS,MINNESOTA_TIMBERWOLVES,86,110,5432,24
5432,2016-11-18,2016-11-17,CHICAGO_BULLS,UTAH_JAZZ,85,77,5433,8
5433,2016-11-19,2016-11-18,ATLANTA_HAWKS,CHARLOTTE_HORNETS,96,100,5434,4
5434,2016-11-19,2016-11-18,PHOENIX_SUNS,INDIANA_PACERS,116,96,5435,20
5435,2016-11-19,2016-11-18,DETROIT_PISTONS,CLEVELAND_CAVALIERS,81,104,5436,23
5436,2016-11-19,2016-11-18,GOLDEN_STATE_WARRIORS,BOSTON_CELTICS,104,88,5437,16
5437,2016-11-19,2016-11-18,PORTLAND_TRAIL_BLAZERS,NEW_ORLEANS_PELICANS,101,113,5438,12
5438,2016-11-19,2016-11-18,BROOKLYN_NETS,OKLAHOMA_CITY_THUNDER,105,124,5439,19
5439,2016-11-19,2016-11-18,MEMPHIS_GRIZZLIES,DALLAS_MAVERICKS,80,64,5440,16
5440,2016-11-19,2016-11-18,TORONTO_RAPTORS,DENVER_NUGGETS,113,111,5441,2
5441,2016-11-19,2016-11-18,SAN_ANTONIO_SPURS,LOS_ANGELES_LAKERS,116,107,5442,9
5442,2016-11-19,2016-11-18,LOS_ANGELES_CLIPPERS,SACRAMENTO_KINGS,121,115,5443,6
5443,2016-11-19,2016-11-18,UTAH_JAZZ,HOUSTON_ROCKETS,102,111,5444,9
5444,2016-11-20,2016-11-19,BOSTON_CELTICS,DETROIT_PISTONS,94,92,5445,2
5445,2016-11-20,2016-11-19,CHARLOTTE_HORNETS,NEW_ORLEANS_PELICANS,116,121,5446,5
5446,2016-11-20,2016-11-19,DALLAS_MAVERICKS,ORLANDO_MAGIC,87,95,5447,8
5447,2016-11-20,2016-11-19,MIAMI_HEAT,WASHINGTON_WIZARDS,114,111,5448,3
5448,2016-11-20,2016-11-19,PHOENIX_SUNS,PHILADELPHIA_76ERS,105,120,5449,15
5449,2016-11-20,2016-11-19,MINNESOTA_TIMBERWOLVES,MEMPHIS_GRIZZLIES,71,93,5450,22
5450,2016-11-20,2016-11-19,GOLDEN_STATE_WARRIORS,MILWAUKEE_BUCKS,124,121,5451,3
5451,2016-11-20,2016-11-19,CHICAGO_BULLS,LOS_ANGELES_CLIPPERS,95,102,5452,7
5452,2016-11-20,2016-11-19,ATLANTA_HAWKS,NEW_YORK_KNICKS,94,104,5453,10
5453,2016-11-20,2016-11-19,PORTLAND_TRAIL_BLAZERS,BROOKLYN_NETS,129,109,5454,20
5454,2016-11-21,2016-11-20,INDIANA_PACERS,OKLAHOMA_CITY_THUNDER,115,111,5455,4
5455,2016-11-21,2016-11-20,UTAH_JAZZ,DENVER_NUGGETS,91,105,5456,14
5456,2016-11-21,2016-11-20,TORONTO_RAPTORS,SACRAMENTO_KINGS,99,102,5457,3
5457,2016-11-21,2016-11-20,CHICAGO_BULLS,LOS_ANGELES_LAKERS,118,110,5458,8
5458,2016-11-22,2016-11-21,MEMPHIS_GRIZZLIES,CHARLOTTE_HORNETS,105,90,5459,15
5459,2016-11-22,2016-11-21,GOLDEN_STATE_WARRIORS,INDIANA_PACERS,120,83,5460,37
5460,2016-11-22,2016-11-21,MIAMI_HEAT,PHILADELPHIA_76ERS,94,101,5461,7
5461,2016-11-22,2016-11-21,PHOENIX_SUNS,WASHINGTON_WIZARDS,101,106,5462,5
5462,2016-11-22,2016-11-21,HOUSTON_ROCKETS,DETROIT_PISTONS,99,96,5463,3
5463,2016-11-22,2016-11-21,ORLANDO_MAGIC,MILWAUKEE_BUCKS,89,93,5464,4
5464,2016-11-22,2016-11-21,BOSTON_CELTICS,MINNESOTA_TIMBERWOLVES,99,93,5465,6
5465,2016-11-22,2016-11-21,DALLAS_MAVERICKS,SAN_ANTONIO_SPURS,91,96,5466,5
5466,2016-11-22,2016-11-21,TORONTO_RAPTORS,LOS_ANGELES_CLIPPERS,115,123,5467,8
5467,2016-11-23,2016-11-22,NEW_ORLEANS_PELICANS,ATLANTA_HAWKS,112,94,5468,18
5468,2016-11-23,2016-11-22,PORTLAND_TRAIL_BLAZERS,NEW_YORK_KNICKS,103,107,5469,4
5469,2016-11-23,2016-11-22,CHICAGO_BULLS,DENVER_NUGGETS,107,110,5470,3
5470,2016-11-23,2016-11-22,OKLAHOMA_CITY_THUNDER,LOS_ANGELES_LAKERS,109,111,5471,2
5471,2016-11-24,2016-11-23,SAN_ANTONIO_SPURS,CHARLOTTE_HORNETS,119,114,5472,5
5472,2016-11-24,2016-11-23,PORTLAND_TRAIL_BLAZERS,CLEVELAND_CAVALIERS,125,137,5473,12
5473,2016-11-24,2016-11-23,ATLANTA_HAWKS,INDIANA_PACERS,96,85,5474,11
5474,2016-11-24,2016-11-23,PHOENIX_SUNS,ORLANDO_MAGIC,92,87,5475,5
5475,2016-11-24,2016-11-23,MEMPHIS_GRIZZLIES,PHILADELPHIA_76ERS,104,99,5476,5
5476,2016-11-24,2016-11-23,BOSTON_CELTICS,BROOKLYN_NETS,111,92,5477,19
5477,2016-11-24,2016-11-23,MIAMI_HEAT,DETROIT_PISTONS,84,107,5478,23
5478,2016-11-24,2016-11-23,TORONTO_RAPTORS,HOUSTON_ROCKETS,115,102,5479,13
5479,2016-11-24,2016-11-23,LOS_ANGELES_CLIPPERS,DALLAS_MAVERICKS,124,104,5480,20
5480,2016-11-24,2016-11-23,DENVER_NUGGETS,UTAH_JAZZ,83,108,5481,25
5481,2016-11-24,2016-11-23,MINNESOTA_TIMBERWOLVES,NEW_ORLEANS_PELICANS,96,117,5482,21
5482,2016-11-24,2016-11-23,LOS_ANGELES_LAKERS,GOLDEN_STATE_WARRIORS,106,149,5483,43
5483,2016-11-24,2016-11-23,OKLAHOMA_CITY_THUNDER,SACRAMENTO_KINGS,101,116,5484,15
5484,2016-11-25,2016-11-24,SAN_ANTONIO_SPURS,BOSTON_CELTICS,109,103,5485,6
5485,2016-11-26,2016-11-25,WASHINGTON_WIZARDS,ORLANDO_MAGIC,94,91,5486,3
5486,2016-11-26,2016-11-25,DALLAS_MAVERICKS,CLEVELAND_CAVALIERS,90,128,5487,38
5487,2016-11-26,2016-11-25,LOS_ANGELES_CLIPPERS,DETROIT_PISTONS,97,108,5488,11
5488,2016-11-26,2016-11-25,CHARLOTTE_HORNETS,NEW_YORK_KNICKS,111,113,5489,2
5489,2016-11-26,2016-11-25,CHICAGO_BULLS,PHILADELPHIA_76ERS,105,89,5490,16
5490,2016-11-26,2016-11-25,BROOKLYN_NETS,INDIANA_PACERS,97,118,5491,21
5491,2016-11-26,2016-11-25,MIAMI_HEAT,MEMPHIS_GRIZZLIES,90,81,5492,9
5492,2016-11-26,2016-11-25,TORONTO_RAPTORS,MILWAUKEE_BUCKS,105,99,5493,6
5493,2016-11-26,2016-11-25,ATLANTA_HAWKS,UTAH_JAZZ,68,95,5494,27
5494,2016-11-26,2016-11-25,OKLAHOMA_CITY_THUNDER,DENVER_NUGGETS,132,129,5495,3
5495,2016-11-26,2016-11-25,MINNESOTA_TIMBERWOLVES,PHOENIX_SUNS,98,85,5496,13
5496,2016-11-26,2016-11-25,NEW_ORLEANS_PELICANS,PORTLAND_TRAIL_BLAZERS,104,119,5497,15
5497,2016-11-26,2016-11-25,GOLDEN_STATE_WARRIORS,LOS_ANGELES_LAKERS,109,85,5498,24
5498,2016-11-26,2016-11-25,HOUSTON_ROCKETS,SACRAMENTO_KINGS,117,104,5499,13
5499,2016-11-27,2016-11-26,NEW_YORK_KNICKS,CHARLOTTE_HORNETS,102,107,5500,5
5500,2016-11-27,2016-11-26,SAN_ANTONIO_SPURS,WASHINGTON_WIZARDS,112,100,5501,12
5501,2016-11-27,2016-11-26,MEMPHIS_GRIZZLIES,MIAMI_HEAT,110,107,5502,3
5502,2016-11-27,2016-11-26,DETROIT_PISTONS,OKLAHOMA_CITY_THUNDER,88,106,5503,18
5503,2016-11-27,2016-11-26,MINNESOTA_TIMBERWOLVES,GOLDEN_STATE_WARRIORS,102,115,5504,13
5504,2016-11-27,2016-11-26,CLEVELAND_CAVALIERS,PHILADELPHIA_76ERS,112,108,5505,4
5505,2016-11-27,2016-11-26,DENVER_NUGGETS,PHOENIX_SUNS,120,114,5506,6
5506,2016-11-27,2016-11-26,SACRAMENTO_KINGS,BROOKLYN_NETS,122,105,5507,17
5507,2016-11-27,2016-11-26,LOS_ANGELES_CLIPPERS,INDIANA_PACERS,70,91,5508,21
5508,2016-11-27,2016-11-26,MILWAUKEE_BUCKS,ORLANDO_MAGIC,104,96,5509,8
5509,2016-11-28,2016-11-27,NEW_ORLEANS_PELICANS,DALLAS_MAVERICKS,81,91,5510,10
5510,2016-11-28,2016-11-27,HOUSTON_ROCKETS,PORTLAND_TRAIL_BLAZERS,130,114,5511,16
5511,2016-11-28,2016-11-27,ATLANTA_HAWKS,LOS_ANGELES_LAKERS,94,109,5512,15
5512,2016-11-29,2016-11-28,SACRAMENTO_KINGS,WASHINGTON_WIZARDS,95,101,5513,6
5513,2016-11-29,2016-11-28,BOSTON_CELTICS,MIAMI_HEAT,112,104,5514,8
5514,2016-11-29,2016-11-28,OKLAHOMA_CITY_THUNDER,NEW_YORK_KNICKS,112,103,5515,9
5515,2016-11-29,2016-11-28,PHILADELPHIA_76ERS,TORONTO_RAPTORS,95,122,5516,27
5516,2016-11-29,2016-11-28,CHARLOTTE_HORNETS,MEMPHIS_GRIZZLIES,104,85,5517,19
5517,2016-11-29,2016-11-28,UTAH_JAZZ,MINNESOTA_TIMBERWOLVES,112,103,5518,9
5518,2016-11-29,2016-11-28,ATLANTA_HAWKS,GOLDEN_STATE_WARRIORS,100,105,5519,5
5519,2016-11-30,2016-11-29,DETROIT_PISTONS,CHARLOTTE_HORNETS,112,89,5520,23
5520,2016-11-30,2016-11-29,LOS_ANGELES_CLIPPERS,BROOKLYN_NETS,122,127,5521,5
5521,2016-11-30,2016-11-29,CLEVELAND_CAVALIERS,MILWAUKEE_BUCKS,101,118,5522,17
5522,2016-11-30,2016-11-29,LOS_ANGELES_LAKERS,NEW_ORLEANS_PELICANS,88,105,5523,17
5523,2016-11-30,2016-11-29,ORLANDO_MAGIC,SAN_ANTONIO_SPURS,95,83,5524,12
5524,2016-11-30,2016-11-29,HOUSTON_ROCKETS,UTAH_JAZZ,101,120,5525,19
5525,2016-12-01,2016-11-30,DETROIT_PISTONS,BOSTON_CELTICS,121,114,5526,7
5526,2016-12-01,2016-11-30,MEMPHIS_GRIZZLIES,TORONTO_RAPTORS,105,120,5527,15
5527,2016-12-01,2016-11-30,LOS_ANGELES_LAKERS,CHICAGO_BULLS,96,90,5528,6
5528,2016-12-01,2016-11-30,NEW_YORK_KNICKS,MINNESOTA_TIMBERWOLVES,106,104,5529,2
5529,2016-12-01,2016-11-30,WASHINGTON_WIZARDS,OKLAHOMA_CITY_THUNDER,115,126,5530,11
5530,2016-12-01,2016-11-30,SAN_ANTONIO_SPURS,DALLAS_MAVERICKS,94,87,5531,7
5531,2016-12-01,2016-11-30,MIAMI_HEAT,DENVER_NUGGETS,106,98,5532,8
5532,2016-12-01,2016-11-30,ATLANTA_HAWKS,PHOENIX_SUNS,107,109,5533,2
5533,2016-12-01,2016-11-30,INDIANA_PACERS,PORTLAND_TRAIL_BLAZERS,109,131,5534,22
5534,2016-12-02,2016-12-01,DALLAS_MAVERICKS,CHARLOTTE_HORNETS,87,97,5535,10
5535,2016-12-02,2016-12-01,MILWAUKEE_BUCKS,BROOKLYN_NETS,111,93,5536,18
5536,2016-12-02,2016-12-01,LOS_ANGELES_CLIPPERS,CLEVELAND_CAVALIERS,113,94,5537,19
5537,2016-12-02,2016-12-01,ORLANDO_MAGIC,MEMPHIS_GRIZZLIES,94,95,5538,1
5538,2016-12-02,2016-12-01,MIAMI_HEAT,UTAH_JAZZ,111,110,5539,1
5539,2016-12-02,2016-12-01,HOUSTON_ROCKETS,GOLDEN_STATE_WARRIORS,132,127,5540,5
5540,2016-12-03,2016-12-02,ORLANDO_MAGIC,PHILADELPHIA_76ERS,105,88,5541,17
5541,2016-12-03,2016-12-02,SACRAMENTO_KINGS,BOSTON_CELTICS,92,97,5542,5
5542,2016-12-03,2016-12-02,MINNESOTA_TIMBERWOLVES,NEW_YORK_KNICKS,114,118,5543,4
5543,2016-12-03,2016-12-02,LOS_ANGELES_LAKERS,TORONTO_RAPTORS,80,113,5544,33
5544,2016-12-03,2016-12-02,DETROIT_PISTONS,ATLANTA_HAWKS,121,85,5545,36
5545,2016-12-03,2016-12-02,CLEVELAND_CAVALIERS,CHICAGO_BULLS,105,111,5546,6
5546,2016-12-03,2016-12-02,LOS_ANGELES_CLIPPERS,NEW_ORLEANS_PELICANS,114,96,5547,18
5547,2016-12-03,2016-12-02,WASHINGTON_WIZARDS,SAN_ANTONIO_SPURS,105,107,5548,2
5548,2016-12-03,2016-12-02,HOUSTON_ROCKETS,DENVER_NUGGETS,128,110,5549,18
5549,2016-12-03,2016-12-02,BROOKLYN_NETS,MILWAUKEE_BUCKS,103,112,5550,9
5550,2016-12-04,2016-12-03,MINNESOTA_TIMBERWOLVES,CHARLOTTE_HORNETS,125,120,5551,5
5551,2016-12-04,2016-12-03,BOSTON_CELTICS,PHILADELPHIA_76ERS,107,106,5552,1
5552,2016-12-04,2016-12-03,ATLANTA_HAWKS,TORONTO_RAPTORS,84,128,5553,44
5553,2016-12-04,2016-12-03,LOS_ANGELES_LAKERS,MEMPHIS_GRIZZLIES,100,103,5554,3
5554,2016-12-04,2016-12-03,CHICAGO_BULLS,DALLAS_MAVERICKS,82,107,5555,25
5555,2016-12-04,2016-12-03,DENVER_NUGGETS,UTAH_JAZZ,98,105,5556,7
5556,2016-12-04,2016-12-03,MIAMI_HEAT,PORTLAND_TRAIL_BLAZERS,92,99,5557,7
5557,2016-12-04,2016-12-03,PHOENIX_SUNS,GOLDEN_STATE_WARRIORS,109,138,5558,29
5558,2016-12-04,2016-12-03,ORLANDO_MAGIC,DETROIT_PISTONS,98,92,5559,6
5559,2016-12-05,2016-12-04,NEW_ORLEANS_PELICANS,OKLAHOMA_CITY_THUNDER,92,101,5560,9
5560,2016-12-05,2016-12-04,SACRAMENTO_KINGS,NEW_YORK_KNICKS,98,106,5561,8
5561,2016-12-05,2016-12-04,INDIANA_PACERS,LOS_ANGELES_CLIPPERS,111,102,5562,9
5562,2016-12-06,2016-12-05,DENVER_NUGGETS,PHILADELPHIA_76ERS,106,98,5563,8
5563,2016-12-06,2016-12-05,OKLAHOMA_CITY_THUNDER,ATLANTA_HAWKS,102,99,5564,3
5564,2016-12-06,2016-12-05,WASHINGTON_WIZARDS,BROOKLYN_NETS,118,113,5565,5
5565,2016-12-06,2016-12-05,CLEVELAND_CAVALIERS,TORONTO_RAPTORS,116,112,5566,4
5566,2016-12-06,2016-12-05,PORTLAND_TRAIL_BLAZERS,CHICAGO_BULLS,112,110,5567,2
5567,2016-12-06,2016-12-05,BOSTON_CELTICS,HOUSTON_ROCKETS,106,107,5568,1
5568,2016-12-06,2016-12-05,SAN_ANTONIO_SPURS,MILWAUKEE_BUCKS,97,96,5569,1
5569,2016-12-06,2016-12-05,MEMPHIS_GRIZZLIES,NEW_ORLEANS_PELICANS,110,108,5570,2
5570,2016-12-06,2016-12-05,CHARLOTTE_HORNETS,DALLAS_MAVERICKS,109,101,5571,8
5571,2016-12-06,2016-12-05,INDIANA_PACERS,GOLDEN_STATE_WARRIORS,106,142,5572,36
5572,2016-12-06,2016-12-05,UTAH_JAZZ,LOS_ANGELES_LAKERS,107,101,5573,6
5573,2016-12-07,2016-12-06,ORLANDO_MAGIC,WASHINGTON_WIZARDS,124,116,5574,8
5574,2016-12-07,2016-12-06,CHICAGO_BULLS,DETROIT_PISTONS,91,102,5575,11
5575,2016-12-07,2016-12-06,NEW_YORK_KNICKS,MIAMI_HEAT,114,103,5576,11
5576,2016-12-07,2016-12-06,PHILADELPHIA_76ERS,MEMPHIS_GRIZZLIES,91,96,5577,5
5577,2016-12-07,2016-12-06,SAN_ANTONIO_SPURS,MINNESOTA_TIMBERWOLVES,105,91,5578,14
5578,2016-12-07,2016-12-06,PHOENIX_SUNS,UTAH_JAZZ,105,112,5579,7
5579,2016-12-08,2016-12-07,DETROIT_PISTONS,CHARLOTTE_HORNETS,77,87,5580,10
5580,2016-12-08,2016-12-07,BOSTON_CELTICS,ORLANDO_MAGIC,117,87,5581,30
5581,2016-12-08,2016-12-07,MIAMI_HEAT,ATLANTA_HAWKS,95,103,5582,8
5582,2016-12-08,2016-12-07,DENVER_NUGGETS,BROOKLYN_NETS,111,116,5583,5
5583,2016-12-08,2016-12-07,LOS_ANGELES_LAKERS,HOUSTON_ROCKETS,95,134,5584,39
5584,2016-12-08,2016-12-07,PORTLAND_TRAIL_BLAZERS,MILWAUKEE_BUCKS,107,115,5585,8
5585,2016-12-08,2016-12-07,CLEVELAND_CAVALIERS,NEW_YORK_KNICKS,126,94,5586,32
5586,2016-12-08,2016-12-07,SACRAMENTO_KINGS,DALLAS_MAVERICKS,120,89,5587,31
5587,2016-12-08,2016-12-07,INDIANA_PACERS,PHOENIX_SUNS,109,94,5588,15
5588,2016-12-08,2016-12-07,GOLDEN_STATE_WARRIORS,LOS_ANGELES_CLIPPERS,115,98,5589,17
5589,2016-12-09,2016-12-08,MINNESOTA_TIMBERWOLVES,TORONTO_RAPTORS,110,124,5590,14
5590,2016-12-09,2016-12-08,DENVER_NUGGETS,WASHINGTON_WIZARDS,85,92,5591,7
5591,2016-12-09,2016-12-08,PORTLAND_TRAIL_BLAZERS,MEMPHIS_GRIZZLIES,86,88,5592,2
5592,2016-12-09,2016-12-08,PHILADELPHIA_76ERS,NEW_ORLEANS_PELICANS,99,88,5593,11
5593,2016-12-09,2016-12-08,GOLDEN_STATE_WARRIORS,UTAH_JAZZ,106,99,5594,7
5594,2016-12-09,2016-12-08,SAN_ANTONIO_SPURS,CHICAGO_BULLS,91,95,5595,4
5595,2016-12-10,2016-12-09,ORLANDO_MAGIC,CHARLOTTE_HORNETS,88,109,5596,21
5596,2016-12-10,2016-12-09,TORONTO_RAPTORS,BOSTON_CELTICS,101,94,5597,7
5597,2016-12-10,2016-12-09,MIAMI_HEAT,CLEVELAND_CAVALIERS,84,114,5598,30
5598,2016-12-10,2016-12-09,ATLANTA_HAWKS,MILWAUKEE_BUCKS,114,110,5599,4
5599,2016-12-10,2016-12-09,DETROIT_PISTONS,MINNESOTA_TIMBERWOLVES,117,90,5600,27
5600,2016-12-10,2016-12-09,HOUSTON_ROCKETS,OKLAHOMA_CITY_THUNDER,102,99,5601,3
5601,2016-12-10,2016-12-09,INDIANA_PACERS,DALLAS_MAVERICKS,103,111,5602,8
5602,2016-12-10,2016-12-09,PHOENIX_SUNS,LOS_ANGELES_LAKERS,119,115,5603,4
5603,2016-12-10,2016-12-09,NEW_YORK_KNICKS,SACRAMENTO_KINGS,103,100,5604,3
5604,2016-12-11,2016-12-10,PORTLAND_TRAIL_BLAZERS,INDIANA_PACERS,111,118,5605,7
5605,2016-12-11,2016-12-10,DENVER_NUGGETS,ORLANDO_MAGIC,121,113,5606,8
5606,2016-12-11,2016-12-10,MILWAUKEE_BUCKS,WASHINGTON_WIZARDS,105,110,5607,5
5607,2016-12-11,2016-12-10,CHARLOTTE_HORNETS,CLEVELAND_CAVALIERS,105,116,5608,11
5608,2016-12-11,2016-12-10,MIAMI_HEAT,CHICAGO_BULLS,100,105,5609,5
5609,2016-12-11,2016-12-10,DALLAS_MAVERICKS,HOUSTON_ROCKETS,87,109,5610,22
5610,2016-12-11,2016-12-10,GOLDEN_STATE_WARRIORS,MEMPHIS_GRIZZLIES,89,110,5611,21
5611,2016-12-11,2016-12-10,BROOKLYN_NETS,SAN_ANTONIO_SPURS,101,130,5612,29
5612,2016-12-11,2016-12-10,SACRAMENTO_KINGS,UTAH_JAZZ,84,104,5613,20
5613,2016-12-11,2016-12-10,NEW_ORLEANS_PELICANS,LOS_ANGELES_CLIPPERS,105,133,5614,28
5614,2016-12-11,2016-12-10,PHILADELPHIA_76ERS,DETROIT_PISTONS,97,79,5615,18
5615,2016-12-12,2016-12-11,GOLDEN_STATE_WARRIORS,MINNESOTA_TIMBERWOLVES,116,108,5616,8
5616,2016-12-12,2016-12-11,BOSTON_CELTICS,OKLAHOMA_CITY_THUNDER,96,99,5617,3
5617,2016-12-12,2016-12-11,NEW_ORLEANS_PELICANS,PHOENIX_SUNS,120,119,5618,1
5618,2016-12-12,2016-12-11,NEW_YORK_KNICKS,LOS_ANGELES_LAKERS,118,112,5619,6
5619,2016-12-13,2016-12-12,CHARLOTTE_HORNETS,INDIANA_PACERS,94,110,5620,16
5620,2016-12-13,2016-12-12,WASHINGTON_WIZARDS,MIAMI_HEAT,101,112,5621,11
5621,2016-12-13,2016-12-12,MILWAUKEE_BUCKS,TORONTO_RAPTORS,100,122,5622,22
5622,2016-12-13,2016-12-12,BROOKLYN_NETS,HOUSTON_ROCKETS,118,122,5623,4
5623,2016-12-13,2016-12-12,DENVER_NUGGETS,DALLAS_MAVERICKS,92,112,5624,20
5624,2016-12-13,2016-12-12,PORTLAND_TRAIL_BLAZERS,LOS_ANGELES_CLIPPERS,120,121,5625,1
5625,2016-12-13,2016-12-12,LOS_ANGELES_LAKERS,SACRAMENTO_KINGS,92,116,5626,24
5626,2016-12-14,2016-12-13,MEMPHIS_GRIZZLIES,CLEVELAND_CAVALIERS,86,103,5627,17
5627,2016-12-14,2016-12-13,ORLANDO_MAGIC,ATLANTA_HAWKS,131,120,5628,11
5628,2016-12-14,2016-12-13,MINNESOTA_TIMBERWOLVES,CHICAGO_BULLS,99,94,5629,5
5629,2016-12-14,2016-12-13,GOLDEN_STATE_WARRIORS,NEW_ORLEANS_PELICANS,113,109,5630,4
5630,2016-12-14,2016-12-13,NEW_YORK_KNICKS,PHOENIX_SUNS,111,113,5631,2
5631,2016-12-14,2016-12-13,OKLAHOMA_CITY_THUNDER,PORTLAND_TRAIL_BLAZERS,95,114,5632,19
5632,2016-12-15,2016-12-14,INDIANA_PACERS,MIAMI_HEAT,89,95,5633,6
5633,2016-12-15,2016-12-14,LOS_ANGELES_CLIPPERS,ORLANDO_MAGIC,113,108,5634,5
5634,2016-12-15,2016-12-14,TORONTO_RAPTORS,PHILADELPHIA_76ERS,123,114,5635,9
5635,2016-12-15,2016-12-14,CHARLOTTE_HORNETS,WASHINGTON_WIZARDS,106,109,5636,3
5636,2016-12-15,2016-12-14,LOS_ANGELES_LAKERS,BROOKLYN_NETS,97,107,5637,10
5637,2016-12-15,2016-12-14,SACRAMENTO_KINGS,HOUSTON_ROCKETS,98,132,5638,34
5638,2016-12-15,2016-12-14,CLEVELAND_CAVALIERS,MEMPHIS_GRIZZLIES,85,93,5639,8
5639,2016-12-15,2016-12-14,DETROIT_PISTONS,DALLAS_MAVERICKS,95,85,5640,10
5640,2016-12-15,2016-12-14,OKLAHOMA_CITY_THUNDER,UTAH_JAZZ,89,109,5641,20
5641,2016-12-15,2016-12-14,BOSTON_CELTICS,SAN_ANTONIO_SPURS,101,108,5642,7
5642,2016-12-16,2016-12-15,CHICAGO_BULLS,MILWAUKEE_BUCKS,97,108,5643,11
5643,2016-12-16,2016-12-15,INDIANA_PACERS,NEW_ORLEANS_PELICANS,95,102,5644,7
5644,2016-12-16,2016-12-15,PORTLAND_TRAIL_BLAZERS,DENVER_NUGGETS,120,132,5645,12
5645,2016-12-16,2016-12-15,SAN_ANTONIO_SPURS,PHOENIX_SUNS,107,92,5646,15
5646,2016-12-16,2016-12-15,NEW_YORK_KNICKS,GOLDEN_STATE_WARRIORS,90,103,5647,13
5647,2016-12-17,2016-12-16,BROOKLYN_NETS,ORLANDO_MAGIC,111,118,5648,7
5648,2016-12-17,2016-12-16,DETROIT_PISTONS,WASHINGTON_WIZARDS,108,122,5649,14
5649,2016-12-17,2016-12-16,CHARLOTTE_HORNETS,BOSTON_CELTICS,88,96,5650,8
5650,2016-12-17,2016-12-16,ATLANTA_HAWKS,TORONTO_RAPTORS,125,121,5651,4
5651,2016-12-17,2016-12-16,MILWAUKEE_BUCKS,CHICAGO_BULLS,95,69,5652,26
5652,2016-12-17,2016-12-16,NEW_ORLEANS_PELICANS,HOUSTON_ROCKETS,100,122,5653,22
5653,2016-12-17,2016-12-16,SACRAMENTO_KINGS,MEMPHIS_GRIZZLIES,96,92,5654,4
5654,2016-12-17,2016-12-16,LOS_ANGELES_CLIPPERS,MIAMI_HEAT,102,98,5655,4
5655,2016-12-17,2016-12-16,LOS_ANGELES_LAKERS,PHILADELPHIA_76ERS,100,89,5656,11
5656,2016-12-17,2016-12-16,DALLAS_MAVERICKS,UTAH_JAZZ,100,103,5657,3
5657,2016-12-17,2016-12-16,PHOENIX_SUNS,OKLAHOMA_CITY_THUNDER,101,114,5658,13
5658,2016-12-18,2016-12-17,INDIANA_PACERS,DETROIT_PISTONS,105,90,5659,15
5659,2016-12-18,2016-12-17,CHARLOTTE_HORNETS,ATLANTA_HAWKS,107,99,5660,8
5660,2016-12-18,2016-12-17,LOS_ANGELES_LAKERS,CLEVELAND_CAVALIERS,108,119,5661,11
5661,2016-12-18,2016-12-17,HOUSTON_ROCKETS,MINNESOTA_TIMBERWOLVES,111,109,5662,2
5662,2016-12-18,2016-12-17,NEW_YORK_KNICKS,DENVER_NUGGETS,114,127,5663,13
5663,2016-12-18,2016-12-17,PORTLAND_TRAIL_BLAZERS,GOLDEN_STATE_WARRIORS,90,135,5664,45
5664,2016-12-18,2016-12-17,LOS_ANGELES_CLIPPERS,WASHINGTON_WIZARDS,110,117,5665,7
5665,2016-12-18,2016-12-17,SACRAMENTO_KINGS,DALLAS_MAVERICKS,79,99,5666,20
5666,2016-12-18,2016-12-17,UTAH_JAZZ,MEMPHIS_GRIZZLIES,82,73,5667,9
5667,2016-12-18,2016-12-17,BOSTON_CELTICS,MIAMI_HEAT,105,95,5668,10
5668,2016-12-18,2016-12-17,TORONTO_RAPTORS,ORLANDO_MAGIC,109,79,5669,30
5669,2016-12-18,2016-12-17,BROOKLYN_NETS,PHILADELPHIA_76ERS,107,108,5670,1
5670,2016-12-19,2016-12-18,NEW_ORLEANS_PELICANS,SAN_ANTONIO_SPURS,100,113,5671,13
5671,2016-12-20,2016-12-19,WASHINGTON_WIZARDS,INDIANA_PACERS,105,107,5672,2
5672,2016-12-20,2016-12-19,DETROIT_PISTONS,CHICAGO_BULLS,82,113,5673,31
5673,2016-12-20,2016-12-19,PHOENIX_SUNS,MINNESOTA_TIMBERWOLVES,108,115,5674,7
5674,2016-12-20,2016-12-19,ATLANTA_HAWKS,OKLAHOMA_CITY_THUNDER,110,108,5675,2
5675,2016-12-20,2016-12-19,DALLAS_MAVERICKS,DENVER_NUGGETS,107,117,5676,10
5676,2016-12-21,2016-12-20,LOS_ANGELES_LAKERS,CHARLOTTE_HORNETS,113,117,5677,4
5677,2016-12-21,2016-12-20,NEW_ORLEANS_PELICANS,PHILADELPHIA_76ERS,108,93,5678,15
5678,2016-12-21,2016-12-20,ORLANDO_MAGIC,MIAMI_HEAT,136,130,5679,6
5679,2016-12-21,2016-12-20,INDIANA_PACERS,NEW_YORK_KNICKS,111,118,5680,7
5680,2016-12-21,2016-12-20,BROOKLYN_NETS,TORONTO_RAPTORS,104,116,5681,12
5681,2016-12-21,2016-12-20,SAN_ANTONIO_SPURS,HOUSTON_ROCKETS,102,100,5682,2
5682,2016-12-21,2016-12-20,BOSTON_CELTICS,MEMPHIS_GRIZZLIES,112,109,5683,3
5683,2016-12-21,2016-12-20,CLEVELAND_CAVALIERS,MILWAUKEE_BUCKS,114,108,5684,6
5684,2016-12-21,2016-12-20,UTAH_JAZZ,GOLDEN_STATE_WARRIORS,74,104,5685,30
5685,2016-12-21,2016-12-20,DENVER_NUGGETS,LOS_ANGELES_CLIPPERS,102,119,5686,17
5686,2016-12-21,2016-12-20,PORTLAND_TRAIL_BLAZERS,SACRAMENTO_KINGS,121,126,5687,5
5687,2016-12-22,2016-12-21,MILWAUKEE_BUCKS,CLEVELAND_CAVALIERS,102,113,5688,11
5688,2016-12-22,2016-12-21,MINNESOTA_TIMBERWOLVES,ATLANTA_HAWKS,92,84,5689,8
5689,2016-12-22,2016-12-21,MEMPHIS_GRIZZLIES,DETROIT_PISTONS,98,86,5690,12
5690,2016-12-22,2016-12-21,WASHINGTON_WIZARDS,CHICAGO_BULLS,107,97,5691,10
5691,2016-12-22,2016-12-21,OKLAHOMA_CITY_THUNDER,NEW_ORLEANS_PELICANS,121,110,5692,11
5692,2016-12-22,2016-12-21,HOUSTON_ROCKETS,PHOENIX_SUNS,125,111,5693,14
5693,2016-12-22,2016-12-21,SACRAMENTO_KINGS,UTAH_JAZZ,94,93,5694,1
5694,2016-12-22,2016-12-21,DALLAS_MAVERICKS,PORTLAND_TRAIL_BLAZERS,96,95,5695,1
5695,2016-12-23,2016-12-22,BOSTON_CELTICS,INDIANA_PACERS,109,102,5696,7
5696,2016-12-23,2016-12-22,GOLDEN_STATE_WARRIORS,BROOKLYN_NETS,117,101,5697,16
5697,2016-12-23,2016-12-22,ORLANDO_MAGIC,NEW_YORK_KNICKS,95,106,5698,11
5698,2016-12-23,2016-12-22,LOS_ANGELES_LAKERS,MIAMI_HEAT,107,115,5699,8
5699,2016-12-23,2016-12-22,SAN_ANTONIO_SPURS,LOS_ANGELES_CLIPPERS,101,106,5700,5
5700,2016-12-24,2016-12-23,CHICAGO_BULLS,CHARLOTTE_HORNETS,91,103,5701,12
5701,2016-12-24,2016-12-23,LOS_ANGELES_LAKERS,ORLANDO_MAGIC,90,109,5702,19
5702,2016-12-24,2016-12-23,OKLAHOMA_CITY_THUNDER,BOSTON_CELTICS,117,112,5703,5
5703,2016-12-24,2016-12-23,BROOKLYN_NETS,CLEVELAND_CAVALIERS,99,119,5704,20
5704,2016-12-24,2016-12-23,GOLDEN_STATE_WARRIORS,DETROIT_PISTONS,119,113,5705,6
5705,2016-12-24,2016-12-23,HOUSTON_ROCKETS,MEMPHIS_GRIZZLIES,109,115,5706,6
5706,2016-12-24,2016-12-23,WASHINGTON_WIZARDS,MILWAUKEE_BUCKS,96,123,5707,27
5707,2016-12-24,2016-12-23,SACRAMENTO_KINGS,MINNESOTA_TIMBERWOLVES,109,105,5708,4
5708,2016-12-24,2016-12-23,MIAMI_HEAT,NEW_ORLEANS_PELICANS,87,91,5709,4
5709,2016-12-24,2016-12-23,ATLANTA_HAWKS,DENVER_NUGGETS,109,108,5710,1
5710,2016-12-24,2016-12-23,PHILADELPHIA_76ERS,PHOENIX_SUNS,116,123,5711,7
5711,2016-12-24,2016-12-23,TORONTO_RAPTORS,UTAH_JAZZ,104,98,5712,6
5712,2016-12-24,2016-12-23,SAN_ANTONIO_SPURS,PORTLAND_TRAIL_BLAZERS,110,90,5713,20
5713,2016-12-24,2016-12-23,DALLAS_MAVERICKS,LOS_ANGELES_CLIPPERS,90,88,5714,2
5714,2016-12-25,2016-12-24,BOSTON_CELTICS,NEW_YORK_KNICKS,119,114,5715,5
5715,2016-12-25,2016-12-24,GOLDEN_STATE_WARRIORS,CLEVELAND_CAVALIERS,108,109,5716,1
5716,2016-12-25,2016-12-24,CHICAGO_BULLS,SAN_ANTONIO_SPURS,100,119,5717,19
5717,2016-12-26,2016-12-25,MINNESOTA_TIMBERWOLVES,OKLAHOMA_CITY_THUNDER,100,112,5718,12
5718,2016-12-26,2016-12-25,LOS_ANGELES_CLIPPERS,LOS_ANGELES_LAKERS,102,111,5719,9
5719,2016-12-27,2016-12-26,MEMPHIS_GRIZZLIES,ORLANDO_MAGIC,102,112,5720,10
5720,2016-12-27,2016-12-26,MILWAUKEE_BUCKS,WASHINGTON_WIZARDS,102,107,5721,5
5721,2016-12-27,2016-12-26,CHARLOTTE_HORNETS,BROOKLYN_NETS,118,120,5722,2
5722,2016-12-27,2016-12-26,CLEVELAND_CAVALIERS,DETROIT_PISTONS,90,106,5723,16
5723,2016-12-27,2016-12-26,INDIANA_PACERS,CHICAGO_BULLS,85,90,5724,5
5724,2016-12-27,2016-12-26,PHOENIX_SUNS,HOUSTON_ROCKETS,115,131,5725,16
5725,2016-12-27,2016-12-26,ATLANTA_HAWKS,MINNESOTA_TIMBERWOLVES,90,104,5726,14
5726,2016-12-27,2016-12-26,DALLAS_MAVERICKS,NEW_ORLEANS_PELICANS,104,111,5727,7
5727,2016-12-27,2016-12-26,TORONTO_RAPTORS,PORTLAND_TRAIL_BLAZERS,95,91,5728,4
5728,2016-12-27,2016-12-26,DENVER_NUGGETS,LOS_ANGELES_CLIPPERS,106,102,5729,4
5729,2016-12-27,2016-12-26,PHILADELPHIA_76ERS,SACRAMENTO_KINGS,100,102,5730,2
5730,2016-12-28,2016-12-27,MEMPHIS_GRIZZLIES,BOSTON_CELTICS,103,113,5731,10
5731,2016-12-28,2016-12-27,OKLAHOMA_CITY_THUNDER,MIAMI_HEAT,106,94,5732,12
5732,2016-12-28,2016-12-27,HOUSTON_ROCKETS,DALLAS_MAVERICKS,123,107,5733,16
5733,2016-12-28,2016-12-27,UTAH_JAZZ,LOS_ANGELES_LAKERS,102,100,5734,2
5734,2016-12-29,2016-12-28,CHARLOTTE_HORNETS,ORLANDO_MAGIC,120,101,5735,19
5735,2016-12-29,2016-12-28,INDIANA_PACERS,WASHINGTON_WIZARDS,105,111,5736,6
5736,2016-12-29,2016-12-28,NEW_YORK_KNICKS,ATLANTA_HAWKS,98,102,5737,4
5737,2016-12-29,2016-12-28,MILWAUKEE_BUCKS,DETROIT_PISTONS,119,94,5738,25
5738,2016-12-29,2016-12-28,BROOKLYN_NETS,CHICAGO_BULLS,99,101,5739,2
5739,2016-12-29,2016-12-28,LOS_ANGELES_CLIPPERS,NEW_ORLEANS_PELICANS,98,102,5740,4
5740,2016-12-29,2016-12-28,PHOENIX_SUNS,SAN_ANTONIO_SPURS,98,119,5741,21
5741,2016-12-29,2016-12-28,MINNESOTA_TIMBERWOLVES,DENVER_NUGGETS,103,105,5742,2
5742,2016-12-29,2016-12-28,SACRAMENTO_KINGS,PORTLAND_TRAIL_BLAZERS,89,102,5743,13
5743,2016-12-29,2016-12-28,TORONTO_RAPTORS,GOLDEN_STATE_WARRIORS,111,121,5744,10
5744,2016-12-30,2016-12-29,MIAMI_HEAT,CHARLOTTE_HORNETS,82,91,5745,9
5745,2016-12-30,2016-12-29,BOSTON_CELTICS,CLEVELAND_CAVALIERS,118,124,5746,6
5746,2016-12-30,2016-12-29,OKLAHOMA_CITY_THUNDER,MEMPHIS_GRIZZLIES,80,114,5747,34
5747,2016-12-30,2016-12-29,TORONTO_RAPTORS,PHOENIX_SUNS,91,99,5748,8
5748,2016-12-30,2016-12-29,PHILADELPHIA_76ERS,UTAH_JAZZ,83,100,5749,17
5749,2016-12-30,2016-12-29,DALLAS_MAVERICKS,LOS_ANGELES_LAKERS,101,89,5750,12
5750,2016-12-30,2016-12-29,CHICAGO_BULLS,INDIANA_PACERS,101,111,5751,10
5751,2016-12-31,2016-12-30,BROOKLYN_NETS,WASHINGTON_WIZARDS,95,118,5752,23
5752,2016-12-31,2016-12-30,MIAMI_HEAT,BOSTON_CELTICS,114,117,5753,3
5753,2016-12-31,2016-12-30,DETROIT_PISTONS,ATLANTA_HAWKS,98,105,5754,7
5754,2016-12-31,2016-12-30,LOS_ANGELES_CLIPPERS,HOUSTON_ROCKETS,116,140,5755,24
5755,2016-12-31,2016-12-30,MILWAUKEE_BUCKS,MINNESOTA_TIMBERWOLVES,99,116,5756,17
5756,2016-12-31,2016-12-30,NEW_YORK_KNICKS,NEW_ORLEANS_PELICANS,92,104,5757,12
5757,2016-12-31,2016-12-30,PORTLAND_TRAIL_BLAZERS,SAN_ANTONIO_SPURS,94,110,5758,16
5758,2016-12-31,2016-12-30,PHILADELPHIA_76ERS,DENVER_NUGGETS,124,122,5759,2
5759,2016-12-31,2016-12-30,DALLAS_MAVERICKS,GOLDEN_STATE_WARRIORS,99,108,5760,9
5760,2016-12-31,2016-12-30,MEMPHIS_GRIZZLIES,SACRAMENTO_KINGS,112,98,5761,14
5761,2017-01-01,2016-12-31,MILWAUKEE_BUCKS,CHICAGO_BULLS,116,96,5762,20
5762,2017-01-01,2016-12-31,CLEVELAND_CAVALIERS,CHARLOTTE_HORNETS,121,109,5763,12
5763,2017-01-01,2016-12-31,NEW_YORK_KNICKS,HOUSTON_ROCKETS,122,129,5764,7
5764,2017-01-01,2016-12-31,LOS_ANGELES_CLIPPERS,OKLAHOMA_CITY_THUNDER,88,114,5765,26
5765,2017-01-01,2016-12-31,PHOENIX_SUNS,UTAH_JAZZ,86,91,5766,5
5766,2017-01-01,2016-12-31,SAN_ANTONIO_SPURS,ATLANTA_HAWKS,112,114,5767,2
5767,2017-01-01,2016-12-31,ORLANDO_MAGIC,INDIANA_PACERS,104,117,5768,13
5768,2017-01-01,2016-12-31,DETROIT_PISTONS,MIAMI_HEAT,107,98,5769,9
5769,2017-01-02,2017-01-01,PORTLAND_TRAIL_BLAZERS,MINNESOTA_TIMBERWOLVES,95,89,5770,6
5770,2017-01-02,2017-01-01,TORONTO_RAPTORS,LOS_ANGELES_LAKERS,123,114,5771,9
5771,2017-01-03,2017-01-02,NEW_ORLEANS_PELICANS,CLEVELAND_CAVALIERS,82,90,5772,8
5772,2017-01-03,2017-01-02,OKLAHOMA_CITY_THUNDER,MILWAUKEE_BUCKS,94,98,5773,4
5773,2017-01-03,2017-01-02,UTAH_JAZZ,BROOKLYN_NETS,101,89,5774,12
5774,2017-01-03,2017-01-02,ORLANDO_MAGIC,NEW_YORK_KNICKS,115,103,5775,12
5775,2017-01-03,2017-01-02,CHARLOTTE_HORNETS,CHICAGO_BULLS,111,118,5776,7
5776,2017-01-03,2017-01-02,WASHINGTON_WIZARDS,HOUSTON_ROCKETS,91,101,5777,10
5777,2017-01-03,2017-01-02,DENVER_NUGGETS,GOLDEN_STATE_WARRIORS,119,127,5778,8
5778,2017-01-03,2017-01-02,PHOENIX_SUNS,LOS_ANGELES_CLIPPERS,98,109,5779,11
5779,2017-01-04,2017-01-03,MINNESOTA_TIMBERWOLVES,PHILADELPHIA_76ERS,91,93,5780,2
5780,2017-01-04,2017-01-03,UTAH_JAZZ,BOSTON_CELTICS,104,115,5781,11
5781,2017-01-04,2017-01-03,INDIANA_PACERS,DETROIT_PISTONS,121,116,5782,5
5782,2017-01-04,2017-01-03,WASHINGTON_WIZARDS,DALLAS_MAVERICKS,105,113,5783,8
5783,2017-01-04,2017-01-03,TORONTO_RAPTORS,SAN_ANTONIO_SPURS,82,110,5784,28
5784,2017-01-04,2017-01-03,SACRAMENTO_KINGS,DENVER_NUGGETS,120,113,5785,7
5785,2017-01-04,2017-01-03,MIAMI_HEAT,PHOENIX_SUNS,90,99,5786,9
5786,2017-01-04,2017-01-03,MEMPHIS_GRIZZLIES,LOS_ANGELES_LAKERS,102,116,5787,14
5787,2017-01-05,2017-01-04,OKLAHOMA_CITY_THUNDER,CHARLOTTE_HORNETS,112,123,5788,11
5788,2017-01-05,2017-01-04,ATLANTA_HAWKS,ORLANDO_MAGIC,111,92,5789,19
5789,2017-01-05,2017-01-04,MILWAUKEE_BUCKS,NEW_YORK_KNICKS,105,104,5790,1
5790,2017-01-05,2017-01-04,CHICAGO_BULLS,CLEVELAND_CAVALIERS,106,94,5791,12
5791,2017-01-05,2017-01-04,PORTLAND_TRAIL_BLAZERS,GOLDEN_STATE_WARRIORS,117,125,5792,8
5792,2017-01-05,2017-01-04,MEMPHIS_GRIZZLIES,LOS_ANGELES_CLIPPERS,106,115,5793,9
5793,2017-01-05,2017-01-04,MIAMI_HEAT,SACRAMENTO_KINGS,107,102,5794,5
5794,2017-01-06,2017-01-05,BROOKLYN_NETS,INDIANA_PACERS,109,121,5795,12
5795,2017-01-06,2017-01-05,CHARLOTTE_HORNETS,DETROIT_PISTONS,114,115,5796,1
5796,2017-01-06,2017-01-05,UTAH_JAZZ,TORONTO_RAPTORS,93,101,5797,8
5797,2017-01-06,2017-01-05,OKLAHOMA_CITY_THUNDER,HOUSTON_ROCKETS,116,118,5798,2
5798,2017-01-06,2017-01-05,ATLANTA_HAWKS,NEW_ORLEANS_PELICANS,99,94,5799,5
5799,2017-01-06,2017-01-05,PHOENIX_SUNS,DALLAS_MAVERICKS,102,95,5800,7
5800,2017-01-06,2017-01-05,SAN_ANTONIO_SPURS,DENVER_NUGGETS,127,99,5801,28
5801,2017-01-06,2017-01-05,LOS_ANGELES_LAKERS,PORTLAND_TRAIL_BLAZERS,109,118,5802,9
5802,2017-01-07,2017-01-06,HOUSTON_ROCKETS,ORLANDO_MAGIC,100,93,5803,7
5803,2017-01-07,2017-01-06,MINNESOTA_TIMBERWOLVES,WASHINGTON_WIZARDS,105,112,5804,7
5804,2017-01-07,2017-01-06,PHILADELPHIA_76ERS,BOSTON_CELTICS,106,110,5805,4
5805,2017-01-07,2017-01-06,CLEVELAND_CAVALIERS,BROOKLYN_NETS,116,108,5806,8
5806,2017-01-07,2017-01-06,NEW_YORK_KNICKS,MILWAUKEE_BUCKS,116,111,5807,5
5807,2017-01-07,2017-01-06,MEMPHIS_GRIZZLIES,GOLDEN_STATE_WARRIORS,128,119,5808,9
5808,2017-01-07,2017-01-06,MIAMI_HEAT,LOS_ANGELES_LAKERS,100,127,5809,27
5809,2017-01-07,2017-01-06,LOS_ANGELES_CLIPPERS,SACRAMENTO_KINGS,106,98,5810,8
5810,2017-01-08,2017-01-07,NEW_YORK_KNICKS,INDIANA_PACERS,109,123,5811,14
5811,2017-01-08,2017-01-07,NEW_ORLEANS_PELICANS,BOSTON_CELTICS,108,117,5812,9
5812,2017-01-08,2017-01-07,TORONTO_RAPTORS,CHICAGO_BULLS,118,123,5813,5
5813,2017-01-08,2017-01-07,UTAH_JAZZ,MINNESOTA_TIMBERWOLVES,94,92,5814,2
5814,2017-01-08,2017-01-07,DENVER_NUGGETS,OKLAHOMA_CITY_THUNDER,106,121,5815,15
5815,2017-01-08,2017-01-07,ATLANTA_HAWKS,DALLAS_MAVERICKS,97,82,5816,15
5816,2017-01-08,2017-01-07,CHARLOTTE_HORNETS,SAN_ANTONIO_SPURS,85,102,5817,17
5817,2017-01-08,2017-01-07,PHILADELPHIA_76ERS,BROOKLYN_NETS,105,95,5818,10
5818,2017-01-08,2017-01-07,WASHINGTON_WIZARDS,MILWAUKEE_BUCKS,107,101,5819,6
5819,2017-01-08,2017-01-07,MIAMI_HEAT,LOS_ANGELES_CLIPPERS,86,98,5820,12
5820,2017-01-08,2017-01-07,HOUSTON_ROCKETS,TORONTO_RAPTORS,129,122,5821,7
5821,2017-01-09,2017-01-08,UTAH_JAZZ,MEMPHIS_GRIZZLIES,79,88,5822,9
5822,2017-01-09,2017-01-08,CLEVELAND_CAVALIERS,PHOENIX_SUNS,120,116,5823,4
5823,2017-01-09,2017-01-08,DETROIT_PISTONS,PORTLAND_TRAIL_BLAZERS,125,124,5824,1
5824,2017-01-09,2017-01-08,GOLDEN_STATE_WARRIORS,SACRAMENTO_KINGS,117,106,5825,11
5825,2017-01-09,2017-01-08,ORLANDO_MAGIC,LOS_ANGELES_LAKERS,95,111,5826,16
5826,2017-01-10,2017-01-09,NEW_ORLEANS_PELICANS,NEW_YORK_KNICKS,110,96,5827,14
5827,2017-01-10,2017-01-09,OKLAHOMA_CITY_THUNDER,CHICAGO_BULLS,109,94,5828,15
5828,2017-01-10,2017-01-09,DALLAS_MAVERICKS,MINNESOTA_TIMBERWOLVES,92,101,5829,9
5829,2017-01-11,2017-01-10,CHICAGO_BULLS,WASHINGTON_WIZARDS,99,101,5830,2
5830,2017-01-11,2017-01-10,ATLANTA_HAWKS,BROOKLYN_NETS,117,97,5831,20
5831,2017-01-11,2017-01-10,BOSTON_CELTICS,TORONTO_RAPTORS,106,114,5832,8
5832,2017-01-11,2017-01-10,CHARLOTTE_HORNETS,HOUSTON_ROCKETS,114,121,5833,7
5833,2017-01-11,2017-01-10,MILWAUKEE_BUCKS,SAN_ANTONIO_SPURS,109,107,5834,2
5834,2017-01-11,2017-01-10,CLEVELAND_CAVALIERS,UTAH_JAZZ,92,100,5835,8
5835,2017-01-11,2017-01-10,MIAMI_HEAT,GOLDEN_STATE_WARRIORS,95,107,5836,12
5836,2017-01-11,2017-01-10,PORTLAND_TRAIL_BLAZERS,LOS_ANGELES_LAKERS,108,87,5837,21
5837,2017-01-11,2017-01-10,DETROIT_PISTONS,SACRAMENTO_KINGS,94,100,5838,6
5838,2017-01-12,2017-01-11,NEW_YORK_KNICKS,PHILADELPHIA_76ERS,97,98,5839,1
5839,2017-01-12,2017-01-11,WASHINGTON_WIZARDS,BOSTON_CELTICS,108,117,5840,9
5840,2017-01-12,2017-01-11,HOUSTON_ROCKETS,MINNESOTA_TIMBERWOLVES,105,119,5841,14
5841,2017-01-12,2017-01-11,MEMPHIS_GRIZZLIES,OKLAHOMA_CITY_THUNDER,95,103,5842,8
5842,2017-01-12,2017-01-11,ORLANDO_MAGIC,LOS_ANGELES_CLIPPERS,96,105,5843,9
5843,2017-01-12,2017-01-11,CLEVELAND_CAVALIERS,PORTLAND_TRAIL_BLAZERS,86,102,5844,16
5844,2017-01-12,2017-01-11,INDIANA_PACERS,DENVER_NUGGETS,112,140,5845,28
5845,2017-01-13,2017-01-12,NEW_ORLEANS_PELICANS,BROOKLYN_NETS,104,95,5846,9
5846,2017-01-13,2017-01-12,CHICAGO_BULLS,NEW_YORK_KNICKS,89,104,5847,15
5847,2017-01-13,2017-01-12,LOS_ANGELES_LAKERS,SAN_ANTONIO_SPURS,94,134,5848,40
5848,2017-01-13,2017-01-12,DALLAS_MAVERICKS,PHOENIX_SUNS,113,108,5849,5
5849,2017-01-13,2017-01-12,DETROIT_PISTONS,GOLDEN_STATE_WARRIORS,107,127,5850,20
5850,2017-01-14,2017-01-13,CHARLOTTE_HORNETS,PHILADELPHIA_76ERS,93,102,5851,9
5851,2017-01-14,2017-01-13,BROOKLYN_NETS,TORONTO_RAPTORS,113,132,5852,19
5852,2017-01-14,2017-01-13,BOSTON_CELTICS,ATLANTA_HAWKS,103,101,5853,2
5853,2017-01-14,2017-01-13,MEMPHIS_GRIZZLIES,HOUSTON_ROCKETS,110,105,5854,5
5854,2017-01-14,2017-01-13,MIAMI_HEAT,MILWAUKEE_BUCKS,108,116,5855,8
5855,2017-01-14,2017-01-13,OKLAHOMA_CITY_THUNDER,MINNESOTA_TIMBERWOLVES,86,96,5856,10
5856,2017-01-14,2017-01-13,ORLANDO_MAGIC,PORTLAND_TRAIL_BLAZERS,115,109,5857,6
5857,2017-01-14,2017-01-13,CLEVELAND_CAVALIERS,SACRAMENTO_KINGS,120,108,5858,12
5858,2017-01-14,2017-01-13,DETROIT_PISTONS,UTAH_JAZZ,77,110,5859,33
5859,2017-01-14,2017-01-13,LOS_ANGELES_LAKERS,LOS_ANGELES_CLIPPERS,97,113,5860,16
5860,2017-01-14,2017-01-13,NEW_ORLEANS_PELICANS,CHICAGO_BULLS,99,107,5861,8
5861,2017-01-14,2017-01-13,SAN_ANTONIO_SPURS,PHOENIX_SUNS,105,108,5862,3
5862,2017-01-15,2017-01-14,PHILADELPHIA_76ERS,WASHINGTON_WIZARDS,93,109,5863,16
5863,2017-01-15,2017-01-14,ORLANDO_MAGIC,UTAH_JAZZ,107,114,5864,7
5864,2017-01-15,2017-01-14,MINNESOTA_TIMBERWOLVES,DALLAS_MAVERICKS,87,98,5865,11
5865,2017-01-15,2017-01-14,MILWAUKEE_BUCKS,ATLANTA_HAWKS,98,111,5866,13
5866,2017-01-15,2017-01-14,NEW_YORK_KNICKS,TORONTO_RAPTORS,101,116,5867,15
5867,2017-01-15,2017-01-14,HOUSTON_ROCKETS,BROOKLYN_NETS,137,112,5868,25
5868,2017-01-16,2017-01-15,CHICAGO_BULLS,MEMPHIS_GRIZZLIES,108,104,5869,4
5869,2017-01-16,2017-01-15,OKLAHOMA_CITY_THUNDER,SACRAMENTO_KINGS,122,118,5870,4
5870,2017-01-16,2017-01-15,DETROIT_PISTONS,LOS_ANGELES_LAKERS,102,97,5871,5
5871,2017-01-16,2017-01-15,ATLANTA_HAWKS,NEW_YORK_KNICKS,108,107,5872,1
5872,2017-01-16,2017-01-15,PORTLAND_TRAIL_BLAZERS,WASHINGTON_WIZARDS,101,120,5873,19
5873,2017-01-16,2017-01-15,PHILADELPHIA_76ERS,MILWAUKEE_BUCKS,113,104,5874,9
5874,2017-01-16,2017-01-15,NEW_ORLEANS_PELICANS,INDIANA_PACERS,95,98,5875,3
5875,2017-01-16,2017-01-15,ORLANDO_MAGIC,DENVER_NUGGETS,112,125,5876,13
5876,2017-01-17,2017-01-16,CHARLOTTE_HORNETS,BOSTON_CELTICS,98,108,5877,10
5877,2017-01-17,2017-01-16,CLEVELAND_CAVALIERS,GOLDEN_STATE_WARRIORS,91,126,5878,35
5878,2017-01-17,2017-01-16,UTAH_JAZZ,PHOENIX_SUNS,106,101,5879,5
5879,2017-01-17,2017-01-16,OKLAHOMA_CITY_THUNDER,LOS_ANGELES_CLIPPERS,98,120,5880,22
5880,2017-01-18,2017-01-17,TORONTO_RAPTORS,BROOKLYN_NETS,119,109,5881,10
5881,2017-01-18,2017-01-17,HOUSTON_ROCKETS,MIAMI_HEAT,103,109,5882,6
5882,2017-01-18,2017-01-17,DALLAS_MAVERICKS,CHICAGO_BULLS,99,98,5883,1
5883,2017-01-18,2017-01-17,MINNESOTA_TIMBERWOLVES,SAN_ANTONIO_SPURS,114,122,5884,8
5884,2017-01-18,2017-01-17,DENVER_NUGGETS,LOS_ANGELES_LAKERS,127,121,5885,6
5885,2017-01-19,2017-01-18,PORTLAND_TRAIL_BLAZERS,CHARLOTTE_HORNETS,85,107,5886,22
5886,2017-01-19,2017-01-18,TORONTO_RAPTORS,PHILADELPHIA_76ERS,89,94,5887,5
5887,2017-01-19,2017-01-18,MEMPHIS_GRIZZLIES,WASHINGTON_WIZARDS,101,104,5888,3
5888,2017-01-19,2017-01-18,NEW_YORK_KNICKS,BOSTON_CELTICS,117,106,5889,11
5889,2017-01-19,2017-01-18,ATLANTA_HAWKS,DETROIT_PISTONS,95,118,5890,23
5890,2017-01-19,2017-01-18,MILWAUKEE_BUCKS,HOUSTON_ROCKETS,92,111,5891,19
5891,2017-01-19,2017-01-18,ORLANDO_MAGIC,NEW_ORLEANS_PELICANS,98,118,5892,20
5892,2017-01-19,2017-01-18,OKLAHOMA_CITY_THUNDER,GOLDEN_STATE_WARRIORS,100,121,5893,21
5893,2017-01-19,2017-01-18,INDIANA_PACERS,SACRAMENTO_KINGS,106,100,5894,6
5894,2017-01-20,2017-01-19,PHOENIX_SUNS,CLEVELAND_CAVALIERS,103,118,5895,15
5895,2017-01-20,2017-01-19,DALLAS_MAVERICKS,MIAMI_HEAT,95,99,5896,4
5896,2017-01-20,2017-01-19,WASHINGTON_WIZARDS,NEW_YORK_KNICKS,113,110,5897,3
5897,2017-01-20,2017-01-19,DENVER_NUGGETS,SAN_ANTONIO_SPURS,104,118,5898,14
5898,2017-01-20,2017-01-19,MINNESOTA_TIMBERWOLVES,LOS_ANGELES_CLIPPERS,104,101,5899,3
5899,2017-01-21,2017-01-20,TORONTO_RAPTORS,CHARLOTTE_HORNETS,78,113,5900,35
5900,2017-01-21,2017-01-20,MILWAUKEE_BUCKS,ORLANDO_MAGIC,96,112,5901,16
5901,2017-01-21,2017-01-20,PORTLAND_TRAIL_BLAZERS,PHILADELPHIA_76ERS,92,93,5902,1
5902,2017-01-21,2017-01-20,CHICAGO_BULLS,ATLANTA_HAWKS,93,102,5903,9
5903,2017-01-21,2017-01-20,GOLDEN_STATE_WARRIORS,HOUSTON_ROCKETS,125,108,5904,17
5904,2017-01-21,2017-01-20,SACRAMENTO_KINGS,MEMPHIS_GRIZZLIES,91,107,5905,16
5905,2017-01-21,2017-01-20,BROOKLYN_NETS,NEW_ORLEANS_PELICANS,143,114,5906,29
5906,2017-01-21,2017-01-20,UTAH_JAZZ,DALLAS_MAVERICKS,112,107,5907,5
5907,2017-01-21,2017-01-20,INDIANA_PACERS,LOS_ANGELES_LAKERS,95,108,5908,13
5908,2017-01-21,2017-01-20,PORTLAND_TRAIL_BLAZERS,BOSTON_CELTICS,127,123,5909,4
5909,2017-01-21,2017-01-20,WASHINGTON_WIZARDS,DETROIT_PISTONS,112,113,5910,1
5910,2017-01-22,2017-01-21,PHILADELPHIA_76ERS,ATLANTA_HAWKS,93,110,5911,17
5911,2017-01-22,2017-01-21,BROOKLYN_NETS,CHARLOTTE_HORNETS,105,112,5912,7
5912,2017-01-22,2017-01-21,MILWAUKEE_BUCKS,MIAMI_HEAT,97,109,5913,12
5913,2017-01-22,2017-01-21,PHOENIX_SUNS,NEW_YORK_KNICKS,107,105,5914,2
5914,2017-01-22,2017-01-21,HOUSTON_ROCKETS,MEMPHIS_GRIZZLIES,119,95,5915,24
5915,2017-01-22,2017-01-21,SAN_ANTONIO_SPURS,CLEVELAND_CAVALIERS,118,115,5916,3
5916,2017-01-22,2017-01-21,SACRAMENTO_KINGS,CHICAGO_BULLS,99,102,5917,3
5917,2017-01-22,2017-01-21,LOS_ANGELES_CLIPPERS,DENVER_NUGGETS,98,123,5918,25
5918,2017-01-22,2017-01-21,INDIANA_PACERS,UTAH_JAZZ,100,109,5919,9
5919,2017-01-22,2017-01-21,GOLDEN_STATE_WARRIORS,ORLANDO_MAGIC,118,98,5920,20
5920,2017-01-22,2017-01-21,LOS_ANGELES_LAKERS,DALLAS_MAVERICKS,73,122,5921,49
5921,2017-01-22,2017-01-21,PHOENIX_SUNS,TORONTO_RAPTORS,115,103,5922,12
5922,2017-01-23,2017-01-22,DENVER_NUGGETS,MINNESOTA_TIMBERWOLVES,108,111,5923,3
5923,2017-01-24,2017-01-23,WASHINGTON_WIZARDS,CHARLOTTE_HORNETS,109,99,5924,10
5924,2017-01-24,2017-01-23,LOS_ANGELES_CLIPPERS,ATLANTA_HAWKS,115,105,5925,10
5925,2017-01-24,2017-01-23,SAN_ANTONIO_SPURS,BROOKLYN_NETS,112,86,5926,26
5926,2017-01-24,2017-01-23,SACRAMENTO_KINGS,DETROIT_PISTONS,109,104,5927,5
5927,2017-01-24,2017-01-23,GOLDEN_STATE_WARRIORS,MIAMI_HEAT,102,105,5928,3
5928,2017-01-24,2017-01-23,NEW_YORK_KNICKS,INDIANA_PACERS,109,103,5929,6
5929,2017-01-24,2017-01-23,HOUSTON_ROCKETS,MILWAUKEE_BUCKS,114,127,5930,13
5930,2017-01-24,2017-01-23,CLEVELAND_CAVALIERS,NEW_ORLEANS_PELICANS,122,124,5931,2
5931,2017-01-24,2017-01-23,OKLAHOMA_CITY_THUNDER,UTAH_JAZZ,97,95,5932,2
5932,2017-01-25,2017-01-24,CHICAGO_BULLS,ORLANDO_MAGIC,100,92,5933,8
5933,2017-01-25,2017-01-24,LOS_ANGELES_CLIPPERS,PHILADELPHIA_76ERS,110,121,5934,11
5934,2017-01-25,2017-01-24,SAN_ANTONIO_SPURS,TORONTO_RAPTORS,108,106,5935,2
5935,2017-01-25,2017-01-24,BOSTON_CELTICS,WASHINGTON_WIZARDS,108,123,5936,15
5936,2017-01-25,2017-01-24,UTAH_JAZZ,DENVER_NUGGETS,93,103,5937,10
5937,2017-01-25,2017-01-24,MINNESOTA_TIMBERWOLVES,PHOENIX_SUNS,112,111,5938,1
5938,2017-01-26,2017-01-25,SACRAMENTO_KINGS,CLEVELAND_CAVALIERS,116,112,5939,4
5939,2017-01-26,2017-01-25,HOUSTON_ROCKETS,BOSTON_CELTICS,109,120,5940,11
5940,2017-01-26,2017-01-25,MIAMI_HEAT,BROOKLYN_NETS,109,106,5941,3
5941,2017-01-26,2017-01-25,ATLANTA_HAWKS,CHICAGO_BULLS,119,114,5942,5
5942,2017-01-26,2017-01-25,GOLDEN_STATE_WARRIORS,CHARLOTTE_HORNETS,113,103,5943,10
5943,2017-01-26,2017-01-25,TORONTO_RAPTORS,MEMPHIS_GRIZZLIES,99,101,5944,2
5944,2017-01-26,2017-01-25,PHILADELPHIA_76ERS,MILWAUKEE_BUCKS,114,109,5945,5
5945,2017-01-26,2017-01-25,OKLAHOMA_CITY_THUNDER,NEW_ORLEANS_PELICANS,114,105,5946,9
5946,2017-01-26,2017-01-25,NEW_YORK_KNICKS,DALLAS_MAVERICKS,95,103,5947,8
5947,2017-01-26,2017-01-25,LOS_ANGELES_LAKERS,PORTLAND_TRAIL_BLAZERS,98,105,5948,7
5948,2017-01-27,2017-01-26,INDIANA_PACERS,MINNESOTA_TIMBERWOLVES,109,103,5949,6
5949,2017-01-27,2017-01-26,DALLAS_MAVERICKS,OKLAHOMA_CITY_THUNDER,98,109,5950,11
5950,2017-01-27,2017-01-26,PHOENIX_SUNS,DENVER_NUGGETS,120,127,5951,7
5951,2017-01-27,2017-01-26,LOS_ANGELES_LAKERS,UTAH_JAZZ,88,96,5952,8
5952,2017-01-28,2017-01-27,SACRAMENTO_KINGS,INDIANA_PACERS,111,115,5953,4
5953,2017-01-28,2017-01-27,ORLANDO_MAGIC,BOSTON_CELTICS,98,128,5954,30
5954,2017-01-28,2017-01-27,BROOKLYN_NETS,CLEVELAND_CAVALIERS,116,124,5955,8
5955,2017-01-28,2017-01-27,CHARLOTTE_HORNETS,NEW_YORK_KNICKS,107,110,5956,3
5956,2017-01-28,2017-01-27,MILWAUKEE_BUCKS,TORONTO_RAPTORS,86,102,5957,16
5957,2017-01-28,2017-01-27,WASHINGTON_WIZARDS,ATLANTA_HAWKS,112,86,5958,26
5958,2017-01-28,2017-01-27,MIAMI_HEAT,CHICAGO_BULLS,100,88,5959,12
5959,2017-01-28,2017-01-27,SAN_ANTONIO_SPURS,NEW_ORLEANS_PELICANS,103,119,5960,16
5960,2017-01-28,2017-01-27,HOUSTON_ROCKETS,PHILADELPHIA_76ERS,123,118,5961,5
5961,2017-01-28,2017-01-27,MEMPHIS_GRIZZLIES,PORTLAND_TRAIL_BLAZERS,109,112,5962,3
5962,2017-01-29,2017-01-28,SACRAMENTO_KINGS,CHARLOTTE_HORNETS,109,106,5963,3
5963,2017-01-29,2017-01-28,DETROIT_PISTONS,MIAMI_HEAT,103,116,5964,13
5964,2017-01-29,2017-01-28,BOSTON_CELTICS,MILWAUKEE_BUCKS,112,108,5965,4
5965,2017-01-29,2017-01-28,LOS_ANGELES_CLIPPERS,GOLDEN_STATE_WARRIORS,98,144,5966,46
5966,2017-01-29,2017-01-28,BROOKLYN_NETS,MINNESOTA_TIMBERWOLVES,109,129,5967,20
5967,2017-01-29,2017-01-28,DENVER_NUGGETS,PHOENIX_SUNS,123,112,5968,11
5968,2017-01-29,2017-01-28,MEMPHIS_GRIZZLIES,UTAH_JAZZ,102,95,5969,7
5969,2017-01-29,2017-01-28,NEW_YORK_KNICKS,ATLANTA_HAWKS,139,142,5970,3
5970,2017-01-29,2017-01-28,OKLAHOMA_CITY_THUNDER,CLEVELAND_CAVALIERS,91,107,5971,16
5971,2017-01-29,2017-01-28,HOUSTON_ROCKETS,INDIANA_PACERS,101,120,5972,19
5972,2017-01-29,2017-01-28,WASHINGTON_WIZARDS,NEW_ORLEANS_PELICANS,107,94,5973,13
5973,2017-01-29,2017-01-28,ORLANDO_MAGIC,TORONTO_RAPTORS,114,113,5974,1
5974,2017-01-30,2017-01-29,PHILADELPHIA_76ERS,CHICAGO_BULLS,108,121,5975,13
5975,2017-01-30,2017-01-29,DALLAS_MAVERICKS,SAN_ANTONIO_SPURS,105,101,5976,4
5976,2017-01-30,2017-01-29,GOLDEN_STATE_WARRIORS,PORTLAND_TRAIL_BLAZERS,113,111,5977,2
5977,2017-01-30,2017-01-29,SACRAMENTO_KINGS,PHILADELPHIA_76ERS,119,122,5978,3
5978,2017-01-31,2017-01-30,BROOKLYN_NETS,MIAMI_HEAT,96,104,5979,8
5979,2017-01-31,2017-01-30,DETROIT_PISTONS,BOSTON_CELTICS,109,113,5980,4
5980,2017-01-31,2017-01-30,ORLANDO_MAGIC,MINNESOTA_TIMBERWOLVES,105,111,5981,6
5981,2017-01-31,2017-01-30,CLEVELAND_CAVALIERS,DALLAS_MAVERICKS,97,104,5982,7
5982,2017-01-31,2017-01-30,MEMPHIS_GRIZZLIES,PHOENIX_SUNS,115,96,5983,19
5983,2017-02-01,2017-01-31,NEW_ORLEANS_PELICANS,TORONTO_RAPTORS,106,108,5984,2
5984,2017-02-01,2017-01-31,NEW_YORK_KNICKS,WASHINGTON_WIZARDS,101,117,5985,16
5985,2017-02-01,2017-01-31,SACRAMENTO_KINGS,HOUSTON_ROCKETS,83,105,5986,22
5986,2017-02-01,2017-01-31,OKLAHOMA_CITY_THUNDER,SAN_ANTONIO_SPURS,94,108,5987,14
5987,2017-02-01,2017-01-31,CHARLOTTE_HORNETS,PORTLAND_TRAIL_BLAZERS,98,115,5988,17
5988,2017-02-01,2017-01-31,DENVER_NUGGETS,LOS_ANGELES_LAKERS,116,120,5989,4
5989,2017-02-02,2017-02-01,MINNESOTA_TIMBERWOLVES,CLEVELAND_CAVALIERS,97,125,5990,28
5990,2017-02-02,2017-02-01,INDIANA_PACERS,ORLANDO_MAGIC,98,88,5991,10
5991,2017-02-02,2017-02-01,TORONTO_RAPTORS,BOSTON_CELTICS,104,109,5992,5
5992,2017-02-02,2017-02-01,NEW_YORK_KNICKS,BROOKLYN_NETS,95,90,5993,5
5993,2017-02-02,2017-02-01,NEW_ORLEANS_PELICANS,DETROIT_PISTONS,98,118,5994,20
5994,2017-02-02,2017-02-01,ATLANTA_HAWKS,MIAMI_HEAT,93,116,5995,23
5995,2017-02-02,2017-02-01,PHILADELPHIA_76ERS,DALLAS_MAVERICKS,95,113,5996,18
5996,2017-02-02,2017-02-01,MEMPHIS_GRIZZLIES,DENVER_NUGGETS,119,99,5997,20
5997,2017-02-02,2017-02-01,LOS_ANGELES_CLIPPERS,PHOENIX_SUNS,124,114,5998,10
5998,2017-02-02,2017-02-01,MILWAUKEE_BUCKS,UTAH_JAZZ,88,104,5999,16
5999,2017-02-02,2017-02-01,CHICAGO_BULLS,OKLAHOMA_CITY_THUNDER,128,100,6000,28
6000,2017-02-02,2017-02-01,CHARLOTTE_HORNETS,GOLDEN_STATE_WARRIORS,111,126,6001,15
6001,2017-02-03,2017-02-02,LOS_ANGELES_LAKERS,WASHINGTON_WIZARDS,108,116,6002,8
6002,2017-02-03,2017-02-02,ATLANTA_HAWKS,HOUSTON_ROCKETS,113,108,6003,5
6003,2017-02-03,2017-02-02,PHILADELPHIA_76ERS,SAN_ANTONIO_SPURS,86,102,6004,16
6004,2017-02-03,2017-02-02,GOLDEN_STATE_WARRIORS,LOS_ANGELES_CLIPPERS,133,120,6005,13
6005,2017-02-04,2017-02-03,TORONTO_RAPTORS,ORLANDO_MAGIC,94,102,6006,8
6006,2017-02-04,2017-02-03,INDIANA_PACERS,BROOKLYN_NETS,106,97,6007,9
6007,2017-02-04,2017-02-03,MINNESOTA_TIMBERWOLVES,DETROIT_PISTONS,108,116,6008,8
6008,2017-02-04,2017-02-03,LOS_ANGELES_LAKERS,BOSTON_CELTICS,107,113,6009,6
6009,2017-02-04,2017-02-03,CHICAGO_BULLS,HOUSTON_ROCKETS,117,121,6010,4
6010,2017-02-04,2017-02-03,MEMPHIS_GRIZZLIES,OKLAHOMA_CITY_THUNDER,102,114,6011,12
6011,2017-02-04,2017-02-03,MILWAUKEE_BUCKS,DENVER_NUGGETS,117,121,6012,4
6012,2017-02-04,2017-02-03,DALLAS_MAVERICKS,PORTLAND_TRAIL_BLAZERS,108,104,6013,4
6013,2017-02-04,2017-02-03,PHOENIX_SUNS,SACRAMENTO_KINGS,105,103,6014,2
6014,2017-02-05,2017-02-04,ORLANDO_MAGIC,ATLANTA_HAWKS,86,113,6015,27
6015,2017-02-05,2017-02-04,DETROIT_PISTONS,INDIANA_PACERS,84,105,6016,21
6016,2017-02-05,2017-02-04,NEW_ORLEANS_PELICANS,WASHINGTON_WIZARDS,91,105,6017,14
6017,2017-02-05,2017-02-04,PHILADELPHIA_76ERS,MIAMI_HEAT,102,125,6018,23
6018,2017-02-05,2017-02-04,CLEVELAND_CAVALIERS,NEW_YORK_KNICKS,111,104,6019,7
6019,2017-02-05,2017-02-04,MEMPHIS_GRIZZLIES,MINNESOTA_TIMBERWOLVES,107,99,6020,8
6020,2017-02-05,2017-02-04,MILWAUKEE_BUCKS,PHOENIX_SUNS,137,112,6021,25
6021,2017-02-05,2017-02-04,DENVER_NUGGETS,SAN_ANTONIO_SPURS,97,121,6022,24
6022,2017-02-05,2017-02-04,CHARLOTTE_HORNETS,UTAH_JAZZ,98,105,6023,7
6023,2017-02-05,2017-02-04,GOLDEN_STATE_WARRIORS,SACRAMENTO_KINGS,106,109,6024,3
6024,2017-02-05,2017-02-04,TORONTO_RAPTORS,BROOKLYN_NETS,103,95,6025,8
6025,2017-02-05,2017-02-04,LOS_ANGELES_CLIPPERS,BOSTON_CELTICS,102,107,6026,5
6026,2017-02-05,2017-02-04,PORTLAND_TRAIL_BLAZERS,OKLAHOMA_CITY_THUNDER,99,105,6027,6
6027,2017-02-07,2017-02-06,OKLAHOMA_CITY_THUNDER,INDIANA_PACERS,90,93,6028,3
6028,2017-02-07,2017-02-06,LOS_ANGELES_LAKERS,NEW_YORK_KNICKS,121,107,6029,14
6029,2017-02-07,2017-02-06,CLEVELAND_CAVALIERS,WASHINGTON_WIZARDS,140,135,6030,5
6030,2017-02-07,2017-02-06,UTAH_JAZZ,ATLANTA_HAWKS,120,95,6031,25
6031,2017-02-07,2017-02-06,PHILADELPHIA_76ERS,DETROIT_PISTONS,96,113,6032,17
6032,2017-02-07,2017-02-06,LOS_ANGELES_CLIPPERS,TORONTO_RAPTORS,109,118,6033,9
6033,2017-02-07,2017-02-06,MIAMI_HEAT,MINNESOTA_TIMBERWOLVES,115,113,6034,2
6034,2017-02-07,2017-02-06,PHOENIX_SUNS,NEW_ORLEANS_PELICANS,106,111,6035,5
6035,2017-02-07,2017-02-06,DALLAS_MAVERICKS,DENVER_NUGGETS,87,110,6036,23
6036,2017-02-07,2017-02-06,SAN_ANTONIO_SPURS,MEMPHIS_GRIZZLIES,74,89,6037,15
6037,2017-02-07,2017-02-06,CHICAGO_BULLS,SACRAMENTO_KINGS,112,107,6038,5
6038,2017-02-08,2017-02-07,BROOKLYN_NETS,CHARLOTTE_HORNETS,107,111,6039,4
6039,2017-02-08,2017-02-07,ORLANDO_MAGIC,HOUSTON_ROCKETS,104,128,6040,24
6040,2017-02-08,2017-02-07,PORTLAND_TRAIL_BLAZERS,DALLAS_MAVERICKS,114,113,6041,1
6041,2017-02-09,2017-02-08,CLEVELAND_CAVALIERS,INDIANA_PACERS,132,117,6042,15
6042,2017-02-09,2017-02-08,SAN_ANTONIO_SPURS,PHILADELPHIA_76ERS,111,103,6043,8
6043,2017-02-09,2017-02-08,DENVER_NUGGETS,ATLANTA_HAWKS,106,117,6044,11
6044,2017-02-09,2017-02-08,WASHINGTON_WIZARDS,BROOKLYN_NETS,114,110,6045,4
6045,2017-02-09,2017-02-08,LOS_ANGELES_LAKERS,DETROIT_PISTONS,102,121,6046,19
6046,2017-02-09,2017-02-08,PHOENIX_SUNS,MEMPHIS_GRIZZLIES,91,110,6047,19
6047,2017-02-09,2017-02-08,MIAMI_HEAT,MILWAUKEE_BUCKS,106,88,6048,18
6048,2017-02-09,2017-02-08,TORONTO_RAPTORS,MINNESOTA_TIMBERWOLVES,109,112,6049,3
6049,2017-02-09,2017-02-08,UTAH_JAZZ,NEW_ORLEANS_PELICANS,127,94,6050,33
6050,2017-02-09,2017-02-08,LOS_ANGELES_CLIPPERS,NEW_YORK_KNICKS,119,115,6051,4
6051,2017-02-09,2017-02-08,CHICAGO_BULLS,GOLDEN_STATE_WARRIORS,92,123,6052,31
6052,2017-02-09,2017-02-08,BOSTON_CELTICS,SACRAMENTO_KINGS,92,108,6053,16
6053,2017-02-10,2017-02-09,HOUSTON_ROCKETS,CHARLOTTE_HORNETS,107,95,6054,12
6054,2017-02-10,2017-02-09,PHILADELPHIA_76ERS,ORLANDO_MAGIC,112,111,6055,1
6055,2017-02-10,2017-02-09,CLEVELAND_CAVALIERS,OKLAHOMA_CITY_THUNDER,109,118,6056,9
6056,2017-02-10,2017-02-09,UTAH_JAZZ,DALLAS_MAVERICKS,105,112,6057,7
6057,2017-02-10,2017-02-09,BOSTON_CELTICS,PORTLAND_TRAIL_BLAZERS,120,111,6058,9
6058,2017-02-11,2017-02-10,MIAMI_HEAT,BROOKLYN_NETS,108,99,6059,9
6059,2017-02-11,2017-02-10,SAN_ANTONIO_SPURS,DETROIT_PISTONS,103,92,6060,11
6060,2017-02-11,2017-02-10,DENVER_NUGGETS,NEW_YORK_KNICKS,131,123,6061,8
6061,2017-02-11,2017-02-10,GOLDEN_STATE_WARRIORS,MEMPHIS_GRIZZLIES,122,107,6062,15
6062,2017-02-11,2017-02-10,LOS_ANGELES_LAKERS,MILWAUKEE_BUCKS,122,114,6063,8
6063,2017-02-11,2017-02-10,NEW_ORLEANS_PELICANS,MINNESOTA_TIMBERWOLVES,122,106,6064,16
6064,2017-02-11,2017-02-10,INDIANA_PACERS,WASHINGTON_WIZARDS,107,112,6065,5
6065,2017-02-11,2017-02-10,CHICAGO_BULLS,PHOENIX_SUNS,97,115,6066,18
6066,2017-02-11,2017-02-10,ATLANTA_HAWKS,SACRAMENTO_KINGS,107,108,6067,1
6067,2017-02-11,2017-02-10,LOS_ANGELES_CLIPPERS,CHARLOTTE_HORNETS,107,102,6068,5
6068,2017-02-12,2017-02-11,MILWAUKEE_BUCKS,INDIANA_PACERS,116,100,6069,16
6069,2017-02-12,2017-02-11,DENVER_NUGGETS,CLEVELAND_CAVALIERS,109,125,6070,16
6070,2017-02-12,2017-02-11,MIAMI_HEAT,PHILADELPHIA_76ERS,109,117,6071,8
6071,2017-02-12,2017-02-11,GOLDEN_STATE_WARRIORS,OKLAHOMA_CITY_THUNDER,130,114,6072,16
6072,2017-02-12,2017-02-11,ORLANDO_MAGIC,DALLAS_MAVERICKS,80,112,6073,32
6073,2017-02-12,2017-02-11,PHOENIX_SUNS,HOUSTON_ROCKETS,102,133,6074,31
6074,2017-02-12,2017-02-11,BOSTON_CELTICS,UTAH_JAZZ,112,104,6075,8
6075,2017-02-12,2017-02-11,CHICAGO_BULLS,MINNESOTA_TIMBERWOLVES,89,117,6076,28
6076,2017-02-12,2017-02-11,SAN_ANTONIO_SPURS,NEW_YORK_KNICKS,90,94,6077,4
6077,2017-02-12,2017-02-11,DETROIT_PISTONS,TORONTO_RAPTORS,102,101,6078,1
6078,2017-02-13,2017-02-12,NEW_ORLEANS_PELICANS,SACRAMENTO_KINGS,99,105,6079,6
6079,2017-02-14,2017-02-13,PHILADELPHIA_76ERS,CHARLOTTE_HORNETS,105,99,6080,6
6080,2017-02-14,2017-02-13,SAN_ANTONIO_SPURS,INDIANA_PACERS,110,106,6081,4
6081,2017-02-14,2017-02-13,MEMPHIS_GRIZZLIES,BROOKLYN_NETS,112,103,6082,9
6082,2017-02-14,2017-02-13,ORLANDO_MAGIC,MIAMI_HEAT,116,107,6083,9
6083,2017-02-14,2017-02-13,DETROIT_PISTONS,MILWAUKEE_BUCKS,89,102,6084,13
6084,2017-02-14,2017-02-13,OKLAHOMA_CITY_THUNDER,WASHINGTON_WIZARDS,98,120,6085,22
6085,2017-02-14,2017-02-13,BOSTON_CELTICS,DALLAS_MAVERICKS,111,98,6086,13
6086,2017-02-14,2017-02-13,GOLDEN_STATE_WARRIORS,DENVER_NUGGETS,110,132,6087,22
6087,2017-02-14,2017-02-13,NEW_ORLEANS_PELICANS,PHOENIX_SUNS,110,108,6088,2
6088,2017-02-14,2017-02-13,LOS_ANGELES_CLIPPERS,UTAH_JAZZ,88,72,6089,16
6089,2017-02-14,2017-02-13,ATLANTA_HAWKS,PORTLAND_TRAIL_BLAZERS,109,104,6090,5
6090,2017-02-15,2017-02-14,TORONTO_RAPTORS,CHICAGO_BULLS,94,105,6091,11
6091,2017-02-15,2017-02-14,CLEVELAND_CAVALIERS,MINNESOTA_TIMBERWOLVES,116,108,6092,8
6092,2017-02-15,2017-02-14,SACRAMENTO_KINGS,LOS_ANGELES_LAKERS,97,96,6093,1
6093,2017-02-16,2017-02-15,INDIANA_PACERS,CLEVELAND_CAVALIERS,104,113,6094,9
6094,2017-02-16,2017-02-15,SAN_ANTONIO_SPURS,ORLANDO_MAGIC,107,79,6095,28
6095,2017-02-16,2017-02-15,PHILADELPHIA_76ERS,BOSTON_CELTICS,108,116,6096,8
6096,2017-02-16,2017-02-15,MILWAUKEE_BUCKS,BROOKLYN_NETS,129,125,6097,4
6097,2017-02-16,2017-02-15,DALLAS_MAVERICKS,DETROIT_PISTONS,91,98,6098,7
6098,2017-02-16,2017-02-15,CHARLOTTE_HORNETS,TORONTO_RAPTORS,85,90,6099,5
6099,2017-02-16,2017-02-15,MIAMI_HEAT,HOUSTON_ROCKETS,117,109,6100,8
6100,2017-02-16,2017-02-15,NEW_ORLEANS_PELICANS,MEMPHIS_GRIZZLIES,95,91,6101,4
6101,2017-02-16,2017-02-15,MINNESOTA_TIMBERWOLVES,DENVER_NUGGETS,112,99,6102,13
6102,2017-02-16,2017-02-15,LOS_ANGELES_LAKERS,PHOENIX_SUNS,101,137,6103,36
6103,2017-02-16,2017-02-15,PORTLAND_TRAIL_BLAZERS,UTAH_JAZZ,88,111,6104,23
6104,2017-02-16,2017-02-15,NEW_YORK_KNICKS,OKLAHOMA_CITY_THUNDER,105,116,6105,11
6105,2017-02-16,2017-02-15,SACRAMENTO_KINGS,GOLDEN_STATE_WARRIORS,86,109,6106,23
6106,2017-02-16,2017-02-15,ATLANTA_HAWKS,LOS_ANGELES_CLIPPERS,84,99,6107,15
6107,2017-02-17,2017-02-16,WASHINGTON_WIZARDS,INDIANA_PACERS,111,98,6108,13
6108,2017-02-17,2017-02-16,BOSTON_CELTICS,CHICAGO_BULLS,103,104,6109,1
6109,2017-02-24,2017-02-23,PORTLAND_TRAIL_BLAZERS,ORLANDO_MAGIC,112,103,6110,9
6110,2017-02-24,2017-02-23,CHARLOTTE_HORNETS,DETROIT_PISTONS,108,114,6111,6
6111,2017-02-24,2017-02-23,NEW_YORK_KNICKS,CLEVELAND_CAVALIERS,104,119,6112,15
6112,2017-02-24,2017-02-23,HOUSTON_ROCKETS,NEW_ORLEANS_PELICANS,129,99,6113,30
6113,2017-02-24,2017-02-23,LOS_ANGELES_CLIPPERS,GOLDEN_STATE_WARRIORS,113,123,6114,10
6114,2017-02-24,2017-02-23,DENVER_NUGGETS,SACRAMENTO_KINGS,100,116,6115,16
6115,2017-02-25,2017-02-24,MEMPHIS_GRIZZLIES,INDIANA_PACERS,92,102,6116,10
6116,2017-02-25,2017-02-24,WASHINGTON_WIZARDS,PHILADELPHIA_76ERS,112,120,6117,8
6117,2017-02-25,2017-02-24,MIAMI_HEAT,ATLANTA_HAWKS,108,90,6118,18
6118,2017-02-25,2017-02-24,PHOENIX_SUNS,CHICAGO_BULLS,121,128,6119,7
6119,2017-02-25,2017-02-24,UTAH_JAZZ,MILWAUKEE_BUCKS,109,95,6120,14
6120,2017-02-25,2017-02-24,DALLAS_MAVERICKS,MINNESOTA_TIMBERWOLVES,84,97,6121,13
6121,2017-02-25,2017-02-24,LOS_ANGELES_LAKERS,OKLAHOMA_CITY_THUNDER,93,110,6122,17
6122,2017-02-25,2017-02-24,BOSTON_CELTICS,TORONTO_RAPTORS,97,107,6123,10
6123,2017-02-25,2017-02-24,BROOKLYN_NETS,DENVER_NUGGETS,109,129,6124,20
6124,2017-02-25,2017-02-24,SAN_ANTONIO_SPURS,LOS_ANGELES_CLIPPERS,105,97,6125,8
6125,2017-02-25,2017-02-24,CHARLOTTE_HORNETS,SACRAMENTO_KINGS,99,85,6126,14
6126,2017-02-26,2017-02-25,ATLANTA_HAWKS,ORLANDO_MAGIC,86,105,6127,19
6127,2017-02-26,2017-02-25,PHILADELPHIA_76ERS,NEW_YORK_KNICKS,109,110,6128,1
6128,2017-02-26,2017-02-25,INDIANA_PACERS,MIAMI_HEAT,95,113,6129,18
6129,2017-02-26,2017-02-25,CHICAGO_BULLS,CLEVELAND_CAVALIERS,117,99,6130,18
6130,2017-02-26,2017-02-25,NEW_ORLEANS_PELICANS,DALLAS_MAVERICKS,83,96,6131,13
6131,2017-02-26,2017-02-25,MINNESOTA_TIMBERWOLVES,HOUSTON_ROCKETS,130,142,6132,12
6132,2017-02-26,2017-02-25,BROOKLYN_NETS,GOLDEN_STATE_WARRIORS,95,112,6133,17
6133,2017-02-26,2017-02-25,SAN_ANTONIO_SPURS,LOS_ANGELES_LAKERS,119,98,6134,21
6134,2017-02-26,2017-02-25,PHOENIX_SUNS,MILWAUKEE_BUCKS,96,100,6135,4
6135,2017-02-26,2017-02-25,MEMPHIS_GRIZZLIES,DENVER_NUGGETS,105,98,6136,7
6136,2017-02-26,2017-02-25,UTAH_JAZZ,WASHINGTON_WIZARDS,102,92,6137,10
6137,2017-02-26,2017-02-25,BOSTON_CELTICS,DETROIT_PISTONS,104,98,6138,6
6138,2017-02-26,2017-02-25,PORTLAND_TRAIL_BLAZERS,TORONTO_RAPTORS,106,112,6139,6
6139,2017-02-27,2017-02-26,NEW_ORLEANS_PELICANS,OKLAHOMA_CITY_THUNDER,110,118,6140,8
6140,2017-02-27,2017-02-26,CHARLOTTE_HORNETS,LOS_ANGELES_CLIPPERS,121,124,6141,3
6141,2017-02-28,2017-02-27,MILWAUKEE_BUCKS,CLEVELAND_CAVALIERS,95,102,6142,7
6142,2017-02-28,2017-02-27,TORONTO_RAPTORS,NEW_YORK_KNICKS,92,91,6143,1
6143,2017-02-28,2017-02-27,GOLDEN_STATE_WARRIORS,PHILADELPHIA_76ERS,119,108,6144,11
6144,2017-02-28,2017-02-27,ATLANTA_HAWKS,BOSTON_CELTICS,114,98,6145,16
6145,2017-02-28,2017-02-27,MIAMI_HEAT,DALLAS_MAVERICKS,89,96,6146,7
6146,2017-02-28,2017-02-27,INDIANA_PACERS,HOUSTON_ROCKETS,117,108,6147,9
6147,2017-02-28,2017-02-27,MINNESOTA_TIMBERWOLVES,SACRAMENTO_KINGS,102,88,6148,14
6148,2017-03-01,2017-02-28,GOLDEN_STATE_WARRIORS,WASHINGTON_WIZARDS,108,112,6149,4
6149,2017-03-01,2017-02-28,PORTLAND_TRAIL_BLAZERS,DETROIT_PISTONS,113,120,6150,7
6150,2017-03-01,2017-02-28,DENVER_NUGGETS,CHICAGO_BULLS,125,107,6151,18
6151,2017-03-01,2017-02-28,PHOENIX_SUNS,MEMPHIS_GRIZZLIES,112,130,6152,18
6152,2017-03-01,2017-02-28,UTAH_JAZZ,OKLAHOMA_CITY_THUNDER,106,109,6153,3
6153,2017-03-01,2017-02-28,CHARLOTTE_HORNETS,LOS_ANGELES_LAKERS,109,104,6154,5
6154,2017-03-02,2017-03-01,NEW_YORK_KNICKS,ORLANDO_MAGIC,101,90,6155,11
6155,2017-03-02,2017-03-01,DALLAS_MAVERICKS,ATLANTA_HAWKS,95,100,6156,5
6156,2017-03-02,2017-03-01,PHILADELPHIA_76ERS,MIAMI_HEAT,98,125,6157,27
6157,2017-03-02,2017-03-01,WASHINGTON_WIZARDS,TORONTO_RAPTORS,105,96,6158,9
6158,2017-03-02,2017-03-01,CLEVELAND_CAVALIERS,BOSTON_CELTICS,99,103,6159,4
6159,2017-03-02,2017-03-01,DENVER_NUGGETS,MILWAUKEE_BUCKS,110,98,6160,12
6160,2017-03-02,2017-03-01,DETROIT_PISTONS,NEW_ORLEANS_PELICANS,86,109,6161,23
6161,2017-03-02,2017-03-01,INDIANA_PACERS,SAN_ANTONIO_SPURS,99,100,6162,1
6162,2017-03-02,2017-03-01,MINNESOTA_TIMBERWOLVES,UTAH_JAZZ,107,80,6163,27
6163,2017-03-02,2017-03-01,HOUSTON_ROCKETS,LOS_ANGELES_CLIPPERS,122,103,6164,19
6164,2017-03-02,2017-03-01,BROOKLYN_NETS,SACRAMENTO_KINGS,109,100,6165,9
6165,2017-03-03,2017-03-02,GOLDEN_STATE_WARRIORS,CHICAGO_BULLS,87,94,6166,7
6166,2017-03-03,2017-03-02,CHARLOTTE_HORNETS,PHOENIX_SUNS,103,120,6167,17
6167,2017-03-03,2017-03-02,OKLAHOMA_CITY_THUNDER,PORTLAND_TRAIL_BLAZERS,109,114,6168,5
6168,2017-03-04,2017-03-03,CLEVELAND_CAVALIERS,ATLANTA_HAWKS,135,130,6169,5
6169,2017-03-04,2017-03-03,MIAMI_HEAT,ORLANDO_MAGIC,99,110,6170,11
6170,2017-03-04,2017-03-03,NEW_YORK_KNICKS,PHILADELPHIA_76ERS,102,105,6171,3
6171,2017-03-04,2017-03-03,TORONTO_RAPTORS,WASHINGTON_WIZARDS,114,106,6172,8
6172,2017-03-04,2017-03-03,LOS_ANGELES_CLIPPERS,MILWAUKEE_BUCKS,101,112,6173,11
6173,2017-03-04,2017-03-03,MEMPHIS_GRIZZLIES,DALLAS_MAVERICKS,100,104,6174,4
6174,2017-03-04,2017-03-03,OKLAHOMA_CITY_THUNDER,PHOENIX_SUNS,111,118,6175,7
6175,2017-03-04,2017-03-03,BROOKLYN_NETS,UTAH_JAZZ,97,112,6176,15
6176,2017-03-04,2017-03-03,SAN_ANTONIO_SPURS,NEW_ORLEANS_PELICANS,101,98,6177,3
6177,2017-03-04,2017-03-03,BOSTON_CELTICS,LOS_ANGELES_LAKERS,115,95,6178,20
6178,2017-03-04,2017-03-03,DETROIT_PISTONS,PHILADELPHIA_76ERS,136,106,6179,30
6179,2017-03-05,2017-03-04,CLEVELAND_CAVALIERS,MIAMI_HEAT,92,120,6180,28
6180,2017-03-05,2017-03-04,TORONTO_RAPTORS,MILWAUKEE_BUCKS,94,101,6181,7
6181,2017-03-05,2017-03-04,LOS_ANGELES_CLIPPERS,CHICAGO_BULLS,101,91,6182,10
6182,2017-03-05,2017-03-04,CHARLOTTE_HORNETS,DENVER_NUGGETS,112,102,6183,10
6183,2017-03-05,2017-03-04,MEMPHIS_GRIZZLIES,HOUSTON_ROCKETS,108,123,6184,15
6184,2017-03-05,2017-03-04,MINNESOTA_TIMBERWOLVES,SAN_ANTONIO_SPURS,90,97,6185,7
6185,2017-03-05,2017-03-04,BROOKLYN_NETS,PORTLAND_TRAIL_BLAZERS,116,130,6186,14
6186,2017-03-05,2017-03-04,INDIANA_PACERS,ATLANTA_HAWKS,97,96,6187,1
6187,2017-03-05,2017-03-04,GOLDEN_STATE_WARRIORS,NEW_YORK_KNICKS,112,105,6188,7
6188,2017-03-05,2017-03-04,BOSTON_CELTICS,PHOENIX_SUNS,106,109,6189,3
6189,2017-03-05,2017-03-04,ORLANDO_MAGIC,WASHINGTON_WIZARDS,114,115,6190,1
6190,2017-03-05,2017-03-04,UTAH_JAZZ,SACRAMENTO_KINGS,110,109,6191,1
6191,2017-03-06,2017-03-05,OKLAHOMA_CITY_THUNDER,DALLAS_MAVERICKS,89,104,6192,15
6192,2017-03-06,2017-03-05,NEW_ORLEANS_PELICANS,LOS_ANGELES_LAKERS,105,97,6193,8
6193,2017-03-07,2017-03-06,MIAMI_HEAT,CLEVELAND_CAVALIERS,106,98,6194,8
6194,2017-03-07,2017-03-06,NEW_YORK_KNICKS,ORLANDO_MAGIC,113,105,6195,8
6195,2017-03-07,2017-03-06,MILWAUKEE_BUCKS,PHILADELPHIA_76ERS,112,98,6196,14
6196,2017-03-07,2017-03-06,GOLDEN_STATE_WARRIORS,ATLANTA_HAWKS,119,111,6197,8
6197,2017-03-07,2017-03-06,CHICAGO_BULLS,DETROIT_PISTONS,95,109,6198,14
6198,2017-03-07,2017-03-06,INDIANA_PACERS,CHARLOTTE_HORNETS,88,100,6199,12
6199,2017-03-07,2017-03-06,BROOKLYN_NETS,MEMPHIS_GRIZZLIES,122,109,6200,13
6200,2017-03-07,2017-03-06,HOUSTON_ROCKETS,SAN_ANTONIO_SPURS,110,112,6201,2
6201,2017-03-07,2017-03-06,SACRAMENTO_KINGS,DENVER_NUGGETS,96,108,6202,12
6202,2017-03-07,2017-03-06,NEW_ORLEANS_PELICANS,UTAH_JAZZ,83,88,6203,5
6203,2017-03-07,2017-03-06,BOSTON_CELTICS,LOS_ANGELES_CLIPPERS,102,116,6204,14
6204,2017-03-08,2017-03-07,PORTLAND_TRAIL_BLAZERS,OKLAHOMA_CITY_THUNDER,126,121,6205,5
6205,2017-03-08,2017-03-07,LOS_ANGELES_LAKERS,DALLAS_MAVERICKS,111,122,6206,11
6206,2017-03-08,2017-03-07,WASHINGTON_WIZARDS,PHOENIX_SUNS,131,127,6207,4
6207,2017-03-09,2017-03-08,CHICAGO_BULLS,ORLANDO_MAGIC,91,98,6208,7
6208,2017-03-09,2017-03-08,BROOKLYN_NETS,ATLANTA_HAWKS,105,110,6209,5
6209,2017-03-09,2017-03-08,CHARLOTTE_HORNETS,MIAMI_HEAT,101,108,6210,7
6210,2017-03-09,2017-03-08,UTAH_JAZZ,HOUSTON_ROCKETS,115,108,6211,7
6211,2017-03-09,2017-03-08,DETROIT_PISTONS,INDIANA_PACERS,98,115,6212,17
6212,2017-03-09,2017-03-08,NEW_YORK_KNICKS,MILWAUKEE_BUCKS,93,104,6213,11
6213,2017-03-09,2017-03-08,LOS_ANGELES_CLIPPERS,MINNESOTA_TIMBERWOLVES,91,107,6214,16
6214,2017-03-09,2017-03-08,TORONTO_RAPTORS,NEW_ORLEANS_PELICANS,94,87,6215,7
6215,2017-03-09,2017-03-08,SACRAMENTO_KINGS,SAN_ANTONIO_SPURS,104,114,6216,10
6216,2017-03-09,2017-03-08,WASHINGTON_WIZARDS,DENVER_NUGGETS,123,113,6217,10
6217,2017-03-09,2017-03-08,BOSTON_CELTICS,GOLDEN_STATE_WARRIORS,99,86,6218,13
6218,2017-03-10,2017-03-09,CLEVELAND_CAVALIERS,DETROIT_PISTONS,101,106,6219,5
6219,2017-03-10,2017-03-09,LOS_ANGELES_CLIPPERS,MEMPHIS_GRIZZLIES,114,98,6220,16
6220,2017-03-10,2017-03-09,SAN_ANTONIO_SPURS,OKLAHOMA_CITY_THUNDER,92,102,6221,10
6221,2017-03-10,2017-03-09,PHILADELPHIA_76ERS,PORTLAND_TRAIL_BLAZERS,108,114,6222,6
6222,2017-03-10,2017-03-09,LOS_ANGELES_LAKERS,PHOENIX_SUNS,122,110,6223,12
6223,2017-03-11,2017-03-10,ORLANDO_MAGIC,CHARLOTTE_HORNETS,81,121,6224,40
6224,2017-03-11,2017-03-10,TORONTO_RAPTORS,ATLANTA_HAWKS,99,105,6225,6
6225,2017-03-11,2017-03-10,HOUSTON_ROCKETS,CHICAGO_BULLS,115,94,6226,21
6226,2017-03-11,2017-03-10,INDIANA_PACERS,MILWAUKEE_BUCKS,85,99,6227,14
6227,2017-03-11,2017-03-10,GOLDEN_STATE_WARRIORS,MINNESOTA_TIMBERWOLVES,102,103,6228,1
6228,2017-03-11,2017-03-10,BROOKLYN_NETS,DALLAS_MAVERICKS,96,105,6229,9
6229,2017-03-11,2017-03-10,BOSTON_CELTICS,DENVER_NUGGETS,99,119,6230,20
6230,2017-03-11,2017-03-10,WASHINGTON_WIZARDS,SACRAMENTO_KINGS,130,122,6231,8
6231,2017-03-11,2017-03-10,UTAH_JAZZ,OKLAHOMA_CITY_THUNDER,104,112,6232,8
6232,2017-03-11,2017-03-10,PHILADELPHIA_76ERS,LOS_ANGELES_CLIPPERS,100,112,6233,12
6233,2017-03-11,2017-03-10,NEW_YORK_KNICKS,DETROIT_PISTONS,92,112,6234,20
6234,2017-03-12,2017-03-11,NEW_ORLEANS_PELICANS,CHARLOTTE_HORNETS,125,122,6235,3
6235,2017-03-12,2017-03-11,CLEVELAND_CAVALIERS,ORLANDO_MAGIC,116,104,6236,12
6236,2017-03-12,2017-03-11,TORONTO_RAPTORS,MIAMI_HEAT,89,104,6237,15
6237,2017-03-12,2017-03-11,MINNESOTA_TIMBERWOLVES,MILWAUKEE_BUCKS,95,102,6238,7
6238,2017-03-12,2017-03-11,GOLDEN_STATE_WARRIORS,SAN_ANTONIO_SPURS,85,107,6239,22
6239,2017-03-12,2017-03-11,PHOENIX_SUNS,DALLAS_MAVERICKS,100,98,6240,2
6240,2017-03-12,2017-03-11,ATLANTA_HAWKS,MEMPHIS_GRIZZLIES,107,90,6241,17
6241,2017-03-12,2017-03-11,WASHINGTON_WIZARDS,PORTLAND_TRAIL_BLAZERS,125,124,6242,1
6242,2017-03-12,2017-03-11,DENVER_NUGGETS,SACRAMENTO_KINGS,105,92,6243,13
6243,2017-03-12,2017-03-11,CHICAGO_BULLS,BOSTON_CELTICS,80,100,6244,20
6244,2017-03-12,2017-03-11,NEW_YORK_KNICKS,BROOKLYN_NETS,112,120,6245,8
6245,2017-03-12,2017-03-11,MIAMI_HEAT,INDIANA_PACERS,98,102,6246,4
6246,2017-03-13,2017-03-12,CLEVELAND_CAVALIERS,HOUSTON_ROCKETS,112,117,6247,5
6247,2017-03-13,2017-03-12,PORTLAND_TRAIL_BLAZERS,PHOENIX_SUNS,110,101,6248,9
6248,2017-03-13,2017-03-12,PHILADELPHIA_76ERS,LOS_ANGELES_LAKERS,118,116,6249,2
6249,2017-03-13,2017-03-12,CHICAGO_BULLS,CHARLOTTE_HORNETS,115,109,6250,6
6250,2017-03-13,2017-03-12,DALLAS_MAVERICKS,TORONTO_RAPTORS,78,100,6251,22
6251,2017-03-14,2017-03-13,MILWAUKEE_BUCKS,MEMPHIS_GRIZZLIES,93,113,6252,20
6252,2017-03-14,2017-03-13,WASHINGTON_WIZARDS,MINNESOTA_TIMBERWOLVES,104,119,6253,15
6253,2017-03-14,2017-03-13,ATLANTA_HAWKS,SAN_ANTONIO_SPURS,99,107,6254,8
6254,2017-03-14,2017-03-13,LOS_ANGELES_CLIPPERS,UTAH_JAZZ,108,114,6255,6
6255,2017-03-14,2017-03-13,LOS_ANGELES_LAKERS,DENVER_NUGGETS,101,129,6256,28
6256,2017-03-14,2017-03-13,ORLANDO_MAGIC,SACRAMENTO_KINGS,115,120,6257,5
6257,2017-03-14,2017-03-13,DETROIT_PISTONS,CLEVELAND_CAVALIERS,96,128,6258,32
6258,2017-03-14,2017-03-13,OKLAHOMA_CITY_THUNDER,BROOKLYN_NETS,122,104,6259,18
6259,2017-03-14,2017-03-13,INDIANA_PACERS,NEW_YORK_KNICKS,81,87,6260,6
6260,2017-03-15,2017-03-14,PORTLAND_TRAIL_BLAZERS,NEW_ORLEANS_PELICANS,77,100,6261,23
6261,2017-03-15,2017-03-14,PHILADELPHIA_76ERS,GOLDEN_STATE_WARRIORS,104,106,6262,2
6262,2017-03-15,2017-03-14,CHARLOTTE_HORNETS,INDIANA_PACERS,77,98,6263,21
6263,2017-03-15,2017-03-14,DALLAS_MAVERICKS,WASHINGTON_WIZARDS,112,107,6264,5
6264,2017-03-15,2017-03-14,MINNESOTA_TIMBERWOLVES,BOSTON_CELTICS,104,117,6265,13
6265,2017-03-15,2017-03-14,UTAH_JAZZ,DETROIT_PISTONS,97,83,6266,14
6266,2017-03-15,2017-03-14,NEW_ORLEANS_PELICANS,MIAMI_HEAT,112,120,6267,8
6267,2017-03-16,2017-03-15,MEMPHIS_GRIZZLIES,CHICAGO_BULLS,98,91,6268,7
6268,2017-03-16,2017-03-15,LOS_ANGELES_LAKERS,HOUSTON_ROCKETS,100,139,6269,39
6269,2017-03-16,2017-03-15,PORTLAND_TRAIL_BLAZERS,SAN_ANTONIO_SPURS,110,106,6270,4
6270,2017-03-16,2017-03-15,SACRAMENTO_KINGS,PHOENIX_SUNS,107,101,6271,6
6271,2017-03-16,2017-03-15,MILWAUKEE_BUCKS,LOS_ANGELES_CLIPPERS,97,96,6272,1
6272,2017-03-16,2017-03-15,UTAH_JAZZ,CLEVELAND_CAVALIERS,83,91,6273,8
6273,2017-03-16,2017-03-15,OKLAHOMA_CITY_THUNDER,TORONTO_RAPTORS,123,102,6274,21
6274,2017-03-16,2017-03-15,MEMPHIS_GRIZZLIES,ATLANTA_HAWKS,103,91,6275,12
6275,2017-03-16,2017-03-15,BROOKLYN_NETS,NEW_YORK_KNICKS,121,110,6276,11
6276,2017-03-17,2017-03-16,LOS_ANGELES_CLIPPERS,DENVER_NUGGETS,114,129,6277,15
6277,2017-03-17,2017-03-16,ORLANDO_MAGIC,GOLDEN_STATE_WARRIORS,92,122,6278,30
6278,2017-03-17,2017-03-16,DALLAS_MAVERICKS,PHILADELPHIA_76ERS,74,116,6279,42
6279,2017-03-17,2017-03-16,CHICAGO_BULLS,WASHINGTON_WIZARDS,107,112,6280,5
6280,2017-03-17,2017-03-16,BOSTON_CELTICS,BROOKLYN_NETS,98,95,6281,3
6281,2017-03-17,2017-03-16,TORONTO_RAPTORS,DETROIT_PISTONS,87,75,6282,12
6282,2017-03-18,2017-03-17,MINNESOTA_TIMBERWOLVES,MIAMI_HEAT,105,123,6283,18
6283,2017-03-18,2017-03-17,HOUSTON_ROCKETS,NEW_ORLEANS_PELICANS,112,128,6284,16
6284,2017-03-18,2017-03-17,ORLANDO_MAGIC,PHOENIX_SUNS,109,103,6285,6
6285,2017-03-18,2017-03-17,MILWAUKEE_BUCKS,LOS_ANGELES_LAKERS,107,103,6286,4
6286,2017-03-18,2017-03-17,SACRAMENTO_KINGS,OKLAHOMA_CITY_THUNDER,94,110,6287,16
6287,2017-03-18,2017-03-17,PORTLAND_TRAIL_BLAZERS,ATLANTA_HAWKS,113,97,6288,16
6288,2017-03-18,2017-03-17,WASHINGTON_WIZARDS,CHARLOTTE_HORNETS,93,98,6289,5
6289,2017-03-19,2017-03-18,CLEVELAND_CAVALIERS,LOS_ANGELES_CLIPPERS,78,108,6290,30
6290,2017-03-19,2017-03-18,UTAH_JAZZ,CHICAGO_BULLS,86,95,6291,9
6291,2017-03-19,2017-03-18,SAN_ANTONIO_SPURS,MEMPHIS_GRIZZLIES,96,104,6292,8
6292,2017-03-19,2017-03-18,HOUSTON_ROCKETS,DENVER_NUGGETS,109,105,6293,4
6293,2017-03-19,2017-03-18,MILWAUKEE_BUCKS,GOLDEN_STATE_WARRIORS,92,117,6294,25
6294,2017-03-19,2017-03-18,DALLAS_MAVERICKS,BROOKLYN_NETS,111,104,6295,7
6295,2017-03-19,2017-03-18,BOSTON_CELTICS,PHILADELPHIA_76ERS,99,105,6296,6
6296,2017-03-19,2017-03-18,PHOENIX_SUNS,DETROIT_PISTONS,95,112,6297,17
6297,2017-03-19,2017-03-18,PORTLAND_TRAIL_BLAZERS,MIAMI_HEAT,115,104,6298,11
6298,2017-03-19,2017-03-18,MINNESOTA_TIMBERWOLVES,NEW_ORLEANS_PELICANS,109,123,6299,14
6299,2017-03-19,2017-03-18,INDIANA_PACERS,TORONTO_RAPTORS,91,116,6300,25
6300,2017-03-19,2017-03-18,SACRAMENTO_KINGS,SAN_ANTONIO_SPURS,102,118,6301,16
6301,2017-03-20,2017-03-19,CLEVELAND_CAVALIERS,LOS_ANGELES_LAKERS,125,120,6302,5
6302,2017-03-20,2017-03-19,ATLANTA_HAWKS,CHARLOTTE_HORNETS,90,105,6303,15
6303,2017-03-20,2017-03-19,UTAH_JAZZ,INDIANA_PACERS,100,107,6304,7
6304,2017-03-20,2017-03-19,PHILADELPHIA_76ERS,ORLANDO_MAGIC,109,112,6305,3
6305,2017-03-20,2017-03-19,WASHINGTON_WIZARDS,BOSTON_CELTICS,102,110,6306,8
6306,2017-03-21,2017-03-20,DENVER_NUGGETS,HOUSTON_ROCKETS,124,125,6307,1
6307,2017-03-21,2017-03-20,GOLDEN_STATE_WARRIORS,OKLAHOMA_CITY_THUNDER,111,95,6308,16
6308,2017-03-21,2017-03-20,NEW_YORK_KNICKS,LOS_ANGELES_CLIPPERS,105,114,6309,9
6309,2017-03-21,2017-03-20,CHICAGO_BULLS,TORONTO_RAPTORS,120,122,6310,2
6310,2017-03-21,2017-03-20,DETROIT_PISTONS,BROOKLYN_NETS,96,98,6311,2
6311,2017-03-21,2017-03-20,PHOENIX_SUNS,MIAMI_HEAT,97,112,6312,15
6312,2017-03-22,2017-03-21,MEMPHIS_GRIZZLIES,NEW_ORLEANS_PELICANS,82,95,6313,13
6313,2017-03-22,2017-03-21,GOLDEN_STATE_WARRIORS,DALLAS_MAVERICKS,112,87,6314,25
6314,2017-03-22,2017-03-21,SAN_ANTONIO_SPURS,MINNESOTA_TIMBERWOLVES,100,93,6315,7
6315,2017-03-22,2017-03-21,MILWAUKEE_BUCKS,PORTLAND_TRAIL_BLAZERS,93,90,6316,3
6316,2017-03-22,2017-03-21,LOS_ANGELES_CLIPPERS,LOS_ANGELES_LAKERS,133,109,6317,24
6317,2017-03-22,2017-03-21,CHARLOTTE_HORNETS,ORLANDO_MAGIC,109,102,6318,7
6318,2017-03-22,2017-03-21,INDIANA_PACERS,BOSTON_CELTICS,100,109,6319,9
6319,2017-03-23,2017-03-22,DETROIT_PISTONS,CHICAGO_BULLS,95,117,6320,22
6320,2017-03-23,2017-03-22,PHILADELPHIA_76ERS,OKLAHOMA_CITY_THUNDER,97,122,6321,25
6321,2017-03-23,2017-03-22,ATLANTA_HAWKS,WASHINGTON_WIZARDS,100,104,6322,4
6322,2017-03-23,2017-03-22,CLEVELAND_CAVALIERS,DENVER_NUGGETS,113,126,6323,13
6323,2017-03-23,2017-03-22,MILWAUKEE_BUCKS,SACRAMENTO_KINGS,116,98,6324,18
6324,2017-03-23,2017-03-22,NEW_YORK_KNICKS,UTAH_JAZZ,101,108,6325,7
6325,2017-03-23,2017-03-22,PHOENIX_SUNS,BROOKLYN_NETS,98,126,6326,28
6326,2017-03-23,2017-03-22,TORONTO_RAPTORS,MIAMI_HEAT,101,84,6327,17
6327,2017-03-24,2017-03-23,LOS_ANGELES_CLIPPERS,DALLAS_MAVERICKS,95,97,6328,2
6328,2017-03-24,2017-03-23,MEMPHIS_GRIZZLIES,SAN_ANTONIO_SPURS,90,97,6329,7
6329,2017-03-24,2017-03-23,NEW_YORK_KNICKS,PORTLAND_TRAIL_BLAZERS,95,110,6330,15
6330,2017-03-24,2017-03-23,CLEVELAND_CAVALIERS,CHARLOTTE_HORNETS,112,105,6331,7
6331,2017-03-24,2017-03-23,DENVER_NUGGETS,INDIANA_PACERS,125,117,6332,8
6332,2017-03-24,2017-03-23,DETROIT_PISTONS,ORLANDO_MAGIC,87,115,6333,28
6333,2017-03-24,2017-03-23,BROOKLYN_NETS,WASHINGTON_WIZARDS,108,129,6334,21
6334,2017-03-24,2017-03-23,PHOENIX_SUNS,BOSTON_CELTICS,120,130,6335,10
6335,2017-03-25,2017-03-24,PHILADELPHIA_76ERS,CHICAGO_BULLS,117,107,6336,10
6336,2017-03-25,2017-03-24,NEW_ORLEANS_PELICANS,HOUSTON_ROCKETS,107,117,6337,10
6337,2017-03-25,2017-03-24,ATLANTA_HAWKS,MILWAUKEE_BUCKS,97,100,6338,3
6338,2017-03-25,2017-03-24,SACRAMENTO_KINGS,GOLDEN_STATE_WARRIORS,100,114,6339,14
6339,2017-03-25,2017-03-24,MINNESOTA_TIMBERWOLVES,LOS_ANGELES_LAKERS,119,130,6340,11
6340,2017-03-25,2017-03-24,UTAH_JAZZ,LOS_ANGELES_CLIPPERS,95,108,6341,13
6341,2017-03-25,2017-03-24,WASHINGTON_WIZARDS,CLEVELAND_CAVALIERS,127,115,6342,12
6342,2017-03-26,2017-03-25,TORONTO_RAPTORS,DALLAS_MAVERICKS,94,86,6343,8
6343,2017-03-26,2017-03-25,NEW_YORK_KNICKS,SAN_ANTONIO_SPURS,98,106,6344,8
6344,2017-03-26,2017-03-25,MINNESOTA_TIMBERWOLVES,PORTLAND_TRAIL_BLAZERS,100,112,6345,12
6345,2017-03-26,2017-03-25,BROOKLYN_NETS,ATLANTA_HAWKS,107,92,6346,15
6346,2017-03-26,2017-03-25,PHOENIX_SUNS,CHARLOTTE_HORNETS,106,120,6347,14
6347,2017-03-26,2017-03-25,OKLAHOMA_CITY_THUNDER,HOUSTON_ROCKETS,125,137,6348,12
6348,2017-03-26,2017-03-25,SACRAMENTO_KINGS,LOS_ANGELES_CLIPPERS,98,97,6349,1
6349,2017-03-26,2017-03-25,CHICAGO_BULLS,MILWAUKEE_BUCKS,109,94,6350,15
6350,2017-03-26,2017-03-25,MIAMI_HEAT,BOSTON_CELTICS,108,112,6351,4
6351,2017-03-26,2017-03-25,PHILADELPHIA_76ERS,INDIANA_PACERS,94,107,6352,13
6352,2017-03-27,2017-03-26,NEW_ORLEANS_PELICANS,DENVER_NUGGETS,115,90,6353,25
6353,2017-03-27,2017-03-26,MEMPHIS_GRIZZLIES,GOLDEN_STATE_WARRIORS,94,106,6354,12
6354,2017-03-27,2017-03-26,PORTLAND_TRAIL_BLAZERS,LOS_ANGELES_LAKERS,97,81,6355,16
6355,2017-03-27,2017-03-26,DETROIT_PISTONS,NEW_YORK_KNICKS,95,109,6356,14
6356,2017-03-27,2017-03-26,ORLANDO_MAGIC,TORONTO_RAPTORS,112,131,6357,19
6357,2017-03-28,2017-03-27,CLEVELAND_CAVALIERS,SAN_ANTONIO_SPURS,74,103,6358,29
6358,2017-03-28,2017-03-27,OKLAHOMA_CITY_THUNDER,DALLAS_MAVERICKS,92,91,6359,1
6359,2017-03-28,2017-03-27,MEMPHIS_GRIZZLIES,SACRAMENTO_KINGS,90,91,6360,1
6360,2017-03-28,2017-03-27,NEW_ORLEANS_PELICANS,UTAH_JAZZ,100,108,6361,8
6361,2017-03-28,2017-03-27,MILWAUKEE_BUCKS,CHARLOTTE_HORNETS,118,108,6362,10
6362,2017-03-28,2017-03-27,MINNESOTA_TIMBERWOLVES,INDIANA_PACERS,115,114,6363,1
6363,2017-03-28,2017-03-27,PHOENIX_SUNS,ATLANTA_HAWKS,91,95,6364,4
6364,2017-03-28,2017-03-27,PHILADELPHIA_76ERS,BROOKLYN_NETS,106,101,6365,5
6365,2017-03-28,2017-03-27,MIAMI_HEAT,DETROIT_PISTONS,97,96,6366,1
6366,2017-03-29,2017-03-28,GOLDEN_STATE_WARRIORS,HOUSTON_ROCKETS,113,106,6367,7
6367,2017-03-29,2017-03-28,DENVER_NUGGETS,PORTLAND_TRAIL_BLAZERS,113,122,6368,9
6368,2017-03-29,2017-03-28,WASHINGTON_WIZARDS,LOS_ANGELES_LAKERS,119,108,6369,11
6369,2017-03-29,2017-03-28,OKLAHOMA_CITY_THUNDER,ORLANDO_MAGIC,114,106,6370,8
6370,2017-03-29,2017-03-28,ATLANTA_HAWKS,PHILADELPHIA_76ERS,99,92,6371,7
6371,2017-03-29,2017-03-28,MILWAUKEE_BUCKS,BOSTON_CELTICS,103,100,6372,3
6372,2017-03-29,2017-03-28,MIAMI_HEAT,NEW_YORK_KNICKS,105,88,6373,17
6373,2017-03-29,2017-03-28,CHARLOTTE_HORNETS,TORONTO_RAPTORS,110,106,6374,4
6374,2017-03-30,2017-03-29,INDIANA_PACERS,MEMPHIS_GRIZZLIES,97,110,6375,13
6375,2017-03-30,2017-03-29,DALLAS_MAVERICKS,NEW_ORLEANS_PELICANS,118,121,6376,3
6376,2017-03-30,2017-03-29,GOLDEN_STATE_WARRIORS,SAN_ANTONIO_SPURS,110,98,6377,12
6377,2017-03-30,2017-03-29,WASHINGTON_WIZARDS,LOS_ANGELES_CLIPPERS,124,133,6378,9
6378,2017-03-30,2017-03-29,UTAH_JAZZ,SACRAMENTO_KINGS,112,82,6379,30
6379,2017-03-30,2017-03-29,BROOKLYN_NETS,DETROIT_PISTONS,89,90,6380,1
6380,2017-03-31,2017-03-30,CLEVELAND_CAVALIERS,CHICAGO_BULLS,93,99,6381,6
6381,2017-03-31,2017-03-30,LOS_ANGELES_LAKERS,MINNESOTA_TIMBERWOLVES,104,119,6382,15
6382,2017-03-31,2017-03-30,LOS_ANGELES_CLIPPERS,PHOENIX_SUNS,124,118,6383,6
6383,2017-03-31,2017-03-30,HOUSTON_ROCKETS,PORTLAND_TRAIL_BLAZERS,107,117,6384,10
6384,2017-03-31,2017-03-30,DENVER_NUGGETS,CHARLOTTE_HORNETS,114,122,6385,8
6385,2017-03-31,2017-03-30,INDIANA_PACERS,TORONTO_RAPTORS,100,111,6386,11
6386,2017-03-31,2017-03-30,ORLANDO_MAGIC,BOSTON_CELTICS,116,117,6387,1
6387,2017-03-31,2017-03-30,PHILADELPHIA_76ERS,CLEVELAND_CAVALIERS,105,122,6388,17
6388,2017-04-01,2017-03-31,DALLAS_MAVERICKS,MEMPHIS_GRIZZLIES,90,99,6389,9
6389,2017-04-01,2017-03-31,NEW_YORK_KNICKS,MIAMI_HEAT,98,94,6390,4
6390,2017-04-01,2017-03-31,DETROIT_PISTONS,MILWAUKEE_BUCKS,105,108,6391,3
6391,2017-04-01,2017-03-31,SACRAMENTO_KINGS,NEW_ORLEANS_PELICANS,89,117,6392,28
6392,2017-04-01,2017-03-31,SAN_ANTONIO_SPURS,OKLAHOMA_CITY_THUNDER,100,95,6393,5
6393,2017-04-01,2017-03-31,WASHINGTON_WIZARDS,UTAH_JAZZ,88,95,6394,7
6394,2017-04-01,2017-03-31,HOUSTON_ROCKETS,GOLDEN_STATE_WARRIORS,98,107,6395,9
6395,2017-04-01,2017-03-31,LOS_ANGELES_LAKERS,LOS_ANGELES_CLIPPERS,104,115,6396,11
6396,2017-04-01,2017-03-31,ATLANTA_HAWKS,CHICAGO_BULLS,104,106,6397,2
6397,2017-04-01,2017-03-31,ORLANDO_MAGIC,BROOKLYN_NETS,111,121,6398,10
6398,2017-04-02,2017-04-01,SACRAMENTO_KINGS,MINNESOTA_TIMBERWOLVES,123,117,6399,6
6399,2017-04-02,2017-04-01,PHOENIX_SUNS,PORTLAND_TRAIL_BLAZERS,117,130,6400,13
6400,2017-04-02,2017-04-01,BOSTON_CELTICS,NEW_YORK_KNICKS,110,94,6401,16
6401,2017-04-02,2017-04-01,CHARLOTTE_HORNETS,OKLAHOMA_CITY_THUNDER,113,101,6402,12
6402,2017-04-02,2017-04-01,MEMPHIS_GRIZZLIES,LOS_ANGELES_LAKERS,103,108,6403,5
6403,2017-04-02,2017-04-01,DALLAS_MAVERICKS,MILWAUKEE_BUCKS,109,105,6404,4
6404,2017-04-02,2017-04-01,UTAH_JAZZ,SAN_ANTONIO_SPURS,103,109,6405,6
6405,2017-04-02,2017-04-01,ATLANTA_HAWKS,BROOKLYN_NETS,82,91,6406,9
6406,2017-04-02,2017-04-01,INDIANA_PACERS,CLEVELAND_CAVALIERS,130,135,6407,5
6407,2017-04-02,2017-04-01,DENVER_NUGGETS,MIAMI_HEAT,116,113,6408,3
6408,2017-04-02,2017-04-01,CHICAGO_BULLS,NEW_ORLEANS_PELICANS,117,110,6409,7
6409,2017-04-02,2017-04-01,PHILADELPHIA_76ERS,TORONTO_RAPTORS,105,113,6410,8
6410,2017-04-03,2017-04-02,WASHINGTON_WIZARDS,GOLDEN_STATE_WARRIORS,115,139,6411,24
6411,2017-04-03,2017-04-02,HOUSTON_ROCKETS,PHOENIX_SUNS,123,116,6412,7
6412,2017-04-03,2017-04-02,PORTLAND_TRAIL_BLAZERS,MINNESOTA_TIMBERWOLVES,109,110,6413,1
6413,2017-04-04,2017-04-03,ORLANDO_MAGIC,CLEVELAND_CAVALIERS,102,122,6414,20
6414,2017-04-04,2017-04-03,TORONTO_RAPTORS,INDIANA_PACERS,90,108,6415,18
6415,2017-04-04,2017-04-03,BROOKLYN_NETS,PHILADELPHIA_76ERS,141,118,6416,23
6416,2017-04-04,2017-04-03,CHARLOTTE_HORNETS,WASHINGTON_WIZARDS,111,118,6417,7
6417,2017-04-05,2017-04-04,DENVER_NUGGETS,NEW_ORLEANS_PELICANS,134,131,6418,3
6418,2017-04-05,2017-04-04,CHICAGO_BULLS,NEW_YORK_KNICKS,91,100,6419,9
6419,2017-04-05,2017-04-04,MILWAUKEE_BUCKS,OKLAHOMA_CITY_THUNDER,79,110,6420,31
6420,2017-04-05,2017-04-04,MEMPHIS_GRIZZLIES,SAN_ANTONIO_SPURS,89,95,6421,6
6421,2017-04-05,2017-04-04,PORTLAND_TRAIL_BLAZERS,UTAH_JAZZ,87,106,6422,19
6422,2017-04-05,2017-04-04,MINNESOTA_TIMBERWOLVES,GOLDEN_STATE_WARRIORS,107,121,6423,14
6423,2017-04-05,2017-04-04,DALLAS_MAVERICKS,SACRAMENTO_KINGS,87,98,6424,11
6424,2017-04-05,2017-04-04,MIAMI_HEAT,CHARLOTTE_HORNETS,112,99,6425,13
6425,2017-04-05,2017-04-04,TORONTO_RAPTORS,DETROIT_PISTONS,105,102,6426,3
6426,2017-04-06,2017-04-05,CLEVELAND_CAVALIERS,BOSTON_CELTICS,114,91,6427,23
6427,2017-04-06,2017-04-05,DENVER_NUGGETS,HOUSTON_ROCKETS,104,110,6428,6
6428,2017-04-06,2017-04-05,OKLAHOMA_CITY_THUNDER,MEMPHIS_GRIZZLIES,103,100,6429,3
6429,2017-04-06,2017-04-05,LOS_ANGELES_LAKERS,SAN_ANTONIO_SPURS,102,95,6430,7
6430,2017-04-06,2017-04-05,GOLDEN_STATE_WARRIORS,PHOENIX_SUNS,120,111,6431,9
6431,2017-04-06,2017-04-05,DALLAS_MAVERICKS,LOS_ANGELES_CLIPPERS,101,112,6432,11
6432,2017-04-06,2017-04-05,MILWAUKEE_BUCKS,INDIANA_PACERS,89,104,6433,15
6433,2017-04-06,2017-04-05,BROOKLYN_NETS,ORLANDO_MAGIC,107,115,6434,8
6434,2017-04-06,2017-04-05,CHICAGO_BULLS,PHILADELPHIA_76ERS,102,90,6435,12
6435,2017-04-06,2017-04-05,WASHINGTON_WIZARDS,NEW_YORK_KNICKS,106,103,6436,3
6436,2017-04-07,2017-04-06,BOSTON_CELTICS,ATLANTA_HAWKS,116,123,6437,7
6437,2017-04-07,2017-04-06,MINNESOTA_TIMBERWOLVES,PORTLAND_TRAIL_BLAZERS,98,105,6438,7
6438,2017-04-07,2017-04-06,ATLANTA_HAWKS,CLEVELAND_CAVALIERS,114,100,6439,14
6439,2017-04-07,2017-04-06,MIAMI_HEAT,TORONTO_RAPTORS,94,96,6440,2
6440,2017-04-08,2017-04-07,DETROIT_PISTONS,HOUSTON_ROCKETS,114,109,6441,5
6441,2017-04-08,2017-04-07,NEW_YORK_KNICKS,MEMPHIS_GRIZZLIES,88,101,6442,13
6442,2017-04-08,2017-04-07,SAN_ANTONIO_SPURS,DALLAS_MAVERICKS,102,89,6443,13
6443,2017-04-08,2017-04-07,NEW_ORLEANS_PELICANS,DENVER_NUGGETS,106,122,6444,16
6444,2017-04-08,2017-04-07,MINNESOTA_TIMBERWOLVES,UTAH_JAZZ,113,120,6445,7
6445,2017-04-08,2017-04-07,OKLAHOMA_CITY_THUNDER,PHOENIX_SUNS,99,120,6446,21
6446,2017-04-08,2017-04-07,SACRAMENTO_KINGS,LOS_ANGELES_LAKERS,94,98,6447,4
6447,2017-04-08,2017-04-07,CHICAGO_BULLS,BROOKLYN_NETS,106,107,6448,1
6448,2017-04-08,2017-04-07,BOSTON_CELTICS,CHARLOTTE_HORNETS,121,114,6449,7
6449,2017-04-08,2017-04-07,INDIANA_PACERS,ORLANDO_MAGIC,127,112,6450,15
6450,2017-04-08,2017-04-07,MILWAUKEE_BUCKS,PHILADELPHIA_76ERS,90,82,6451,8
6451,2017-04-08,2017-04-07,MIAMI_HEAT,WASHINGTON_WIZARDS,106,103,6452,3
6452,2017-04-09,2017-04-08,LOS_ANGELES_CLIPPERS,SAN_ANTONIO_SPURS,98,87,6453,11
6453,2017-04-09,2017-04-08,UTAH_JAZZ,PORTLAND_TRAIL_BLAZERS,86,101,6454,15
6454,2017-04-09,2017-04-08,NEW_ORLEANS_PELICANS,GOLDEN_STATE_WARRIORS,101,123,6455,22
6455,2017-04-09,2017-04-08,TORONTO_RAPTORS,NEW_YORK_KNICKS,110,97,6456,13
6456,2017-04-09,2017-04-08,CLEVELAND_CAVALIERS,ATLANTA_HAWKS,125,126,6457,1
6457,2017-04-09,2017-04-08,OKLAHOMA_CITY_THUNDER,DENVER_NUGGETS,106,105,6458,1
6458,2017-04-09,2017-04-08,DETROIT_PISTONS,MEMPHIS_GRIZZLIES,103,90,6459,13
6459,2017-04-09,2017-04-08,DALLAS_MAVERICKS,PHOENIX_SUNS,111,124,6460,13
6460,2017-04-09,2017-04-08,HOUSTON_ROCKETS,SACRAMENTO_KINGS,135,128,6461,7
6461,2017-04-10,2017-04-09,MINNESOTA_TIMBERWOLVES,LOS_ANGELES_LAKERS,109,110,6462,1
6462,2017-04-10,2017-04-09,INDIANA_PACERS,PHILADELPHIA_76ERS,120,111,6463,9
6463,2017-04-10,2017-04-09,BROOKLYN_NETS,BOSTON_CELTICS,105,114,6464,9
6464,2017-04-10,2017-04-09,CLEVELAND_CAVALIERS,MIAMI_HEAT,121,124,6465,3
6465,2017-04-11,2017-04-10,ORLANDO_MAGIC,CHICAGO_BULLS,75,122,6466,47
6466,2017-04-11,2017-04-10,WASHINGTON_WIZARDS,DETROIT_PISTONS,105,101,6467,4
6467,2017-04-11,2017-04-10,CHARLOTTE_HORNETS,MILWAUKEE_BUCKS,79,89,6468,10
6468,2017-04-11,2017-04-10,SAN_ANTONIO_SPURS,PORTLAND_TRAIL_BLAZERS,98,99,6469,1
6469,2017-04-11,2017-04-10,UTAH_JAZZ,GOLDEN_STATE_WARRIORS,105,99,6470,6
6470,2017-04-11,2017-04-10,HOUSTON_ROCKETS,LOS_ANGELES_CLIPPERS,96,125,6471,29
6471,2017-04-11,2017-04-10,CHARLOTTE_HORNETS,ATLANTA_HAWKS,76,103,6472,27
6472,2017-04-12,2017-04-11,OKLAHOMA_CITY_THUNDER,MINNESOTA_TIMBERWOLVES,100,98,6473,2
6473,2017-04-12,2017-04-11,DENVER_NUGGETS,DALLAS_MAVERICKS,109,91,6474,18
6474,2017-04-12,2017-04-11,NEW_ORLEANS_PELICANS,LOS_ANGELES_LAKERS,96,108,6475,12
6475,2017-04-12,2017-04-11,PHOENIX_SUNS,SACRAMENTO_KINGS,104,129,6476,25
6476,2017-04-13,2017-04-12,MILWAUKEE_BUCKS,BOSTON_CELTICS,94,112,6477,18
6477,2017-04-13,2017-04-12,BROOKLYN_NETS,CHICAGO_BULLS,73,112,6478,39
6478,2017-04-13,2017-04-12,TORONTO_RAPTORS,CLEVELAND_CAVALIERS,98,83,6479,15
6479,2017-04-13,2017-04-12,MINNESOTA_TIMBERWOLVES,HOUSTON_ROCKETS,118,123,6480,5
6480,2017-04-13,2017-04-12,ATLANTA_HAWKS,INDIANA_PACERS,86,104,6481,18
6481,2017-04-13,2017-04-12,DALLAS_MAVERICKS,MEMPHIS_GRIZZLIES,100,93,6482,7
6482,2017-04-13,2017-04-12,WASHINGTON_WIZARDS,MIAMI_HEAT,102,110,6483,8
6483,2017-04-13,2017-04-12,PHILADELPHIA_76ERS,NEW_YORK_KNICKS,113,114,6484,1
6484,2017-04-13,2017-04-12,DENVER_NUGGETS,OKLAHOMA_CITY_THUNDER,111,105,6485,6
6485,2017-04-13,2017-04-12,DETROIT_PISTONS,ORLANDO_MAGIC,109,113,6486,4
6486,2017-04-13,2017-04-12,SAN_ANTONIO_SPURS,UTAH_JAZZ,97,101,6487,4
6487,2017-04-13,2017-04-12,LOS_ANGELES_LAKERS,GOLDEN_STATE_WARRIORS,94,109,6488,15
6488,2017-04-13,2017-04-12,SACRAMENTO_KINGS,LOS_ANGELES_CLIPPERS,95,115,6489,20
6489,2017-04-13,2017-04-12,NEW_ORLEANS_PELICANS,PORTLAND_TRAIL_BLAZERS,103,100,6490,3
6490,2017-04-15,2017-04-14,INDIANA_PACERS,CLEVELAND_CAVALIERS,108,109,6491,1
6491,2017-04-15,2017-04-14,MILWAUKEE_BUCKS,TORONTO_RAPTORS,97,83,6492,14
6492,2017-04-16,2017-04-15,MEMPHIS_GRIZZLIES,SAN_ANTONIO_SPURS,82,111,6493,29
6493,2017-04-16,2017-04-15,UTAH_JAZZ,LOS_ANGELES_CLIPPERS,97,95,6494,2
6494,2017-04-16,2017-04-15,ATLANTA_HAWKS,WASHINGTON_WIZARDS,107,114,6495,7
6495,2017-04-16,2017-04-15,PORTLAND_TRAIL_BLAZERS,GOLDEN_STATE_WARRIORS,109,121,6496,12
6496,2017-04-16,2017-04-15,CHICAGO_BULLS,BOSTON_CELTICS,106,102,6497,4
6497,2017-04-17,2017-04-16,OKLAHOMA_CITY_THUNDER,HOUSTON_ROCKETS,87,118,6498,31
6498,2017-04-17,2017-04-16,INDIANA_PACERS,CLEVELAND_CAVALIERS,111,117,6499,6
6499,2017-04-18,2017-04-17,MEMPHIS_GRIZZLIES,SAN_ANTONIO_SPURS,82,96,6500,14
6500,2017-04-18,2017-04-17,MILWAUKEE_BUCKS,TORONTO_RAPTORS,100,106,6501,6
6501,2017-04-19,2017-04-18,CHICAGO_BULLS,BOSTON_CELTICS,111,97,6502,14
6502,2017-04-19,2017-04-18,UTAH_JAZZ,LOS_ANGELES_CLIPPERS,91,99,6503,8
6503,2017-04-19,2017-04-18,ATLANTA_HAWKS,WASHINGTON_WIZARDS,101,109,6504,8
6504,2017-04-20,2017-04-19,OKLAHOMA_CITY_THUNDER,HOUSTON_ROCKETS,111,115,6505,4
6505,2017-04-20,2017-04-19,PORTLAND_TRAIL_BLAZERS,GOLDEN_STATE_WARRIORS,81,110,6506,29
6506,2017-04-20,2017-04-19,CLEVELAND_CAVALIERS,INDIANA_PACERS,119,114,6507,5
6507,2017-04-21,2017-04-20,TORONTO_RAPTORS,MILWAUKEE_BUCKS,77,104,6508,27
6508,2017-04-21,2017-04-20,SAN_ANTONIO_SPURS,MEMPHIS_GRIZZLIES,94,105,6509,11
6509,2017-04-21,2017-04-20,BOSTON_CELTICS,CHICAGO_BULLS,104,87,6510,17
6510,2017-04-22,2017-04-21,HOUSTON_ROCKETS,OKLAHOMA_CITY_THUNDER,113,115,6511,2
6511,2017-04-22,2017-04-21,LOS_ANGELES_CLIPPERS,UTAH_JAZZ,111,106,6512,5
6512,2017-04-22,2017-04-21,TORONTO_RAPTORS,MILWAUKEE_BUCKS,87,76,6513,11
6513,2017-04-22,2017-04-21,WASHINGTON_WIZARDS,ATLANTA_HAWKS,98,116,6514,18
6514,2017-04-23,2017-04-22,SAN_ANTONIO_SPURS,MEMPHIS_GRIZZLIES,108,110,6515,2
6515,2017-04-23,2017-04-22,GOLDEN_STATE_WARRIORS,PORTLAND_TRAIL_BLAZERS,119,113,6516,6
6516,2017-04-23,2017-04-22,CLEVELAND_CAVALIERS,INDIANA_PACERS,106,102,6517,4
6517,2017-04-23,2017-04-22,HOUSTON_ROCKETS,OKLAHOMA_CITY_THUNDER,113,109,6518,4
6518,2017-04-23,2017-04-22,BOSTON_CELTICS,CHICAGO_BULLS,104,95,6519,9
6519,2017-04-24,2017-04-23,LOS_ANGELES_CLIPPERS,UTAH_JAZZ,98,105,6520,7
6520,2017-04-24,2017-04-23,MILWAUKEE_BUCKS,TORONTO_RAPTORS,93,118,6521,25
6521,2017-04-25,2017-04-24,WASHINGTON_WIZARDS,ATLANTA_HAWKS,101,111,6522,10
6522,2017-04-25,2017-04-24,GOLDEN_STATE_WARRIORS,PORTLAND_TRAIL_BLAZERS,128,103,6523,25
6523,2017-04-26,2017-04-25,OKLAHOMA_CITY_THUNDER,HOUSTON_ROCKETS,99,105,6524,6
6524,2017-04-26,2017-04-25,MEMPHIS_GRIZZLIES,SAN_ANTONIO_SPURS,103,116,6525,13
6525,2017-04-26,2017-04-25,UTAH_JAZZ,LOS_ANGELES_CLIPPERS,96,92,6526,4
6526,2017-04-26,2017-04-25,ATLANTA_HAWKS,WASHINGTON_WIZARDS,99,103,6527,4
6527,2017-04-27,2017-04-26,CHICAGO_BULLS,BOSTON_CELTICS,97,108,6528,11
6528,2017-04-27,2017-04-26,TORONTO_RAPTORS,MILWAUKEE_BUCKS,92,89,6529,3
6529,2017-04-28,2017-04-27,SAN_ANTONIO_SPURS,MEMPHIS_GRIZZLIES,103,96,6530,7
6530,2017-04-28,2017-04-27,WASHINGTON_WIZARDS,ATLANTA_HAWKS,115,99,6531,16
6531,2017-04-29,2017-04-28,BOSTON_CELTICS,CHICAGO_BULLS,105,83,6532,22
6532,2017-04-29,2017-04-28,LOS_ANGELES_CLIPPERS,UTAH_JAZZ,98,93,6533,5
6533,2017-04-30,2017-04-29,WASHINGTON_WIZARDS,BOSTON_CELTICS,111,123,6534,12
6534,2017-04-30,2017-04-29,UTAH_JAZZ,LOS_ANGELES_CLIPPERS,104,91,6535,13
6535,2017-05-01,2017-04-30,TORONTO_RAPTORS,CLEVELAND_CAVALIERS,105,116,6536,11
6536,2017-05-02,2017-05-01,HOUSTON_ROCKETS,SAN_ANTONIO_SPURS,126,99,6537,27
6537,2017-05-03,2017-05-02,WASHINGTON_WIZARDS,BOSTON_CELTICS,119,129,6538,10
6538,2017-05-03,2017-05-02,UTAH_JAZZ,GOLDEN_STATE_WARRIORS,94,106,6539,12
6539,2017-05-03,2017-05-02,TORONTO_RAPTORS,CLEVELAND_CAVALIERS,103,125,6540,22
6540,2017-05-04,2017-05-03,HOUSTON_ROCKETS,SAN_ANTONIO_SPURS,96,121,6541,25
6541,2017-05-05,2017-05-04,BOSTON_CELTICS,WASHINGTON_WIZARDS,89,116,6542,27
6542,2017-05-05,2017-05-04,UTAH_JAZZ,GOLDEN_STATE_WARRIORS,104,115,6543,11
6543,2017-05-05,2017-05-04,CLEVELAND_CAVALIERS,TORONTO_RAPTORS,115,94,6544,21
6544,2017-05-06,2017-05-05,SAN_ANTONIO_SPURS,HOUSTON_ROCKETS,103,92,6545,11
6545,2017-05-07,2017-05-06,GOLDEN_STATE_WARRIORS,UTAH_JAZZ,102,91,6546,11
6546,2017-05-07,2017-05-06,CLEVELAND_CAVALIERS,TORONTO_RAPTORS,109,102,6547,7
6547,2017-05-07,2017-05-06,BOSTON_CELTICS,WASHINGTON_WIZARDS,102,121,6548,19
6548,2017-05-08,2017-05-07,SAN_ANTONIO_SPURS,HOUSTON_ROCKETS,104,125,6549,21
6549,2017-05-09,2017-05-08,GOLDEN_STATE_WARRIORS,UTAH_JAZZ,121,95,6550,26
6550,2017-05-10,2017-05-09,HOUSTON_ROCKETS,SAN_ANTONIO_SPURS,107,110,6551,3
6551,2017-05-11,2017-05-10,WASHINGTON_WIZARDS,BOSTON_CELTICS,101,123,6552,22
6552,2017-05-12,2017-05-11,SAN_ANTONIO_SPURS,HOUSTON_ROCKETS,114,75,6553,39
6553,2017-05-13,2017-05-12,BOSTON_CELTICS,WASHINGTON_WIZARDS,91,92,6554,1
6554,2017-05-14,2017-05-13,SAN_ANTONIO_SPURS,GOLDEN_STATE_WARRIORS,111,113,6555,2
6555,2017-05-16,2017-05-15,WASHINGTON_WIZARDS,BOSTON_CELTICS,105,115,6556,10
6556,2017-05-17,2017-05-16,SAN_ANTONIO_SPURS,GOLDEN_STATE_WARRIORS,100,136,6557,36
6557,2017-05-18,2017-05-17,CLEVELAND_CAVALIERS,BOSTON_CELTICS,117,104,6558,13
6558,2017-05-20,2017-05-19,CLEVELAND_CAVALIERS,BOSTON_CELTICS,130,86,6559,44
6559,2017-05-21,2017-05-20,GOLDEN_STATE_WARRIORS,SAN_ANTONIO_SPURS,120,108,6560,12
6560,2017-05-22,2017-05-21,BOSTON_CELTICS,CLEVELAND_CAVALIERS,111,108,6561,3
6561,2017-05-23,2017-05-22,GOLDEN_STATE_WARRIORS,SAN_ANTONIO_SPURS,129,115,6562,14
6562,2017-05-24,2017-05-23,BOSTON_CELTICS,CLEVELAND_CAVALIERS,99,112,6563,13
6563,2017-05-26,2017-05-25,CLEVELAND_CAVALIERS,BOSTON_CELTICS,135,102,6564,33
6564,2017-06-02,2017-06-01,CLEVELAND_CAVALIERS,GOLDEN_STATE_WARRIORS,91,113,6565,22
6565,2017-06-05,2017-06-04,CLEVELAND_CAVALIERS,GOLDEN_STATE_WARRIORS,113,132,6566,19
6566,2017-06-08,2017-06-07,GOLDEN_STATE_WARRIORS,CLEVELAND_CAVALIERS,118,113,6567,5
6567,2017-06-10,2017-06-09,GOLDEN_STATE_WARRIORS,CLEVELAND_CAVALIERS,116,137,6568,21
6568,2017-06-13,2017-06-12,CLEVELAND_CAVALIERS,GOLDEN_STATE_WARRIORS,120,129,6569,9
6569,2017-10-18,2017-10-17,BOSTON_CELTICS,CLEVELAND_CAVALIERS,99,102,6570,3
6570,2017-10-18,2017-10-17,HOUSTON_ROCKETS,GOLDEN_STATE_WARRIORS,122,121,6571,1
6571,2017-10-18,2017-10-17,CHARLOTTE_HORNETS,DETROIT_PISTONS,90,102,6572,12
6572,2017-10-18,2017-10-17,BROOKLYN_NETS,INDIANA_PACERS,131,140,6573,9
6573,2017-10-18,2017-10-17,MIAMI_HEAT,ORLANDO_MAGIC,109,116,6574,7
6574,2017-10-18,2017-10-17,PHILADELPHIA_76ERS,WASHINGTON_WIZARDS,115,120,6575,5
6575,2017-10-18,2017-10-17,MILWAUKEE_BUCKS,BOSTON_CELTICS,108,100,6576,8
6576,2017-10-19,2017-10-18,NEW_ORLEANS_PELICANS,MEMPHIS_GRIZZLIES,91,103,6577,12
6577,2017-10-19,2017-10-18,ATLANTA_HAWKS,DALLAS_MAVERICKS,117,111,6578,6
6578,2017-10-19,2017-10-18,DENVER_NUGGETS,UTAH_JAZZ,96,106,6579,10
6579,2017-10-19,2017-10-18,MINNESOTA_TIMBERWOLVES,SAN_ANTONIO_SPURS,99,107,6580,8
6580,2017-10-19,2017-10-18,PORTLAND_TRAIL_BLAZERS,PHOENIX_SUNS,124,76,6581,48
6581,2017-10-19,2017-10-18,HOUSTON_ROCKETS,SACRAMENTO_KINGS,105,100,6582,5
6582,2017-10-19,2017-10-18,CHICAGO_BULLS,TORONTO_RAPTORS,100,117,6583,17
6583,2017-10-20,2017-10-19,NEW_YORK_KNICKS,OKLAHOMA_CITY_THUNDER,84,105,6584,21
6584,2017-10-20,2017-10-19,LOS_ANGELES_CLIPPERS,LOS_ANGELES_LAKERS,108,92,6585,16
6585,2017-10-20,2017-10-19,ATLANTA_HAWKS,CHARLOTTE_HORNETS,91,109,6586,18
6586,2017-10-20,2017-10-19,PORTLAND_TRAIL_BLAZERS,INDIANA_PACERS,114,96,6587,18
6587,2017-10-20,2017-10-19,CLEVELAND_CAVALIERS,MILWAUKEE_BUCKS,116,97,6588,19
6588,2017-10-20,2017-10-19,BOSTON_CELTICS,PHILADELPHIA_76ERS,102,92,6589,10
6589,2017-10-20,2017-10-19,DETROIT_PISTONS,WASHINGTON_WIZARDS,111,115,6590,4
6590,2017-10-20,2017-10-19,ORLANDO_MAGIC,BROOKLYN_NETS,121,126,6591,5
6591,2017-10-21,2017-10-20,UTAH_JAZZ,MINNESOTA_TIMBERWOLVES,97,100,6592,3
6592,2017-10-21,2017-10-20,SACRAMENTO_KINGS,DALLAS_MAVERICKS,93,88,6593,5
6593,2017-10-21,2017-10-20,GOLDEN_STATE_WARRIORS,NEW_ORLEANS_PELICANS,128,120,6594,8
6594,2017-10-21,2017-10-20,LOS_ANGELES_LAKERS,PHOENIX_SUNS,132,130,6595,2
6595,2017-10-21,2017-10-20,PHILADELPHIA_76ERS,TORONTO_RAPTORS,94,128,6596,34
6596,2017-10-22,2017-10-21,SAN_ANTONIO_SPURS,CHICAGO_BULLS,87,77,6597,10
6597,2017-10-22,2017-10-21,ORLANDO_MAGIC,CLEVELAND_CAVALIERS,114,93,6598,21
6598,2017-10-22,2017-10-21,DALLAS_MAVERICKS,HOUSTON_ROCKETS,91,107,6599,16
6599,2017-10-22,2017-10-21,GOLDEN_STATE_WARRIORS,MEMPHIS_GRIZZLIES,101,111,6600,10
6600,2017-10-22,2017-10-21,INDIANA_PACERS,MIAMI_HEAT,108,112,6601,4
6601,2017-10-22,2017-10-21,DETROIT_PISTONS,NEW_YORK_KNICKS,111,107,6602,4
6602,2017-10-22,2017-10-21,PORTLAND_TRAIL_BLAZERS,MILWAUKEE_BUCKS,110,113,6603,3
6603,2017-10-22,2017-10-21,SACRAMENTO_KINGS,DENVER_NUGGETS,79,96,6604,17
6604,2017-10-22,2017-10-21,OKLAHOMA_CITY_THUNDER,UTAH_JAZZ,87,96,6605,9
6605,2017-10-22,2017-10-21,PHOENIX_SUNS,LOS_ANGELES_CLIPPERS,88,130,6606,42
6606,2017-10-22,2017-10-21,ATLANTA_HAWKS,BROOKLYN_NETS,104,116,6607,12
6607,2017-10-22,2017-10-21,MINNESOTA_TIMBERWOLVES,OKLAHOMA_CITY_THUNDER,115,113,6608,2
6608,2017-10-23,2017-10-22,NEW_ORLEANS_PELICANS,LOS_ANGELES_LAKERS,119,112,6609,7
6609,2017-10-23,2017-10-22,PHILADELPHIA_76ERS,DETROIT_PISTONS,97,86,6610,11
6610,2017-10-23,2017-10-22,ATLANTA_HAWKS,MIAMI_HEAT,93,104,6611,11
6611,2017-10-24,2017-10-23,MEMPHIS_GRIZZLIES,HOUSTON_ROCKETS,98,90,6612,8
6612,2017-10-24,2017-10-23,CHARLOTTE_HORNETS,MILWAUKEE_BUCKS,94,103,6613,9
6613,2017-10-24,2017-10-23,GOLDEN_STATE_WARRIORS,DALLAS_MAVERICKS,133,103,6614,30
6614,2017-10-24,2017-10-23,TORONTO_RAPTORS,SAN_ANTONIO_SPURS,97,101,6615,4
6615,2017-10-24,2017-10-23,WASHINGTON_WIZARDS,DENVER_NUGGETS,109,104,6616,5
6616,2017-10-24,2017-10-23,SACRAMENTO_KINGS,PHOENIX_SUNS,115,117,6617,2
6617,2017-10-24,2017-10-23,CHICAGO_BULLS,CLEVELAND_CAVALIERS,112,119,6618,7
6618,2017-10-24,2017-10-23,BROOKLYN_NETS,ORLANDO_MAGIC,121,125,6619,4
6619,2017-10-24,2017-10-23,NEW_YORK_KNICKS,BOSTON_CELTICS,89,110,6620,21
6620,2017-10-25,2017-10-24,INDIANA_PACERS,MINNESOTA_TIMBERWOLVES,130,107,6621,23
6621,2017-10-25,2017-10-24,NEW_ORLEANS_PELICANS,PORTLAND_TRAIL_BLAZERS,93,103,6622,10
6622,2017-10-25,2017-10-24,UTAH_JAZZ,LOS_ANGELES_CLIPPERS,84,102,6623,18
6623,2017-10-25,2017-10-24,DENVER_NUGGETS,CHARLOTTE_HORNETS,93,110,6624,17
6624,2017-10-25,2017-10-24,MINNESOTA_TIMBERWOLVES,DETROIT_PISTONS,101,122,6625,21
6625,2017-10-25,2017-10-24,HOUSTON_ROCKETS,PHILADELPHIA_76ERS,105,104,6626,1
6626,2017-10-25,2017-10-24,CLEVELAND_CAVALIERS,BROOKLYN_NETS,107,112,6627,5
6627,2017-10-26,2017-10-25,SAN_ANTONIO_SPURS,MIAMI_HEAT,117,100,6628,17
6628,2017-10-26,2017-10-25,INDIANA_PACERS,OKLAHOMA_CITY_THUNDER,96,114,6629,18
6629,2017-10-26,2017-10-25,MEMPHIS_GRIZZLIES,DALLAS_MAVERICKS,94,103,6630,9
6630,2017-10-26,2017-10-25,UTAH_JAZZ,PHOENIX_SUNS,88,97,6631,9
6631,2017-10-26,2017-10-25,TORONTO_RAPTORS,GOLDEN_STATE_WARRIORS,112,117,6632,5
6632,2017-10-26,2017-10-25,WASHINGTON_WIZARDS,LOS_ANGELES_LAKERS,99,102,6633,3
6633,2017-10-27,2017-10-26,ATLANTA_HAWKS,CHICAGO_BULLS,86,91,6634,5
6634,2017-10-27,2017-10-26,DALLAS_MAVERICKS,MEMPHIS_GRIZZLIES,91,96,6635,5
6635,2017-10-27,2017-10-26,BOSTON_CELTICS,MILWAUKEE_BUCKS,96,89,6636,7
6636,2017-10-27,2017-10-26,LOS_ANGELES_CLIPPERS,PORTLAND_TRAIL_BLAZERS,104,103,6637,1
6637,2017-10-27,2017-10-26,NEW_ORLEANS_PELICANS,SACRAMENTO_KINGS,114,106,6638,8
6638,2017-10-27,2017-10-26,HOUSTON_ROCKETS,CHARLOTTE_HORNETS,109,93,6639,16
6639,2017-10-27,2017-10-26,SAN_ANTONIO_SPURS,ORLANDO_MAGIC,87,114,6640,27
6640,2017-10-27,2017-10-26,DENVER_NUGGETS,ATLANTA_HAWKS,105,100,6641,5
6641,2017-10-27,2017-10-26,BROOKLYN_NETS,NEW_YORK_KNICKS,86,107,6642,21
6642,2017-10-28,2017-10-27,OKLAHOMA_CITY_THUNDER,MINNESOTA_TIMBERWOLVES,116,119,6643,3
6643,2017-10-28,2017-10-27,WASHINGTON_WIZARDS,GOLDEN_STATE_WARRIORS,117,120,6644,3
6644,2017-10-28,2017-10-27,TORONTO_RAPTORS,LOS_ANGELES_LAKERS,101,92,6645,9
6645,2017-10-28,2017-10-27,CLEVELAND_CAVALIERS,NEW_ORLEANS_PELICANS,101,123,6646,22
6646,2017-10-29,2017-10-28,OKLAHOMA_CITY_THUNDER,CHICAGO_BULLS,101,69,6647,32
6647,2017-10-29,2017-10-28,HOUSTON_ROCKETS,MEMPHIS_GRIZZLIES,89,103,6648,14
6648,2017-10-29,2017-10-28,BOSTON_CELTICS,MIAMI_HEAT,96,90,6649,6
6649,2017-10-29,2017-10-28,PHILADELPHIA_76ERS,DALLAS_MAVERICKS,112,110,6650,2
6650,2017-10-29,2017-10-28,LOS_ANGELES_LAKERS,UTAH_JAZZ,81,96,6651,15
6651,2017-10-29,2017-10-28,PHOENIX_SUNS,PORTLAND_TRAIL_BLAZERS,107,114,6652,7
6652,2017-10-29,2017-10-28,DETROIT_PISTONS,LOS_ANGELES_CLIPPERS,95,87,6653,8
6653,2017-10-29,2017-10-28,MILWAUKEE_BUCKS,ATLANTA_HAWKS,117,106,6654,11
6654,2017-10-29,2017-10-28,SAN_ANTONIO_SPURS,INDIANA_PACERS,94,97,6655,3
6655,2017-10-29,2017-10-28,DENVER_NUGGETS,BROOKLYN_NETS,124,111,6656,13
6656,2017-10-29,2017-10-28,ORLANDO_MAGIC,CHARLOTTE_HORNETS,113,120,6657,7
6657,2017-10-29,2017-10-28,WASHINGTON_WIZARDS,SACRAMENTO_KINGS,110,83,6658,27
6658,2017-10-29,2017-10-28,NEW_YORK_KNICKS,CLEVELAND_CAVALIERS,114,95,6659,19
6659,2017-10-30,2017-10-29,DETROIT_PISTONS,GOLDEN_STATE_WARRIORS,115,107,6660,8
6660,2017-10-30,2017-10-29,SAN_ANTONIO_SPURS,BOSTON_CELTICS,94,108,6661,14
6661,2017-10-30,2017-10-29,MINNESOTA_TIMBERWOLVES,MIAMI_HEAT,125,122,6662,3
6662,2017-10-30,2017-10-29,DENVER_NUGGETS,NEW_YORK_KNICKS,110,116,6663,6
6663,2017-10-31,2017-10-30,PHILADELPHIA_76ERS,HOUSTON_ROCKETS,115,107,6664,8
6664,2017-10-31,2017-10-30,CHARLOTTE_HORNETS,MEMPHIS_GRIZZLIES,104,99,6665,5
6665,2017-10-31,2017-10-30,ORLANDO_MAGIC,NEW_ORLEANS_PELICANS,115,99,6666,16
6666,2017-10-31,2017-10-30,DALLAS_MAVERICKS,UTAH_JAZZ,89,104,6667,15
6667,2017-10-31,2017-10-30,TORONTO_RAPTORS,PORTLAND_TRAIL_BLAZERS,99,85,6668,14
6668,2017-10-31,2017-10-30,GOLDEN_STATE_WARRIORS,LOS_ANGELES_CLIPPERS,141,113,6669,28
6669,2017-10-31,2017-10-30,SACRAMENTO_KINGS,INDIANA_PACERS,83,101,6670,18
6670,2017-10-31,2017-10-30,PHOENIX_SUNS,BROOKLYN_NETS,122,114,6671,8
6671,2017-11-01,2017-10-31,OKLAHOMA_CITY_THUNDER,MILWAUKEE_BUCKS,110,91,6672,19
6672,2017-11-01,2017-10-31,DETROIT_PISTONS,LOS_ANGELES_LAKERS,93,113,6673,20
6673,2017-11-01,2017-10-31,MILWAUKEE_BUCKS,CHARLOTTE_HORNETS,121,126,6674,5
6674,2017-11-01,2017-10-31,INDIANA_PACERS,CLEVELAND_CAVALIERS,124,107,6675,17
6675,2017-11-01,2017-10-31,ATLANTA_HAWKS,PHILADELPHIA_76ERS,109,119,6676,10
6676,2017-11-01,2017-10-31,PHOENIX_SUNS,WASHINGTON_WIZARDS,122,116,6677,6
6677,2017-11-01,2017-10-31,SACRAMENTO_KINGS,BOSTON_CELTICS,86,113,6678,27
6678,2017-11-01,2017-10-31,CHICAGO_BULLS,MIAMI_HEAT,91,97,6679,6
6679,2017-11-02,2017-11-01,ORLANDO_MAGIC,MEMPHIS_GRIZZLIES,101,99,6680,2
6680,2017-11-02,2017-11-01,MINNESOTA_TIMBERWOLVES,NEW_ORLEANS_PELICANS,104,98,6681,6
6681,2017-11-02,2017-11-01,HOUSTON_ROCKETS,NEW_YORK_KNICKS,119,97,6682,22
6682,2017-11-02,2017-11-01,TORONTO_RAPTORS,DENVER_NUGGETS,111,129,6683,18
6683,2017-11-02,2017-11-01,PORTLAND_TRAIL_BLAZERS,UTAH_JAZZ,103,112,6684,9
6684,2017-11-02,2017-11-01,DALLAS_MAVERICKS,LOS_ANGELES_CLIPPERS,98,119,6685,21
6685,2017-11-03,2017-11-02,GOLDEN_STATE_WARRIORS,SAN_ANTONIO_SPURS,112,92,6686,20
6686,2017-11-03,2017-11-02,LOS_ANGELES_LAKERS,PORTLAND_TRAIL_BLAZERS,110,113,6687,3
6687,2017-11-03,2017-11-02,MILWAUKEE_BUCKS,DETROIT_PISTONS,96,105,6688,9
6688,2017-11-03,2017-11-02,CHICAGO_BULLS,ORLANDO_MAGIC,105,83,6689,22
6689,2017-11-03,2017-11-02,INDIANA_PACERS,PHILADELPHIA_76ERS,110,121,6690,11
6690,2017-11-03,2017-11-02,CLEVELAND_CAVALIERS,WASHINGTON_WIZARDS,130,122,6691,8
6691,2017-11-03,2017-11-02,HOUSTON_ROCKETS,ATLANTA_HAWKS,119,104,6692,15
6692,2017-11-03,2017-11-02,PHOENIX_SUNS,NEW_YORK_KNICKS,107,120,6693,13
6693,2017-11-04,2017-11-03,NEW_ORLEANS_PELICANS,DALLAS_MAVERICKS,99,94,6694,5
6694,2017-11-04,2017-11-03,CHARLOTTE_HORNETS,SAN_ANTONIO_SPURS,101,108,6695,7
6695,2017-11-04,2017-11-03,MIAMI_HEAT,DENVER_NUGGETS,94,95,6696,1
6696,2017-11-04,2017-11-03,TORONTO_RAPTORS,UTAH_JAZZ,109,100,6697,9
6697,2017-11-04,2017-11-03,BOSTON_CELTICS,OKLAHOMA_CITY_THUNDER,101,94,6698,7
6698,2017-11-04,2017-11-03,BROOKLYN_NETS,LOS_ANGELES_LAKERS,112,124,6699,12
6699,2017-11-04,2017-11-03,MEMPHIS_GRIZZLIES,LOS_ANGELES_CLIPPERS,113,104,6700,9
6700,2017-11-04,2017-11-03,SACRAMENTO_KINGS,DETROIT_PISTONS,99,108,6701,9
6701,2017-11-05,2017-11-04,NEW_ORLEANS_PELICANS,CHICAGO_BULLS,96,90,6702,6
6702,2017-11-05,2017-11-04,DALLAS_MAVERICKS,MINNESOTA_TIMBERWOLVES,99,112,6703,13
6703,2017-11-05,2017-11-04,GOLDEN_STATE_WARRIORS,DENVER_NUGGETS,127,108,6704,19
6704,2017-11-05,2017-11-04,ATLANTA_HAWKS,CLEVELAND_CAVALIERS,117,115,6705,2
6705,2017-11-05,2017-11-04,MIAMI_HEAT,LOS_ANGELES_CLIPPERS,104,101,6706,3
6706,2017-11-05,2017-11-04,BOSTON_CELTICS,ORLANDO_MAGIC,104,88,6707,16
6707,2017-11-05,2017-11-04,WASHINGTON_WIZARDS,TORONTO_RAPTORS,107,96,6708,11
6708,2017-11-06,2017-11-05,UTAH_JAZZ,HOUSTON_ROCKETS,110,137,6709,27
6709,2017-11-06,2017-11-05,PHOENIX_SUNS,SAN_ANTONIO_SPURS,95,112,6710,17
6710,2017-11-06,2017-11-05,INDIANA_PACERS,NEW_YORK_KNICKS,101,108,6711,7
6711,2017-11-06,2017-11-05,CHARLOTTE_HORNETS,MINNESOTA_TIMBERWOLVES,94,112,6712,18
6712,2017-11-06,2017-11-05,OKLAHOMA_CITY_THUNDER,PORTLAND_TRAIL_BLAZERS,99,103,6713,4
6713,2017-11-06,2017-11-05,MEMPHIS_GRIZZLIES,LOS_ANGELES_LAKERS,102,107,6714,5
6714,2017-11-07,2017-11-06,BOSTON_CELTICS,ATLANTA_HAWKS,110,107,6715,3
6715,2017-11-07,2017-11-06,BROOKLYN_NETS,PHOENIX_SUNS,98,92,6716,6
6716,2017-11-07,2017-11-06,MIAMI_HEAT,GOLDEN_STATE_WARRIORS,80,97,6717,17
6717,2017-11-08,2017-11-07,MILWAUKEE_BUCKS,CLEVELAND_CAVALIERS,119,124,6718,5
6718,2017-11-08,2017-11-07,NEW_ORLEANS_PELICANS,INDIANA_PACERS,117,112,6719,5
6719,2017-11-08,2017-11-07,DALLAS_MAVERICKS,WASHINGTON_WIZARDS,113,99,6720,14
6720,2017-11-08,2017-11-07,CHARLOTTE_HORNETS,NEW_YORK_KNICKS,113,118,6721,5
6721,2017-11-08,2017-11-07,CHICAGO_BULLS,TORONTO_RAPTORS,114,119,6722,5
6722,2017-11-08,2017-11-07,LOS_ANGELES_CLIPPERS,SAN_ANTONIO_SPURS,107,120,6723,13
6723,2017-11-08,2017-11-07,BROOKLYN_NETS,DENVER_NUGGETS,104,112,6724,8
6724,2017-11-08,2017-11-07,PHILADELPHIA_76ERS,UTAH_JAZZ,104,97,6725,7
6725,2017-11-08,2017-11-07,MEMPHIS_GRIZZLIES,PORTLAND_TRAIL_BLAZERS,98,97,6726,1
6726,2017-11-08,2017-11-07,OKLAHOMA_CITY_THUNDER,SACRAMENTO_KINGS,86,94,6727,8
6727,2017-11-09,2017-11-08,INDIANA_PACERS,DETROIT_PISTONS,97,114,6728,17
6728,2017-11-09,2017-11-08,NEW_YORK_KNICKS,ORLANDO_MAGIC,99,112,6729,13
6729,2017-11-09,2017-11-08,LOS_ANGELES_LAKERS,BOSTON_CELTICS,96,107,6730,11
6730,2017-11-09,2017-11-08,MIAMI_HEAT,PHOENIX_SUNS,126,115,6731,11
6731,2017-11-09,2017-11-08,MINNESOTA_TIMBERWOLVES,GOLDEN_STATE_WARRIORS,101,125,6732,24
6732,2017-11-10,2017-11-09,LOS_ANGELES_LAKERS,WASHINGTON_WIZARDS,95,111,6733,16
6733,2017-11-10,2017-11-09,NEW_ORLEANS_PELICANS,TORONTO_RAPTORS,118,122,6734,4
6734,2017-11-10,2017-11-09,CLEVELAND_CAVALIERS,HOUSTON_ROCKETS,113,117,6735,4
6735,2017-11-10,2017-11-09,PHILADELPHIA_76ERS,SACRAMENTO_KINGS,108,109,6736,1
6736,2017-11-10,2017-11-09,OKLAHOMA_CITY_THUNDER,DENVER_NUGGETS,94,102,6737,8
6737,2017-11-11,2017-11-10,ATLANTA_HAWKS,DETROIT_PISTONS,104,111,6738,7
6738,2017-11-11,2017-11-10,CHARLOTTE_HORNETS,BOSTON_CELTICS,87,90,6739,3
6739,2017-11-11,2017-11-10,INDIANA_PACERS,CHICAGO_BULLS,105,87,6740,18
6740,2017-11-11,2017-11-10,LOS_ANGELES_CLIPPERS,OKLAHOMA_CITY_THUNDER,111,120,6741,9
6741,2017-11-11,2017-11-10,ORLANDO_MAGIC,PHOENIX_SUNS,128,112,6742,16
6742,2017-11-11,2017-11-10,MILWAUKEE_BUCKS,SAN_ANTONIO_SPURS,94,87,6743,7
6743,2017-11-11,2017-11-10,MIAMI_HEAT,UTAH_JAZZ,84,74,6744,10
6744,2017-11-11,2017-11-10,BROOKLYN_NETS,PORTLAND_TRAIL_BLAZERS,101,97,6745,4
6745,2017-11-12,2017-11-11,LOS_ANGELES_CLIPPERS,NEW_ORLEANS_PELICANS,103,111,6746,8
6746,2017-11-12,2017-11-11,ATLANTA_HAWKS,WASHINGTON_WIZARDS,94,113,6747,19
6747,2017-11-12,2017-11-11,MEMPHIS_GRIZZLIES,HOUSTON_ROCKETS,96,111,6748,15
6748,2017-11-12,2017-11-11,SACRAMENTO_KINGS,NEW_YORK_KNICKS,91,118,6749,27
6749,2017-11-12,2017-11-11,CLEVELAND_CAVALIERS,DALLAS_MAVERICKS,111,104,6750,7
6750,2017-11-12,2017-11-11,PHILADELPHIA_76ERS,GOLDEN_STATE_WARRIORS,114,135,6751,21
6751,2017-11-12,2017-11-11,LOS_ANGELES_LAKERS,MILWAUKEE_BUCKS,90,98,6752,8
6752,2017-11-12,2017-11-11,CHICAGO_BULLS,SAN_ANTONIO_SPURS,94,133,6753,39
6753,2017-11-12,2017-11-11,ORLANDO_MAGIC,DENVER_NUGGETS,107,125,6754,18
6754,2017-11-12,2017-11-11,MINNESOTA_TIMBERWOLVES,PHOENIX_SUNS,110,118,6755,8
6755,2017-11-12,2017-11-11,BROOKLYN_NETS,UTAH_JAZZ,106,114,6756,8
6756,2017-11-12,2017-11-11,TORONTO_RAPTORS,BOSTON_CELTICS,94,95,6757,1
6757,2017-11-12,2017-11-11,MIAMI_HEAT,DETROIT_PISTONS,103,112,6758,9
6758,2017-11-12,2017-11-11,HOUSTON_ROCKETS,INDIANA_PACERS,118,95,6759,23
6759,2017-11-13,2017-11-12,DALLAS_MAVERICKS,OKLAHOMA_CITY_THUNDER,99,112,6760,13
6760,2017-11-14,2017-11-13,SACRAMENTO_KINGS,WASHINGTON_WIZARDS,92,110,6761,18
6761,2017-11-14,2017-11-13,CLEVELAND_CAVALIERS,NEW_YORK_KNICKS,104,101,6762,3
6762,2017-11-14,2017-11-13,MEMPHIS_GRIZZLIES,MILWAUKEE_BUCKS,103,110,6763,7
6763,2017-11-14,2017-11-13,ATLANTA_HAWKS,NEW_ORLEANS_PELICANS,105,106,6764,1
6764,2017-11-14,2017-11-13,LOS_ANGELES_LAKERS,PHOENIX_SUNS,100,93,6765,7
6765,2017-11-14,2017-11-13,MINNESOTA_TIMBERWOLVES,UTAH_JAZZ,109,98,6766,11
6766,2017-11-14,2017-11-13,DENVER_NUGGETS,PORTLAND_TRAIL_BLAZERS,82,99,6767,17
6767,2017-11-14,2017-11-13,ORLANDO_MAGIC,GOLDEN_STATE_WARRIORS,100,110,6768,10
6768,2017-11-14,2017-11-13,PHILADELPHIA_76ERS,LOS_ANGELES_CLIPPERS,109,105,6769,4
6769,2017-11-15,2017-11-14,BOSTON_CELTICS,BROOKLYN_NETS,109,102,6770,7
6770,2017-11-15,2017-11-14,TORONTO_RAPTORS,HOUSTON_ROCKETS,129,113,6771,16
6771,2017-11-15,2017-11-14,SAN_ANTONIO_SPURS,DALLAS_MAVERICKS,97,91,6772,6
6772,2017-11-16,2017-11-15,SACRAMENTO_KINGS,ATLANTA_HAWKS,80,126,6773,46
6773,2017-11-16,2017-11-15,WASHINGTON_WIZARDS,MIAMI_HEAT,102,93,6774,9
6774,2017-11-16,2017-11-15,UTAH_JAZZ,NEW_YORK_KNICKS,101,106,6775,5
6775,2017-11-16,2017-11-15,CLEVELAND_CAVALIERS,CHARLOTTE_HORNETS,115,107,6776,8
6776,2017-11-16,2017-11-15,INDIANA_PACERS,MEMPHIS_GRIZZLIES,116,113,6777,3
6777,2017-11-16,2017-11-15,DETROIT_PISTONS,MILWAUKEE_BUCKS,95,99,6778,4
6778,2017-11-16,2017-11-15,SAN_ANTONIO_SPURS,MINNESOTA_TIMBERWOLVES,86,98,6779,12
6779,2017-11-16,2017-11-15,TORONTO_RAPTORS,NEW_ORLEANS_PELICANS,125,116,6780,9
6780,2017-11-16,2017-11-15,CHICAGO_BULLS,OKLAHOMA_CITY_THUNDER,79,92,6781,13
6781,2017-11-16,2017-11-15,ORLANDO_MAGIC,PORTLAND_TRAIL_BLAZERS,94,99,6782,5
6782,2017-11-16,2017-11-15,PHILADELPHIA_76ERS,LOS_ANGELES_LAKERS,115,109,6783,6
6783,2017-11-17,2017-11-16,GOLDEN_STATE_WARRIORS,BOSTON_CELTICS,88,92,6784,4
6784,2017-11-17,2017-11-16,HOUSTON_ROCKETS,PHOENIX_SUNS,142,116,6785,26
6785,2017-11-18,2017-11-17,DETROIT_PISTONS,INDIANA_PACERS,100,107,6786,7
6786,2017-11-18,2017-11-17,MIAMI_HEAT,WASHINGTON_WIZARDS,91,88,6787,3
6787,2017-11-18,2017-11-17,UTAH_JAZZ,BROOKLYN_NETS,107,118,6788,11
6788,2017-11-18,2017-11-17,LOS_ANGELES_CLIPPERS,CLEVELAND_CAVALIERS,113,118,6789,5
6789,2017-11-18,2017-11-17,NEW_YORK_KNICKS,TORONTO_RAPTORS,84,107,6790,23
6790,2017-11-18,2017-11-17,CHARLOTTE_HORNETS,CHICAGO_BULLS,120,123,6791,3
6791,2017-11-18,2017-11-17,OKLAHOMA_CITY_THUNDER,SAN_ANTONIO_SPURS,101,104,6792,3
6792,2017-11-18,2017-11-17,MINNESOTA_TIMBERWOLVES,DALLAS_MAVERICKS,111,87,6793,24
6793,2017-11-18,2017-11-17,PORTLAND_TRAIL_BLAZERS,SACRAMENTO_KINGS,82,86,6794,4
6794,2017-11-18,2017-11-17,NEW_ORLEANS_PELICANS,DENVER_NUGGETS,114,146,6795,32
6795,2017-11-18,2017-11-17,PHOENIX_SUNS,LOS_ANGELES_LAKERS,122,113,6796,9
6796,2017-11-19,2017-11-18,LOS_ANGELES_CLIPPERS,CHARLOTTE_HORNETS,87,102,6797,15
6797,2017-11-19,2017-11-18,UTAH_JAZZ,ORLANDO_MAGIC,125,85,6798,40
6798,2017-11-19,2017-11-18,BOSTON_CELTICS,ATLANTA_HAWKS,110,99,6799,11
6799,2017-11-19,2017-11-18,GOLDEN_STATE_WARRIORS,PHILADELPHIA_76ERS,124,116,6800,8
6800,2017-11-19,2017-11-18,HOUSTON_ROCKETS,MEMPHIS_GRIZZLIES,105,83,6801,22
6801,2017-11-19,2017-11-18,MILWAUKEE_BUCKS,DALLAS_MAVERICKS,79,111,6802,32
6802,2017-11-19,2017-11-18,SACRAMENTO_KINGS,PORTLAND_TRAIL_BLAZERS,90,102,6803,12
6803,2017-11-19,2017-11-18,WASHINGTON_WIZARDS,TORONTO_RAPTORS,91,100,6804,9
6804,2017-11-19,2017-11-18,INDIANA_PACERS,MIAMI_HEAT,120,95,6805,25
6805,2017-11-19,2017-11-18,GOLDEN_STATE_WARRIORS,BROOKLYN_NETS,118,111,6806,7
6806,2017-11-20,2017-11-19,DETROIT_PISTONS,MINNESOTA_TIMBERWOLVES,100,97,6807,3
6807,2017-11-20,2017-11-19,CHICAGO_BULLS,PHOENIX_SUNS,105,113,6808,8
6808,2017-11-20,2017-11-19,DENVER_NUGGETS,LOS_ANGELES_LAKERS,109,127,6809,18
6809,2017-11-21,2017-11-20,MINNESOTA_TIMBERWOLVES,CHARLOTTE_HORNETS,102,118,6810,16
6810,2017-11-21,2017-11-20,CLEVELAND_CAVALIERS,DETROIT_PISTONS,116,88,6811,28
6811,2017-11-21,2017-11-20,INDIANA_PACERS,ORLANDO_MAGIC,105,97,6812,8
6812,2017-11-21,2017-11-20,UTAH_JAZZ,PHILADELPHIA_76ERS,86,107,6813,21
6813,2017-11-21,2017-11-20,LOS_ANGELES_CLIPPERS,NEW_YORK_KNICKS,85,107,6814,22
6814,2017-11-21,2017-11-20,PORTLAND_TRAIL_BLAZERS,MEMPHIS_GRIZZLIES,100,92,6815,8
6815,2017-11-21,2017-11-20,WASHINGTON_WIZARDS,MILWAUKEE_BUCKS,99,88,6816,11
6816,2017-11-21,2017-11-20,OKLAHOMA_CITY_THUNDER,NEW_ORLEANS_PELICANS,107,114,6817,7
6817,2017-11-21,2017-11-20,BOSTON_CELTICS,DALLAS_MAVERICKS,110,102,6818,8
6818,2017-11-21,2017-11-20,ATLANTA_HAWKS,SAN_ANTONIO_SPURS,85,96,6819,11
6819,2017-11-21,2017-11-20,DENVER_NUGGETS,SACRAMENTO_KINGS,114,98,6820,16
6820,2017-11-22,2017-11-21,CHICAGO_BULLS,LOS_ANGELES_LAKERS,94,103,6821,9
6821,2017-11-23,2017-11-22,WASHINGTON_WIZARDS,CHARLOTTE_HORNETS,124,129,6822,5
6822,2017-11-23,2017-11-22,BROOKLYN_NETS,CLEVELAND_CAVALIERS,109,119,6823,10
6823,2017-11-23,2017-11-22,PORTLAND_TRAIL_BLAZERS,PHILADELPHIA_76ERS,81,101,6824,20
6824,2017-11-23,2017-11-22,LOS_ANGELES_CLIPPERS,ATLANTA_HAWKS,116,103,6825,13
6825,2017-11-23,2017-11-22,BOSTON_CELTICS,MIAMI_HEAT,98,104,6826,6
6826,2017-11-23,2017-11-22,TORONTO_RAPTORS,NEW_YORK_KNICKS,100,108,6827,8
6827,2017-11-23,2017-11-22,DENVER_NUGGETS,HOUSTON_ROCKETS,95,125,6828,30
6828,2017-11-23,2017-11-22,DALLAS_MAVERICKS,MEMPHIS_GRIZZLIES,95,94,6829,1
6829,2017-11-23,2017-11-22,ORLANDO_MAGIC,MINNESOTA_TIMBERWOLVES,118,124,6830,6
6830,2017-11-23,2017-11-22,SAN_ANTONIO_SPURS,NEW_ORLEANS_PELICANS,90,107,6831,17
6831,2017-11-23,2017-11-22,GOLDEN_STATE_WARRIORS,OKLAHOMA_CITY_THUNDER,91,108,6832,17
6832,2017-11-23,2017-11-22,MILWAUKEE_BUCKS,PHOENIX_SUNS,113,107,6833,6
6833,2017-11-23,2017-11-22,CHICAGO_BULLS,UTAH_JAZZ,80,110,6834,30
6834,2017-11-23,2017-11-22,LOS_ANGELES_LAKERS,SACRAMENTO_KINGS,102,113,6835,11
6835,2017-11-24,2017-11-23,PORTLAND_TRAIL_BLAZERS,BROOKLYN_NETS,127,125,6836,2
6836,2017-11-25,2017-11-24,NEW_YORK_KNICKS,ATLANTA_HAWKS,104,116,6837,12
6837,2017-11-25,2017-11-24,ORLANDO_MAGIC,BOSTON_CELTICS,103,118,6838,15
6838,2017-11-25,2017-11-24,CHARLOTTE_HORNETS,CLEVELAND_CAVALIERS,99,100,6839,1
6839,2017-11-25,2017-11-24,TORONTO_RAPTORS,INDIANA_PACERS,104,107,6840,3
6840,2017-11-25,2017-11-24,MIAMI_HEAT,MINNESOTA_TIMBERWOLVES,109,97,6841,12
6841,2017-11-25,2017-11-24,DETROIT_PISTONS,OKLAHOMA_CITY_THUNDER,99,98,6842,1
6842,2017-11-25,2017-11-24,MEMPHIS_GRIZZLIES,DENVER_NUGGETS,92,104,6843,12
6843,2017-11-25,2017-11-24,NEW_ORLEANS_PELICANS,PHOENIX_SUNS,115,91,6844,24
6844,2017-11-25,2017-11-24,CHICAGO_BULLS,GOLDEN_STATE_WARRIORS,94,143,6845,49
6845,2017-11-26,2017-11-25,SAN_ANTONIO_SPURS,CHARLOTTE_HORNETS,106,86,6846,20
6846,2017-11-26,2017-11-25,ORLANDO_MAGIC,PHILADELPHIA_76ERS,111,130,6847,19
6847,2017-11-26,2017-11-25,PORTLAND_TRAIL_BLAZERS,WASHINGTON_WIZARDS,108,105,6848,3
6848,2017-11-26,2017-11-25,TORONTO_RAPTORS,ATLANTA_HAWKS,112,78,6849,34
6849,2017-11-26,2017-11-25,NEW_YORK_KNICKS,HOUSTON_ROCKETS,102,117,6850,15
6850,2017-11-26,2017-11-25,BOSTON_CELTICS,INDIANA_PACERS,108,98,6851,10
6851,2017-11-26,2017-11-25,OKLAHOMA_CITY_THUNDER,DALLAS_MAVERICKS,81,97,6852,16
6852,2017-11-26,2017-11-25,NEW_ORLEANS_PELICANS,GOLDEN_STATE_WARRIORS,95,110,6853,15
6853,2017-11-26,2017-11-25,MILWAUKEE_BUCKS,UTAH_JAZZ,108,121,6854,13
6854,2017-11-26,2017-11-25,LOS_ANGELES_CLIPPERS,SACRAMENTO_KINGS,97,95,6855,2
6855,2017-11-26,2017-11-25,MIAMI_HEAT,CHICAGO_BULLS,100,93,6856,7
6856,2017-11-26,2017-11-25,PHOENIX_SUNS,MINNESOTA_TIMBERWOLVES,108,119,6857,11
6857,2017-11-26,2017-11-25,BROOKLYN_NETS,MEMPHIS_GRIZZLIES,98,88,6858,10
6858,2017-11-28,2017-11-27,ORLANDO_MAGIC,INDIANA_PACERS,109,121,6859,12
6859,2017-11-28,2017-11-27,CLEVELAND_CAVALIERS,PHILADELPHIA_76ERS,113,91,6860,22
6860,2017-11-28,2017-11-27,DETROIT_PISTONS,BOSTON_CELTICS,118,108,6861,10
6861,2017-11-28,2017-11-27,PORTLAND_TRAIL_BLAZERS,NEW_YORK_KNICKS,103,91,6862,12
6862,2017-11-28,2017-11-27,BROOKLYN_NETS,HOUSTON_ROCKETS,103,117,6863,14
6863,2017-11-28,2017-11-27,DALLAS_MAVERICKS,SAN_ANTONIO_SPURS,108,115,6864,7
6864,2017-11-28,2017-11-27,SACRAMENTO_KINGS,GOLDEN_STATE_WARRIORS,110,106,6865,4
6865,2017-11-28,2017-11-27,LOS_ANGELES_LAKERS,LOS_ANGELES_CLIPPERS,115,120,6866,5
6866,2017-11-29,2017-11-28,MIAMI_HEAT,CLEVELAND_CAVALIERS,97,108,6867,11
6867,2017-11-29,2017-11-28,PHOENIX_SUNS,CHICAGO_BULLS,104,99,6868,5
6868,2017-11-29,2017-11-28,WASHINGTON_WIZARDS,MINNESOTA_TIMBERWOLVES,92,89,6869,3
6869,2017-11-29,2017-11-28,MILWAUKEE_BUCKS,SACRAMENTO_KINGS,112,87,6870,25
6870,2017-11-29,2017-11-28,DENVER_NUGGETS,UTAH_JAZZ,77,106,6871,29
6871,2017-11-30,2017-11-29,PHOENIX_SUNS,DETROIT_PISTONS,107,131,6872,24
6872,2017-11-30,2017-11-29,OKLAHOMA_CITY_THUNDER,ORLANDO_MAGIC,108,121,6873,13
6873,2017-11-30,2017-11-29,WASHINGTON_WIZARDS,PHILADELPHIA_76ERS,113,118,6874,5
6874,2017-11-30,2017-11-29,MIAMI_HEAT,NEW_YORK_KNICKS,86,115,6875,29
6875,2017-11-30,2017-11-29,CHARLOTTE_HORNETS,TORONTO_RAPTORS,113,126,6876,13
6876,2017-11-30,2017-11-29,INDIANA_PACERS,HOUSTON_ROCKETS,97,118,6877,21
6877,2017-11-30,2017-11-29,MINNESOTA_TIMBERWOLVES,NEW_ORLEANS_PELICANS,120,102,6878,18
6878,2017-11-30,2017-11-29,BROOKLYN_NETS,DALLAS_MAVERICKS,109,104,6879,5
6879,2017-11-30,2017-11-29,MEMPHIS_GRIZZLIES,SAN_ANTONIO_SPURS,95,104,6880,9
6880,2017-11-30,2017-11-29,GOLDEN_STATE_WARRIORS,LOS_ANGELES_LAKERS,127,123,6881,4
6881,2017-12-01,2017-11-30,CLEVELAND_CAVALIERS,ATLANTA_HAWKS,121,114,6882,7
6882,2017-12-01,2017-11-30,PHILADELPHIA_76ERS,BOSTON_CELTICS,97,108,6883,11
6883,2017-12-01,2017-11-30,CHICAGO_BULLS,DENVER_NUGGETS,110,111,6884,1
6884,2017-12-01,2017-11-30,MILWAUKEE_BUCKS,PORTLAND_TRAIL_BLAZERS,103,91,6885,12
6885,2017-12-01,2017-11-30,UTAH_JAZZ,LOS_ANGELES_CLIPPERS,126,107,6886,19
6886,2017-12-02,2017-12-01,GOLDEN_STATE_WARRIORS,ORLANDO_MAGIC,133,112,6887,21
6887,2017-12-02,2017-12-01,DETROIT_PISTONS,WASHINGTON_WIZARDS,91,109,6888,18
6888,2017-12-02,2017-12-01,INDIANA_PACERS,TORONTO_RAPTORS,115,120,6889,5
6889,2017-12-02,2017-12-01,SACRAMENTO_KINGS,CHICAGO_BULLS,107,106,6890,1
6890,2017-12-02,2017-12-01,SAN_ANTONIO_SPURS,MEMPHIS_GRIZZLIES,95,79,6891,16
6891,2017-12-02,2017-12-01,CHARLOTTE_HORNETS,MIAMI_HEAT,100,105,6892,5
6892,2017-12-02,2017-12-01,MINNESOTA_TIMBERWOLVES,OKLAHOMA_CITY_THUNDER,107,111,6893,4
6893,2017-12-02,2017-12-01,NEW_ORLEANS_PELICANS,UTAH_JAZZ,108,114,6894,6
6894,2017-12-02,2017-12-01,PHOENIX_SUNS,BOSTON_CELTICS,111,116,6895,5
6895,2017-12-02,2017-12-01,LOS_ANGELES_CLIPPERS,DALLAS_MAVERICKS,82,108,6896,26
6896,2017-12-02,2017-12-01,ATLANTA_HAWKS,BROOKLYN_NETS,114,102,6897,12
6897,2017-12-03,2017-12-02,MEMPHIS_GRIZZLIES,CLEVELAND_CAVALIERS,111,116,6898,5
6898,2017-12-03,2017-12-02,DETROIT_PISTONS,PHILADELPHIA_76ERS,103,108,6899,5
6899,2017-12-03,2017-12-02,SACRAMENTO_KINGS,MILWAUKEE_BUCKS,104,109,6900,5
6900,2017-12-03,2017-12-02,LOS_ANGELES_LAKERS,DENVER_NUGGETS,100,115,6901,15
6901,2017-12-03,2017-12-02,NEW_ORLEANS_PELICANS,PORTLAND_TRAIL_BLAZERS,123,116,6902,7
6902,2017-12-03,2017-12-02,ORLANDO_MAGIC,NEW_YORK_KNICKS,105,100,6903,5
6903,2017-12-04,2017-12-03,GOLDEN_STATE_WARRIORS,MIAMI_HEAT,123,95,6904,28
6904,2017-12-04,2017-12-03,LOS_ANGELES_CLIPPERS,MINNESOTA_TIMBERWOLVES,106,112,6905,6
6905,2017-12-04,2017-12-03,SAN_ANTONIO_SPURS,OKLAHOMA_CITY_THUNDER,87,90,6906,3
6906,2017-12-04,2017-12-03,HOUSTON_ROCKETS,LOS_ANGELES_LAKERS,118,95,6907,23
6907,2017-12-05,2017-12-04,ORLANDO_MAGIC,CHARLOTTE_HORNETS,94,104,6908,10
6908,2017-12-05,2017-12-04,NEW_YORK_KNICKS,INDIANA_PACERS,97,115,6909,18
6909,2017-12-05,2017-12-04,PHOENIX_SUNS,PHILADELPHIA_76ERS,115,101,6910,14
6910,2017-12-05,2017-12-04,BROOKLYN_NETS,ATLANTA_HAWKS,110,90,6911,20
6911,2017-12-05,2017-12-04,MILWAUKEE_BUCKS,BOSTON_CELTICS,100,111,6912,11
6912,2017-12-05,2017-12-04,CLEVELAND_CAVALIERS,CHICAGO_BULLS,113,91,6913,22
6913,2017-12-05,2017-12-04,MINNESOTA_TIMBERWOLVES,MEMPHIS_GRIZZLIES,92,95,6914,3
6914,2017-12-05,2017-12-04,GOLDEN_STATE_WARRIORS,NEW_ORLEANS_PELICANS,125,115,6915,10
6915,2017-12-05,2017-12-04,DENVER_NUGGETS,DALLAS_MAVERICKS,105,122,6916,17
6916,2017-12-05,2017-12-04,DETROIT_PISTONS,SAN_ANTONIO_SPURS,93,96,6917,3
6917,2017-12-05,2017-12-04,WASHINGTON_WIZARDS,UTAH_JAZZ,69,116,6918,47
6918,2017-12-06,2017-12-05,PHOENIX_SUNS,TORONTO_RAPTORS,113,126,6919,13
6919,2017-12-06,2017-12-05,UTAH_JAZZ,OKLAHOMA_CITY_THUNDER,94,100,6920,6
6920,2017-12-06,2017-12-05,WASHINGTON_WIZARDS,PORTLAND_TRAIL_BLAZERS,106,92,6921,14
6921,2017-12-07,2017-12-06,SACRAMENTO_KINGS,CLEVELAND_CAVALIERS,95,101,6922,6
6922,2017-12-07,2017-12-06,CHICAGO_BULLS,INDIANA_PACERS,96,98,6923,2
6923,2017-12-07,2017-12-06,ATLANTA_HAWKS,ORLANDO_MAGIC,106,110,6924,4
6924,2017-12-07,2017-12-06,DALLAS_MAVERICKS,BOSTON_CELTICS,90,97,6925,7
6925,2017-12-07,2017-12-06,MEMPHIS_GRIZZLIES,NEW_YORK_KNICKS,88,99,6926,11
6926,2017-12-07,2017-12-06,GOLDEN_STATE_WARRIORS,CHARLOTTE_HORNETS,101,87,6927,14
6927,2017-12-07,2017-12-06,DETROIT_PISTONS,MILWAUKEE_BUCKS,100,104,6928,4
6928,2017-12-07,2017-12-06,DENVER_NUGGETS,NEW_ORLEANS_PELICANS,114,123,6929,9
6929,2017-12-07,2017-12-06,MIAMI_HEAT,SAN_ANTONIO_SPURS,105,117,6930,12
6930,2017-12-07,2017-12-06,MINNESOTA_TIMBERWOLVES,LOS_ANGELES_CLIPPERS,113,107,6931,6
6931,2017-12-08,2017-12-07,LOS_ANGELES_LAKERS,PHILADELPHIA_76ERS,107,104,6932,3
6932,2017-12-08,2017-12-07,WASHINGTON_WIZARDS,PHOENIX_SUNS,109,99,6933,10
6933,2017-12-08,2017-12-07,OKLAHOMA_CITY_THUNDER,BROOKLYN_NETS,95,100,6934,5
6934,2017-12-08,2017-12-07,HOUSTON_ROCKETS,UTAH_JAZZ,112,101,6935,11
6935,2017-12-09,2017-12-08,CHICAGO_BULLS,CHARLOTTE_HORNETS,119,111,6936,8
6936,2017-12-09,2017-12-08,GOLDEN_STATE_WARRIORS,DETROIT_PISTONS,102,98,6937,4
6937,2017-12-09,2017-12-08,CLEVELAND_CAVALIERS,INDIANA_PACERS,102,106,6938,4
6938,2017-12-09,2017-12-08,DENVER_NUGGETS,ORLANDO_MAGIC,103,89,6939,14
6939,2017-12-09,2017-12-08,TORONTO_RAPTORS,MEMPHIS_GRIZZLIES,116,107,6940,9
6940,2017-12-09,2017-12-08,DALLAS_MAVERICKS,MILWAUKEE_BUCKS,102,109,6941,7
6941,2017-12-09,2017-12-08,SACRAMENTO_KINGS,NEW_ORLEANS_PELICANS,116,109,6942,7
6942,2017-12-09,2017-12-08,BOSTON_CELTICS,SAN_ANTONIO_SPURS,102,105,6943,3
6943,2017-12-09,2017-12-08,WASHINGTON_WIZARDS,LOS_ANGELES_CLIPPERS,112,113,6944,1
6944,2017-12-09,2017-12-08,MIAMI_HEAT,BROOKLYN_NETS,101,89,6945,12
6945,2017-12-10,2017-12-09,LOS_ANGELES_LAKERS,CHARLOTTE_HORNETS,110,99,6946,11
6946,2017-12-10,2017-12-09,ORLANDO_MAGIC,ATLANTA_HAWKS,110,117,6947,7
6947,2017-12-10,2017-12-09,NEW_YORK_KNICKS,CHICAGO_BULLS,102,104,6948,2
6948,2017-12-10,2017-12-09,PHILADELPHIA_76ERS,CLEVELAND_CAVALIERS,98,105,6949,7
6949,2017-12-10,2017-12-09,UTAH_JAZZ,MILWAUKEE_BUCKS,100,117,6950,17
6950,2017-12-10,2017-12-09,OKLAHOMA_CITY_THUNDER,MEMPHIS_GRIZZLIES,102,101,6951,1
6951,2017-12-10,2017-12-09,SAN_ANTONIO_SPURS,PHOENIX_SUNS,104,101,6952,3
6952,2017-12-10,2017-12-09,HOUSTON_ROCKETS,PORTLAND_TRAIL_BLAZERS,124,117,6953,7
6953,2017-12-10,2017-12-09,TORONTO_RAPTORS,SACRAMENTO_KINGS,102,87,6954,15
6954,2017-12-10,2017-12-09,BOSTON_CELTICS,DETROIT_PISTONS,91,81,6955,10
6955,2017-12-10,2017-12-09,DENVER_NUGGETS,INDIANA_PACERS,116,126,6956,10
6956,2017-12-11,2017-12-10,DALLAS_MAVERICKS,MINNESOTA_TIMBERWOLVES,92,97,6957,5
6957,2017-12-11,2017-12-10,PHILADELPHIA_76ERS,NEW_ORLEANS_PELICANS,124,131,6958,7
6958,2017-12-11,2017-12-10,ATLANTA_HAWKS,NEW_YORK_KNICKS,107,111,6959,4
6959,2017-12-12,2017-12-11,BOSTON_CELTICS,CHICAGO_BULLS,85,108,6960,23
6960,2017-12-12,2017-12-11,NEW_ORLEANS_PELICANS,HOUSTON_ROCKETS,123,130,6961,7
6961,2017-12-12,2017-12-11,MIAMI_HEAT,MEMPHIS_GRIZZLIES,107,82,6962,25
6962,2017-12-12,2017-12-11,CHARLOTTE_HORNETS,OKLAHOMA_CITY_THUNDER,116,103,6963,13
6963,2017-12-12,2017-12-11,PORTLAND_TRAIL_BLAZERS,GOLDEN_STATE_WARRIORS,104,111,6964,7
6964,2017-12-12,2017-12-11,TORONTO_RAPTORS,LOS_ANGELES_CLIPPERS,91,96,6965,5
6965,2017-12-13,2017-12-12,ATLANTA_HAWKS,CLEVELAND_CAVALIERS,114,123,6966,9
6966,2017-12-13,2017-12-12,DENVER_NUGGETS,DETROIT_PISTONS,103,84,6967,19
6967,2017-12-13,2017-12-12,LOS_ANGELES_LAKERS,NEW_YORK_KNICKS,109,113,6968,4
6968,2017-12-13,2017-12-12,WASHINGTON_WIZARDS,BROOKLYN_NETS,98,103,6969,5
6969,2017-12-13,2017-12-12,SAN_ANTONIO_SPURS,DALLAS_MAVERICKS,89,95,6970,6
6970,2017-12-13,2017-12-12,PHILADELPHIA_76ERS,MINNESOTA_TIMBERWOLVES,118,112,6971,6
6971,2017-12-13,2017-12-12,PHOENIX_SUNS,SACRAMENTO_KINGS,92,99,6972,7
6972,2017-12-14,2017-12-13,OKLAHOMA_CITY_THUNDER,INDIANA_PACERS,100,95,6973,5
6973,2017-12-14,2017-12-13,LOS_ANGELES_CLIPPERS,ORLANDO_MAGIC,106,95,6974,11
6974,2017-12-14,2017-12-13,MEMPHIS_GRIZZLIES,WASHINGTON_WIZARDS,87,93,6975,6
6975,2017-12-14,2017-12-13,DENVER_NUGGETS,BOSTON_CELTICS,118,124,6976,6
6976,2017-12-14,2017-12-13,PORTLAND_TRAIL_BLAZERS,MIAMI_HEAT,102,95,6977,7
6977,2017-12-14,2017-12-13,UTAH_JAZZ,CHICAGO_BULLS,100,103,6978,3
6978,2017-12-14,2017-12-13,MILWAUKEE_BUCKS,NEW_ORLEANS_PELICANS,108,115,6979,7
6979,2017-12-14,2017-12-13,TORONTO_RAPTORS,PHOENIX_SUNS,115,109,6980,6
6980,2017-12-14,2017-12-13,CHARLOTTE_HORNETS,HOUSTON_ROCKETS,96,108,6981,12
6981,2017-12-15,2017-12-14,DETROIT_PISTONS,ATLANTA_HAWKS,105,91,6982,14
6982,2017-12-15,2017-12-14,NEW_YORK_KNICKS,BROOKLYN_NETS,111,104,6983,7
6983,2017-12-15,2017-12-14,LOS_ANGELES_LAKERS,CLEVELAND_CAVALIERS,112,121,6984,9
6984,2017-12-15,2017-12-14,SACRAMENTO_KINGS,MINNESOTA_TIMBERWOLVES,96,119,6985,23
6985,2017-12-15,2017-12-14,DALLAS_MAVERICKS,GOLDEN_STATE_WARRIORS,97,112,6986,15
6986,2017-12-16,2017-12-15,MIAMI_HEAT,CHARLOTTE_HORNETS,104,98,6987,6
6987,2017-12-16,2017-12-15,DETROIT_PISTONS,INDIANA_PACERS,104,98,6988,6
6988,2017-12-16,2017-12-15,PORTLAND_TRAIL_BLAZERS,ORLANDO_MAGIC,95,88,6989,7
6989,2017-12-16,2017-12-15,OKLAHOMA_CITY_THUNDER,PHILADELPHIA_76ERS,119,117,6990,2
6990,2017-12-16,2017-12-15,LOS_ANGELES_CLIPPERS,WASHINGTON_WIZARDS,91,100,6991,9
6991,2017-12-16,2017-12-15,UTAH_JAZZ,BOSTON_CELTICS,107,95,6992,12
6992,2017-12-16,2017-12-15,BROOKLYN_NETS,TORONTO_RAPTORS,87,120,6993,33
6993,2017-12-16,2017-12-15,ATLANTA_HAWKS,MEMPHIS_GRIZZLIES,94,96,6994,2
6994,2017-12-16,2017-12-15,CHICAGO_BULLS,MILWAUKEE_BUCKS,115,109,6995,6
6995,2017-12-16,2017-12-15,NEW_ORLEANS_PELICANS,DENVER_NUGGETS,111,117,6996,6
6996,2017-12-16,2017-12-15,SAN_ANTONIO_SPURS,HOUSTON_ROCKETS,109,124,6997,15
6997,2017-12-17,2017-12-16,PORTLAND_TRAIL_BLAZERS,CHARLOTTE_HORNETS,93,91,6998,2
6998,2017-12-17,2017-12-16,UTAH_JAZZ,CLEVELAND_CAVALIERS,100,109,6999,9
6999,2017-12-17,2017-12-16,OKLAHOMA_CITY_THUNDER,NEW_YORK_KNICKS,96,111,7000,15
7000,2017-12-17,2017-12-16,MILWAUKEE_BUCKS,HOUSTON_ROCKETS,111,115,7001,4
7001,2017-12-17,2017-12-16,LOS_ANGELES_CLIPPERS,MIAMI_HEAT,85,90,7002,5
7002,2017-12-17,2017-12-16,PHOENIX_SUNS,MINNESOTA_TIMBERWOLVES,108,106,7003,2
7003,2017-12-17,2017-12-16,DALLAS_MAVERICKS,SAN_ANTONIO_SPURS,96,98,7004,2
7004,2017-12-17,2017-12-16,BOSTON_CELTICS,MEMPHIS_GRIZZLIES,102,93,7005,9
7005,2017-12-17,2017-12-16,SACRAMENTO_KINGS,TORONTO_RAPTORS,93,108,7006,15
7006,2017-12-17,2017-12-16,ORLANDO_MAGIC,DETROIT_PISTONS,110,114,7007,4
7007,2017-12-17,2017-12-16,INDIANA_PACERS,BROOKLYN_NETS,109,97,7008,12
7008,2017-12-17,2017-12-16,CLEVELAND_CAVALIERS,WASHINGTON_WIZARDS,106,99,7009,7
7009,2017-12-19,2017-12-18,NEW_YORK_KNICKS,CHARLOTTE_HORNETS,91,109,7010,18
7010,2017-12-19,2017-12-18,BOSTON_CELTICS,INDIANA_PACERS,112,111,7011,1
7011,2017-12-19,2017-12-18,MIAMI_HEAT,ATLANTA_HAWKS,104,110,7012,6
7012,2017-12-19,2017-12-18,PHILADELPHIA_76ERS,CHICAGO_BULLS,115,117,7013,2
7013,2017-12-19,2017-12-18,UTAH_JAZZ,HOUSTON_ROCKETS,99,120,7014,21
7014,2017-12-19,2017-12-18,PORTLAND_TRAIL_BLAZERS,MINNESOTA_TIMBERWOLVES,107,108,7015,1
7015,2017-12-19,2017-12-18,DENVER_NUGGETS,OKLAHOMA_CITY_THUNDER,94,95,7016,1
7016,2017-12-19,2017-12-18,PHOENIX_SUNS,DALLAS_MAVERICKS,97,91,7017,6
7017,2017-12-19,2017-12-18,LOS_ANGELES_CLIPPERS,SAN_ANTONIO_SPURS,91,109,7018,18
7018,2017-12-19,2017-12-18,GOLDEN_STATE_WARRIORS,LOS_ANGELES_LAKERS,116,114,7019,2
7019,2017-12-20,2017-12-19,SACRAMENTO_KINGS,PHILADELPHIA_76ERS,101,95,7020,6
7020,2017-12-20,2017-12-19,NEW_ORLEANS_PELICANS,WASHINGTON_WIZARDS,106,116,7021,10
7021,2017-12-20,2017-12-19,CLEVELAND_CAVALIERS,MILWAUKEE_BUCKS,116,119,7022,3
7022,2017-12-21,2017-12-20,TORONTO_RAPTORS,CHARLOTTE_HORNETS,129,111,7023,18
7023,2017-12-21,2017-12-20,INDIANA_PACERS,ATLANTA_HAWKS,105,95,7024,10
7024,2017-12-21,2017-12-20,MIAMI_HEAT,BOSTON_CELTICS,90,89,7025,1
7025,2017-12-21,2017-12-20,SACRAMENTO_KINGS,BROOKLYN_NETS,104,99,7026,5
7026,2017-12-21,2017-12-20,ORLANDO_MAGIC,CHICAGO_BULLS,94,112,7027,18
7027,2017-12-21,2017-12-20,LOS_ANGELES_LAKERS,HOUSTON_ROCKETS,122,116,7028,6
7028,2017-12-21,2017-12-20,UTAH_JAZZ,OKLAHOMA_CITY_THUNDER,79,107,7029,28
7029,2017-12-21,2017-12-20,DETROIT_PISTONS,DALLAS_MAVERICKS,93,110,7030,17
7030,2017-12-21,2017-12-20,MINNESOTA_TIMBERWOLVES,DENVER_NUGGETS,112,104,7031,8
7031,2017-12-21,2017-12-20,SAN_ANTONIO_SPURS,PORTLAND_TRAIL_BLAZERS,93,91,7032,2
7032,2017-12-21,2017-12-20,MEMPHIS_GRIZZLIES,GOLDEN_STATE_WARRIORS,84,97,7033,13
7033,2017-12-21,2017-12-20,PHOENIX_SUNS,LOS_ANGELES_CLIPPERS,95,108,7034,13
7034,2017-12-22,2017-12-21,CHICAGO_BULLS,CLEVELAND_CAVALIERS,112,115,7035,3
7035,2017-12-22,2017-12-21,TORONTO_RAPTORS,PHILADELPHIA_76ERS,114,109,7036,5
7036,2017-12-22,2017-12-21,BOSTON_CELTICS,NEW_YORK_KNICKS,93,102,7037,9
7037,2017-12-22,2017-12-21,MEMPHIS_GRIZZLIES,PHOENIX_SUNS,95,97,7038,2
7038,2017-12-22,2017-12-21,SAN_ANTONIO_SPURS,UTAH_JAZZ,89,100,7039,11
7039,2017-12-23,2017-12-22,NEW_YORK_KNICKS,DETROIT_PISTONS,101,104,7040,3
7040,2017-12-23,2017-12-22,NEW_ORLEANS_PELICANS,ORLANDO_MAGIC,111,97,7041,14
7041,2017-12-23,2017-12-22,WASHINGTON_WIZARDS,BROOKLYN_NETS,84,119,7042,35
7042,2017-12-23,2017-12-22,LOS_ANGELES_CLIPPERS,HOUSTON_ROCKETS,128,118,7043,10
7043,2017-12-23,2017-12-22,DALLAS_MAVERICKS,MIAMI_HEAT,101,113,7044,12
7044,2017-12-23,2017-12-22,CHARLOTTE_HORNETS,MILWAUKEE_BUCKS,104,109,7045,5
7045,2017-12-23,2017-12-22,ATLANTA_HAWKS,OKLAHOMA_CITY_THUNDER,117,120,7046,3
7046,2017-12-23,2017-12-22,DENVER_NUGGETS,PORTLAND_TRAIL_BLAZERS,102,85,7047,17
7047,2017-12-23,2017-12-22,LOS_ANGELES_LAKERS,GOLDEN_STATE_WARRIORS,106,113,7048,7
7048,2017-12-23,2017-12-22,PHILADELPHIA_76ERS,TORONTO_RAPTORS,86,102,7049,16
7049,2017-12-24,2017-12-23,MILWAUKEE_BUCKS,CHARLOTTE_HORNETS,106,111,7050,5
7050,2017-12-24,2017-12-23,BROOKLYN_NETS,INDIANA_PACERS,119,123,7051,4
7051,2017-12-24,2017-12-23,ORLANDO_MAGIC,WASHINGTON_WIZARDS,103,130,7052,27
7052,2017-12-24,2017-12-23,DALLAS_MAVERICKS,ATLANTA_HAWKS,107,112,7053,5
7053,2017-12-24,2017-12-23,CHICAGO_BULLS,BOSTON_CELTICS,92,117,7054,25
7054,2017-12-24,2017-12-23,LOS_ANGELES_CLIPPERS,MEMPHIS_GRIZZLIES,112,115,7055,3
7055,2017-12-24,2017-12-23,NEW_ORLEANS_PELICANS,MIAMI_HEAT,109,94,7056,15
7056,2017-12-24,2017-12-23,OKLAHOMA_CITY_THUNDER,UTAH_JAZZ,103,89,7057,14
7057,2017-12-24,2017-12-23,DENVER_NUGGETS,GOLDEN_STATE_WARRIORS,96,81,7058,15
7058,2017-12-24,2017-12-23,MINNESOTA_TIMBERWOLVES,PHOENIX_SUNS,115,106,7059,9
7059,2017-12-24,2017-12-23,PORTLAND_TRAIL_BLAZERS,LOS_ANGELES_LAKERS,95,92,7060,3
7060,2017-12-24,2017-12-23,SAN_ANTONIO_SPURS,SACRAMENTO_KINGS,108,99,7061,9
7061,2017-12-25,2017-12-24,PHILADELPHIA_76ERS,NEW_YORK_KNICKS,105,98,7062,7
7062,2017-12-25,2017-12-24,CLEVELAND_CAVALIERS,GOLDEN_STATE_WARRIORS,92,99,7063,7
7063,2017-12-25,2017-12-24,WASHINGTON_WIZARDS,BOSTON_CELTICS,111,103,7064,8
7064,2017-12-26,2017-12-25,HOUSTON_ROCKETS,OKLAHOMA_CITY_THUNDER,107,112,7065,5
7065,2017-12-26,2017-12-25,MINNESOTA_TIMBERWOLVES,LOS_ANGELES_LAKERS,121,104,7066,17
7066,2017-12-27,2017-12-26,TORONTO_RAPTORS,DALLAS_MAVERICKS,93,98,7067,5
7067,2017-12-27,2017-12-26,INDIANA_PACERS,DETROIT_PISTONS,83,107,7068,24
7068,2017-12-27,2017-12-26,ORLANDO_MAGIC,MIAMI_HEAT,89,107,7069,18
7069,2017-12-27,2017-12-26,CHICAGO_BULLS,MILWAUKEE_BUCKS,115,106,7070,9
7070,2017-12-27,2017-12-26,BROOKLYN_NETS,SAN_ANTONIO_SPURS,97,109,7071,12
7071,2017-12-27,2017-12-26,UTAH_JAZZ,DENVER_NUGGETS,83,107,7072,24
7072,2017-12-27,2017-12-26,MEMPHIS_GRIZZLIES,PHOENIX_SUNS,97,99,7073,2
7073,2017-12-27,2017-12-26,SACRAMENTO_KINGS,LOS_ANGELES_CLIPPERS,95,122,7074,27
7074,2017-12-28,2017-12-27,BOSTON_CELTICS,CHARLOTTE_HORNETS,102,91,7075,11
7075,2017-12-28,2017-12-27,DALLAS_MAVERICKS,INDIANA_PACERS,98,94,7076,4
7076,2017-12-28,2017-12-27,WASHINGTON_WIZARDS,ATLANTA_HAWKS,99,113,7077,14
7077,2017-12-28,2017-12-27,NEW_YORK_KNICKS,CHICAGO_BULLS,87,92,7078,5
7078,2017-12-28,2017-12-27,DENVER_NUGGETS,MINNESOTA_TIMBERWOLVES,125,128,7079,3
7079,2017-12-28,2017-12-27,BROOKLYN_NETS,NEW_ORLEANS_PELICANS,113,128,7080,15
7080,2017-12-28,2017-12-27,TORONTO_RAPTORS,OKLAHOMA_CITY_THUNDER,107,124,7081,17
7081,2017-12-28,2017-12-27,CLEVELAND_CAVALIERS,SACRAMENTO_KINGS,95,109,7082,14
7082,2017-12-28,2017-12-27,UTAH_JAZZ,GOLDEN_STATE_WARRIORS,101,126,7083,25
7083,2017-12-28,2017-12-27,MEMPHIS_GRIZZLIES,LOS_ANGELES_LAKERS,109,99,7084,10
7084,2017-12-29,2017-12-28,DETROIT_PISTONS,ORLANDO_MAGIC,89,102,7085,13
7085,2017-12-29,2017-12-28,HOUSTON_ROCKETS,BOSTON_CELTICS,98,99,7086,1
7086,2017-12-29,2017-12-28,MINNESOTA_TIMBERWOLVES,MILWAUKEE_BUCKS,96,102,7087,6
7087,2017-12-29,2017-12-28,NEW_YORK_KNICKS,SAN_ANTONIO_SPURS,107,119,7088,12
7088,2017-12-29,2017-12-28,PHILADELPHIA_76ERS,PORTLAND_TRAIL_BLAZERS,110,114,7089,4
7089,2017-12-30,2017-12-29,HOUSTON_ROCKETS,WASHINGTON_WIZARDS,103,121,7090,18
7090,2017-12-30,2017-12-29,ATLANTA_HAWKS,TORONTO_RAPTORS,98,111,7091,13
7091,2017-12-30,2017-12-29,INDIANA_PACERS,CHICAGO_BULLS,107,119,7092,12
7092,2017-12-30,2017-12-29,BROOKLYN_NETS,MIAMI_HEAT,111,87,7093,24
7093,2017-12-30,2017-12-29,DALLAS_MAVERICKS,NEW_ORLEANS_PELICANS,128,120,7094,8
7094,2017-12-30,2017-12-29,MILWAUKEE_BUCKS,OKLAHOMA_CITY_THUNDER,97,95,7095,2
7095,2017-12-30,2017-12-29,PHOENIX_SUNS,SACRAMENTO_KINGS,111,101,7096,10
7096,2017-12-30,2017-12-29,CHARLOTTE_HORNETS,GOLDEN_STATE_WARRIORS,111,100,7097,11
7097,2017-12-30,2017-12-29,LOS_ANGELES_CLIPPERS,LOS_ANGELES_LAKERS,121,106,7098,15
7098,2017-12-31,2017-12-30,SAN_ANTONIO_SPURS,DETROIT_PISTONS,79,93,7099,14
7099,2017-12-31,2017-12-30,NEW_YORK_KNICKS,NEW_ORLEANS_PELICANS,105,103,7100,2
7100,2017-12-31,2017-12-30,MIAMI_HEAT,ORLANDO_MAGIC,117,111,7101,6
7101,2017-12-31,2017-12-30,PORTLAND_TRAIL_BLAZERS,ATLANTA_HAWKS,89,104,7102,15
7102,2017-12-31,2017-12-30,CLEVELAND_CAVALIERS,UTAH_JAZZ,101,104,7103,3
7103,2017-12-31,2017-12-30,MEMPHIS_GRIZZLIES,GOLDEN_STATE_WARRIORS,128,141,7104,13
7104,2017-12-31,2017-12-30,PHILADELPHIA_76ERS,DENVER_NUGGETS,107,102,7105,5
7105,2017-12-31,2017-12-30,CHICAGO_BULLS,WASHINGTON_WIZARDS,110,114,7106,4
7106,2017-12-31,2017-12-30,MINNESOTA_TIMBERWOLVES,INDIANA_PACERS,107,90,7107,17
7107,2017-12-31,2017-12-30,BROOKLYN_NETS,BOSTON_CELTICS,105,108,7108,3
7108,2018-01-01,2017-12-31,LOS_ANGELES_LAKERS,HOUSTON_ROCKETS,142,148,7109,6
7109,2018-01-01,2017-12-31,CHARLOTTE_HORNETS,LOS_ANGELES_CLIPPERS,98,106,7110,8
7110,2018-01-01,2017-12-31,DALLAS_MAVERICKS,OKLAHOMA_CITY_THUNDER,116,113,7111,3
7111,2018-01-01,2017-12-31,MEMPHIS_GRIZZLIES,SACRAMENTO_KINGS,114,96,7112,18
7112,2018-01-01,2017-12-31,PHILADELPHIA_76ERS,PHOENIX_SUNS,123,110,7113,13
7113,2018-01-02,2018-01-01,ORLANDO_MAGIC,BROOKLYN_NETS,95,98,7114,3
7114,2018-01-02,2018-01-01,MILWAUKEE_BUCKS,TORONTO_RAPTORS,127,131,7115,4
7115,2018-01-02,2018-01-01,PORTLAND_TRAIL_BLAZERS,CHICAGO_BULLS,124,120,7116,4
7116,2018-01-02,2018-01-01,LOS_ANGELES_LAKERS,MINNESOTA_TIMBERWOLVES,96,114,7117,18
7117,2018-01-03,2018-01-02,PORTLAND_TRAIL_BLAZERS,CLEVELAND_CAVALIERS,110,127,7118,17
7118,2018-01-03,2018-01-02,SAN_ANTONIO_SPURS,NEW_YORK_KNICKS,100,91,7119,9
7119,2018-01-03,2018-01-02,ATLANTA_HAWKS,PHOENIX_SUNS,103,104,7120,1
7120,2018-01-03,2018-01-02,CHARLOTTE_HORNETS,SACRAMENTO_KINGS,131,111,7121,20
7121,2018-01-03,2018-01-02,MEMPHIS_GRIZZLIES,LOS_ANGELES_CLIPPERS,105,113,7122,8
7122,2018-01-04,2018-01-03,HOUSTON_ROCKETS,ORLANDO_MAGIC,116,98,7123,18
7123,2018-01-04,2018-01-03,SAN_ANTONIO_SPURS,PHILADELPHIA_76ERS,106,112,7124,6
7124,2018-01-04,2018-01-03,NEW_YORK_KNICKS,WASHINGTON_WIZARDS,103,121,7125,18
7125,2018-01-04,2018-01-03,MINNESOTA_TIMBERWOLVES,BROOKLYN_NETS,97,98,7126,1
7126,2018-01-04,2018-01-03,DETROIT_PISTONS,MIAMI_HEAT,104,111,7127,7
7127,2018-01-04,2018-01-03,CLEVELAND_CAVALIERS,BOSTON_CELTICS,88,102,7128,14
7128,2018-01-04,2018-01-03,TORONTO_RAPTORS,CHICAGO_BULLS,124,115,7129,9
7129,2018-01-04,2018-01-03,INDIANA_PACERS,MILWAUKEE_BUCKS,101,122,7130,21
7130,2018-01-04,2018-01-03,GOLDEN_STATE_WARRIORS,DALLAS_MAVERICKS,125,122,7131,3
7131,2018-01-04,2018-01-03,PHOENIX_SUNS,DENVER_NUGGETS,111,134,7132,23
7132,2018-01-04,2018-01-03,NEW_ORLEANS_PELICANS,UTAH_JAZZ,108,98,7133,10
7133,2018-01-04,2018-01-03,OKLAHOMA_CITY_THUNDER,LOS_ANGELES_LAKERS,133,96,7134,37
7134,2018-01-05,2018-01-04,GOLDEN_STATE_WARRIORS,HOUSTON_ROCKETS,124,114,7135,10
7135,2018-01-05,2018-01-04,OKLAHOMA_CITY_THUNDER,LOS_ANGELES_CLIPPERS,127,117,7136,10
7136,2018-01-06,2018-01-05,MINNESOTA_TIMBERWOLVES,BOSTON_CELTICS,84,91,7137,7
7137,2018-01-06,2018-01-05,DETROIT_PISTONS,PHILADELPHIA_76ERS,78,114,7138,36
7138,2018-01-06,2018-01-05,NEW_YORK_KNICKS,MIAMI_HEAT,103,107,7139,4
7139,2018-01-06,2018-01-05,TORONTO_RAPTORS,MILWAUKEE_BUCKS,129,110,7140,19
7140,2018-01-06,2018-01-05,CHICAGO_BULLS,DALLAS_MAVERICKS,127,124,7141,3
7141,2018-01-06,2018-01-05,PHOENIX_SUNS,SAN_ANTONIO_SPURS,89,103,7142,14
7142,2018-01-06,2018-01-05,UTAH_JAZZ,DENVER_NUGGETS,91,99,7143,8
7143,2018-01-06,2018-01-05,WASHINGTON_WIZARDS,MEMPHIS_GRIZZLIES,102,100,7144,2
7144,2018-01-06,2018-01-05,ATLANTA_HAWKS,PORTLAND_TRAIL_BLAZERS,89,110,7145,21
7145,2018-01-06,2018-01-05,CHARLOTTE_HORNETS,LOS_ANGELES_LAKERS,108,94,7146,14
7146,2018-01-06,2018-01-05,GOLDEN_STATE_WARRIORS,LOS_ANGELES_CLIPPERS,121,105,7147,16
7147,2018-01-06,2018-01-05,BOSTON_CELTICS,BROOKLYN_NETS,87,85,7148,2
7148,2018-01-07,2018-01-06,HOUSTON_ROCKETS,DETROIT_PISTONS,101,108,7149,7
7149,2018-01-07,2018-01-06,CHICAGO_BULLS,INDIANA_PACERS,86,125,7150,39
7150,2018-01-07,2018-01-06,CLEVELAND_CAVALIERS,ORLANDO_MAGIC,131,127,7151,4
7151,2018-01-07,2018-01-06,MILWAUKEE_BUCKS,WASHINGTON_WIZARDS,110,103,7152,7
7152,2018-01-07,2018-01-06,NEW_ORLEANS_PELICANS,MINNESOTA_TIMBERWOLVES,98,116,7153,18
7153,2018-01-07,2018-01-06,DENVER_NUGGETS,SACRAMENTO_KINGS,98,106,7154,8
7154,2018-01-07,2018-01-06,UTAH_JAZZ,MIAMI_HEAT,102,103,7155,1
7155,2018-01-08,2018-01-07,NEW_YORK_KNICKS,DALLAS_MAVERICKS,100,96,7156,4
7156,2018-01-08,2018-01-07,OKLAHOMA_CITY_THUNDER,PHOENIX_SUNS,100,114,7157,14
7157,2018-01-08,2018-01-07,SAN_ANTONIO_SPURS,PORTLAND_TRAIL_BLAZERS,110,111,7158,1
7158,2018-01-08,2018-01-07,ATLANTA_HAWKS,LOS_ANGELES_LAKERS,113,132,7159,19
7159,2018-01-09,2018-01-08,MILWAUKEE_BUCKS,INDIANA_PACERS,96,109,7160,13
7160,2018-01-09,2018-01-08,TORONTO_RAPTORS,BROOKLYN_NETS,114,113,7161,1
7161,2018-01-09,2018-01-08,HOUSTON_ROCKETS,CHICAGO_BULLS,116,107,7162,9
7162,2018-01-09,2018-01-08,CLEVELAND_CAVALIERS,MINNESOTA_TIMBERWOLVES,99,127,7163,28
7163,2018-01-09,2018-01-08,DETROIT_PISTONS,NEW_ORLEANS_PELICANS,109,112,7164,3
7164,2018-01-09,2018-01-08,SAN_ANTONIO_SPURS,SACRAMENTO_KINGS,107,100,7165,7
7165,2018-01-09,2018-01-08,DENVER_NUGGETS,GOLDEN_STATE_WARRIORS,114,124,7166,10
7166,2018-01-09,2018-01-08,ATLANTA_HAWKS,LOS_ANGELES_CLIPPERS,107,108,7167,1
7167,2018-01-10,2018-01-09,MIAMI_HEAT,TORONTO_RAPTORS,90,89,7168,1
7168,2018-01-10,2018-01-09,PORTLAND_TRAIL_BLAZERS,OKLAHOMA_CITY_THUNDER,117,106,7169,11
7169,2018-01-10,2018-01-09,ORLANDO_MAGIC,DALLAS_MAVERICKS,99,114,7170,15
7170,2018-01-10,2018-01-09,SACRAMENTO_KINGS,LOS_ANGELES_LAKERS,86,99,7171,13
7171,2018-01-11,2018-01-10,DALLAS_MAVERICKS,CHARLOTTE_HORNETS,115,111,7172,4
7172,2018-01-11,2018-01-10,MIAMI_HEAT,INDIANA_PACERS,114,106,7173,8
7173,2018-01-11,2018-01-10,UTAH_JAZZ,WASHINGTON_WIZARDS,107,104,7174,3
7174,2018-01-11,2018-01-10,DETROIT_PISTONS,BROOKLYN_NETS,114,80,7175,34
7175,2018-01-11,2018-01-10,CHICAGO_BULLS,NEW_YORK_KNICKS,122,119,7176,3
7176,2018-01-11,2018-01-10,PORTLAND_TRAIL_BLAZERS,HOUSTON_ROCKETS,112,121,7177,9
7177,2018-01-11,2018-01-10,NEW_ORLEANS_PELICANS,MEMPHIS_GRIZZLIES,102,105,7178,3
7178,2018-01-11,2018-01-10,ORLANDO_MAGIC,MILWAUKEE_BUCKS,103,110,7179,7
7179,2018-01-11,2018-01-10,OKLAHOMA_CITY_THUNDER,MINNESOTA_TIMBERWOLVES,88,104,7180,16
7180,2018-01-11,2018-01-10,ATLANTA_HAWKS,DENVER_NUGGETS,110,97,7181,13
7181,2018-01-11,2018-01-10,LOS_ANGELES_CLIPPERS,GOLDEN_STATE_WARRIORS,125,106,7182,19
7182,2018-01-11,2018-01-10,BOSTON_CELTICS,PHILADELPHIA_76ERS,114,103,7183,11
7183,2018-01-12,2018-01-11,CLEVELAND_CAVALIERS,TORONTO_RAPTORS,99,133,7184,34
7184,2018-01-12,2018-01-11,LOS_ANGELES_CLIPPERS,SACRAMENTO_KINGS,121,115,7185,6
7185,2018-01-12,2018-01-11,SAN_ANTONIO_SPURS,LOS_ANGELES_LAKERS,81,93,7186,12
7186,2018-01-13,2018-01-12,UTAH_JAZZ,CHARLOTTE_HORNETS,88,99,7187,11
7187,2018-01-13,2018-01-12,CLEVELAND_CAVALIERS,INDIANA_PACERS,95,97,7188,2
7188,2018-01-13,2018-01-12,ORLANDO_MAGIC,WASHINGTON_WIZARDS,119,125,7189,6
7189,2018-01-13,2018-01-12,BROOKLYN_NETS,ATLANTA_HAWKS,110,105,7190,5
7190,2018-01-13,2018-01-12,GOLDEN_STATE_WARRIORS,MILWAUKEE_BUCKS,108,94,7191,14
7191,2018-01-13,2018-01-12,NEW_YORK_KNICKS,MINNESOTA_TIMBERWOLVES,108,118,7192,10
7192,2018-01-13,2018-01-12,PORTLAND_TRAIL_BLAZERS,NEW_ORLEANS_PELICANS,113,119,7193,6
7193,2018-01-13,2018-01-12,MEMPHIS_GRIZZLIES,DENVER_NUGGETS,78,87,7194,9
7194,2018-01-13,2018-01-12,HOUSTON_ROCKETS,PHOENIX_SUNS,112,95,7195,17
7195,2018-01-13,2018-01-12,LOS_ANGELES_LAKERS,DALLAS_MAVERICKS,107,101,7196,6
7196,2018-01-13,2018-01-12,SACRAMENTO_KINGS,LOS_ANGELES_CLIPPERS,105,126,7197,21
7197,2018-01-13,2018-01-12,OKLAHOMA_CITY_THUNDER,CHARLOTTE_HORNETS,101,91,7198,10
7198,2018-01-14,2018-01-13,BROOKLYN_NETS,WASHINGTON_WIZARDS,113,119,7199,6
7199,2018-01-14,2018-01-13,GOLDEN_STATE_WARRIORS,TORONTO_RAPTORS,127,125,7200,2
7200,2018-01-14,2018-01-13,DETROIT_PISTONS,CHICAGO_BULLS,105,107,7201,2
7201,2018-01-14,2018-01-13,DENVER_NUGGETS,SAN_ANTONIO_SPURS,80,112,7202,32
7202,2018-01-14,2018-01-13,MILWAUKEE_BUCKS,MIAMI_HEAT,79,97,7203,18
7203,2018-01-14,2018-01-13,NEW_ORLEANS_PELICANS,NEW_YORK_KNICKS,123,118,7204,5
7204,2018-01-15,2018-01-14,INDIANA_PACERS,PHOENIX_SUNS,120,97,7205,23
7205,2018-01-15,2018-01-14,PORTLAND_TRAIL_BLAZERS,MINNESOTA_TIMBERWOLVES,103,120,7206,17
7206,2018-01-15,2018-01-14,CHARLOTTE_HORNETS,DETROIT_PISTONS,118,107,7207,11
7207,2018-01-15,2018-01-14,TORONTO_RAPTORS,PHILADELPHIA_76ERS,111,117,7208,6
7208,2018-01-15,2018-01-14,MILWAUKEE_BUCKS,WASHINGTON_WIZARDS,104,95,7209,9
7209,2018-01-15,2018-01-14,SAN_ANTONIO_SPURS,ATLANTA_HAWKS,99,102,7210,3
7210,2018-01-15,2018-01-14,NEW_YORK_KNICKS,BROOKLYN_NETS,119,104,7211,15
7211,2018-01-15,2018-01-14,MIAMI_HEAT,CHICAGO_BULLS,111,119,7212,8
7212,2018-01-15,2018-01-14,LOS_ANGELES_LAKERS,MEMPHIS_GRIZZLIES,114,123,7213,9
7213,2018-01-16,2018-01-15,GOLDEN_STATE_WARRIORS,CLEVELAND_CAVALIERS,118,108,7214,10
7214,2018-01-16,2018-01-15,SACRAMENTO_KINGS,OKLAHOMA_CITY_THUNDER,88,95,7215,7
7215,2018-01-16,2018-01-15,INDIANA_PACERS,UTAH_JAZZ,109,94,7216,15
7216,2018-01-16,2018-01-15,HOUSTON_ROCKETS,LOS_ANGELES_CLIPPERS,102,113,7217,11
7217,2018-01-17,2018-01-16,MINNESOTA_TIMBERWOLVES,ORLANDO_MAGIC,102,108,7218,6
7218,2018-01-17,2018-01-16,NEW_ORLEANS_PELICANS,BOSTON_CELTICS,116,113,7219,3
7219,2018-01-17,2018-01-16,DALLAS_MAVERICKS,DENVER_NUGGETS,102,105,7220,3
7220,2018-01-17,2018-01-16,PHOENIX_SUNS,PORTLAND_TRAIL_BLAZERS,111,118,7221,7
7221,2018-01-18,2018-01-17,WASHINGTON_WIZARDS,CHARLOTTE_HORNETS,109,133,7222,24
7222,2018-01-18,2018-01-17,NEW_ORLEANS_PELICANS,ATLANTA_HAWKS,93,94,7223,1
7223,2018-01-18,2018-01-17,SAN_ANTONIO_SPURS,BROOKLYN_NETS,100,95,7224,5
7224,2018-01-18,2018-01-17,DETROIT_PISTONS,TORONTO_RAPTORS,91,96,7225,5
7225,2018-01-18,2018-01-17,GOLDEN_STATE_WARRIORS,CHICAGO_BULLS,119,112,7226,7
7226,2018-01-18,2018-01-17,NEW_YORK_KNICKS,MEMPHIS_GRIZZLIES,99,105,7227,6
7227,2018-01-18,2018-01-17,MIAMI_HEAT,MILWAUKEE_BUCKS,106,101,7228,5
7228,2018-01-18,2018-01-17,LOS_ANGELES_LAKERS,OKLAHOMA_CITY_THUNDER,90,114,7229,24
7229,2018-01-18,2018-01-17,UTAH_JAZZ,SACRAMENTO_KINGS,120,105,7230,15
7230,2018-01-18,2018-01-17,DENVER_NUGGETS,LOS_ANGELES_CLIPPERS,104,109,7231,5
7231,2018-01-19,2018-01-18,PHILADELPHIA_76ERS,BOSTON_CELTICS,89,80,7232,9
7232,2018-01-19,2018-01-18,ORLANDO_MAGIC,CLEVELAND_CAVALIERS,103,104,7233,1
7233,2018-01-19,2018-01-18,MINNESOTA_TIMBERWOLVES,HOUSTON_ROCKETS,98,116,7234,18
7234,2018-01-19,2018-01-18,INDIANA_PACERS,PORTLAND_TRAIL_BLAZERS,86,100,7235,14
7235,2018-01-20,2018-01-19,SAN_ANTONIO_SPURS,TORONTO_RAPTORS,83,86,7236,3
7236,2018-01-20,2018-01-19,MIAMI_HEAT,BROOKLYN_NETS,95,101,7237,6
7237,2018-01-20,2018-01-19,WASHINGTON_WIZARDS,DETROIT_PISTONS,122,112,7238,10
7238,2018-01-20,2018-01-19,SACRAMENTO_KINGS,MEMPHIS_GRIZZLIES,88,106,7239,18
7239,2018-01-20,2018-01-19,PHOENIX_SUNS,DENVER_NUGGETS,108,100,7240,8
7240,2018-01-20,2018-01-19,INDIANA_PACERS,LOS_ANGELES_LAKERS,86,99,7241,13
7241,2018-01-20,2018-01-19,NEW_YORK_KNICKS,UTAH_JAZZ,117,115,7242,2
7242,2018-01-20,2018-01-19,OKLAHOMA_CITY_THUNDER,CLEVELAND_CAVALIERS,148,124,7243,24
7243,2018-01-20,2018-01-19,CHICAGO_BULLS,ATLANTA_HAWKS,113,97,7244,16
7244,2018-01-21,2018-01-20,MIAMI_HEAT,CHARLOTTE_HORNETS,106,105,7245,1
7245,2018-01-21,2018-01-20,MEMPHIS_GRIZZLIES,NEW_ORLEANS_PELICANS,104,111,7246,7
7246,2018-01-21,2018-01-20,MILWAUKEE_BUCKS,PHILADELPHIA_76ERS,94,116,7247,22
7247,2018-01-21,2018-01-20,GOLDEN_STATE_WARRIORS,HOUSTON_ROCKETS,108,116,7248,8
7248,2018-01-21,2018-01-20,TORONTO_RAPTORS,MINNESOTA_TIMBERWOLVES,109,115,7249,6
7249,2018-01-21,2018-01-20,LOS_ANGELES_CLIPPERS,UTAH_JAZZ,113,125,7250,12
7250,2018-01-21,2018-01-20,DALLAS_MAVERICKS,PORTLAND_TRAIL_BLAZERS,108,117,7251,9
7251,2018-01-21,2018-01-20,ORLANDO_MAGIC,BOSTON_CELTICS,103,95,7252,8
7252,2018-01-21,2018-01-20,NEW_YORK_KNICKS,LOS_ANGELES_LAKERS,107,127,7253,20
7253,2018-01-21,2018-01-20,BROOKLYN_NETS,DETROIT_PISTONS,101,100,7254,1
7254,2018-01-22,2018-01-21,INDIANA_PACERS,SAN_ANTONIO_SPURS,94,86,7255,8
7255,2018-01-23,2018-01-22,SACRAMENTO_KINGS,CHARLOTTE_HORNETS,107,112,7256,5
7256,2018-01-23,2018-01-22,UTAH_JAZZ,ATLANTA_HAWKS,90,104,7257,14
7257,2018-01-23,2018-01-22,MIAMI_HEAT,HOUSTON_ROCKETS,90,99,7258,9
7258,2018-01-23,2018-01-22,PHILADELPHIA_76ERS,MEMPHIS_GRIZZLIES,101,105,7259,4
7259,2018-01-23,2018-01-22,PHOENIX_SUNS,MILWAUKEE_BUCKS,105,109,7260,4
7260,2018-01-23,2018-01-22,CHICAGO_BULLS,NEW_ORLEANS_PELICANS,128,132,7261,4
7261,2018-01-23,2018-01-22,WASHINGTON_WIZARDS,DALLAS_MAVERICKS,75,98,7262,23
7262,2018-01-23,2018-01-22,PORTLAND_TRAIL_BLAZERS,DENVER_NUGGETS,101,104,7263,3
7263,2018-01-23,2018-01-22,MINNESOTA_TIMBERWOLVES,LOS_ANGELES_CLIPPERS,126,118,7264,8
7264,2018-01-24,2018-01-23,SACRAMENTO_KINGS,ORLANDO_MAGIC,105,99,7265,6
7265,2018-01-24,2018-01-23,BROOKLYN_NETS,OKLAHOMA_CITY_THUNDER,108,109,7266,1
7266,2018-01-24,2018-01-23,CLEVELAND_CAVALIERS,SAN_ANTONIO_SPURS,102,114,7267,12
7267,2018-01-24,2018-01-23,NEW_YORK_KNICKS,GOLDEN_STATE_WARRIORS,112,123,7268,11
7268,2018-01-24,2018-01-23,BOSTON_CELTICS,LOS_ANGELES_LAKERS,107,108,7269,1
7269,2018-01-25,2018-01-24,NEW_ORLEANS_PELICANS,CHARLOTTE_HORNETS,101,96,7270,5
7270,2018-01-25,2018-01-24,UTAH_JAZZ,DETROIT_PISTONS,98,95,7271,3
7271,2018-01-25,2018-01-24,PHOENIX_SUNS,INDIANA_PACERS,101,116,7272,15
7272,2018-01-25,2018-01-24,CHICAGO_BULLS,PHILADELPHIA_76ERS,101,115,7273,14
7273,2018-01-25,2018-01-24,TORONTO_RAPTORS,ATLANTA_HAWKS,108,93,7274,15
7274,2018-01-25,2018-01-24,HOUSTON_ROCKETS,DALLAS_MAVERICKS,104,97,7275,7
7275,2018-01-25,2018-01-24,SAN_ANTONIO_SPURS,MEMPHIS_GRIZZLIES,108,85,7276,23
7276,2018-01-25,2018-01-24,MINNESOTA_TIMBERWOLVES,PORTLAND_TRAIL_BLAZERS,114,123,7277,9
7277,2018-01-25,2018-01-24,BOSTON_CELTICS,LOS_ANGELES_CLIPPERS,113,102,7278,11
7278,2018-01-26,2018-01-25,SACRAMENTO_KINGS,MIAMI_HEAT,89,88,7279,1
7279,2018-01-26,2018-01-25,WASHINGTON_WIZARDS,OKLAHOMA_CITY_THUNDER,112,121,7280,9
7280,2018-01-26,2018-01-25,NEW_YORK_KNICKS,DENVER_NUGGETS,118,130,7281,12
7281,2018-01-26,2018-01-25,MINNESOTA_TIMBERWOLVES,GOLDEN_STATE_WARRIORS,113,126,7282,13
7282,2018-01-27,2018-01-26,ATLANTA_HAWKS,CHARLOTTE_HORNETS,110,121,7283,11
7283,2018-01-27,2018-01-26,INDIANA_PACERS,CLEVELAND_CAVALIERS,108,115,7284,7
7284,2018-01-27,2018-01-26,UTAH_JAZZ,TORONTO_RAPTORS,97,93,7285,4
7285,2018-01-27,2018-01-26,LOS_ANGELES_LAKERS,CHICAGO_BULLS,108,103,7286,5
7286,2018-01-27,2018-01-26,LOS_ANGELES_CLIPPERS,MEMPHIS_GRIZZLIES,109,100,7287,9
7287,2018-01-27,2018-01-26,BROOKLYN_NETS,MILWAUKEE_BUCKS,91,116,7288,25
7288,2018-01-27,2018-01-26,HOUSTON_ROCKETS,NEW_ORLEANS_PELICANS,113,115,7289,2
7289,2018-01-27,2018-01-26,PORTLAND_TRAIL_BLAZERS,DALLAS_MAVERICKS,107,93,7290,14
7290,2018-01-27,2018-01-26,PHILADELPHIA_76ERS,SAN_ANTONIO_SPURS,97,78,7291,19
7291,2018-01-27,2018-01-26,NEW_YORK_KNICKS,PHOENIX_SUNS,107,85,7292,22
7292,2018-01-27,2018-01-26,OKLAHOMA_CITY_THUNDER,DETROIT_PISTONS,121,108,7293,13
7293,2018-01-28,2018-01-27,ORLANDO_MAGIC,INDIANA_PACERS,112,114,7294,2
7294,2018-01-28,2018-01-27,WASHINGTON_WIZARDS,ATLANTA_HAWKS,129,104,7295,25
7295,2018-01-28,2018-01-27,CHARLOTTE_HORNETS,MIAMI_HEAT,91,95,7296,4
7296,2018-01-28,2018-01-27,BOSTON_CELTICS,GOLDEN_STATE_WARRIORS,105,109,7297,4
7297,2018-01-28,2018-01-27,DALLAS_MAVERICKS,DENVER_NUGGETS,89,91,7298,2
7298,2018-01-28,2018-01-27,BROOKLYN_NETS,MINNESOTA_TIMBERWOLVES,97,111,7299,14
7299,2018-01-28,2018-01-27,MILWAUKEE_BUCKS,CHICAGO_BULLS,110,96,7300,14
7300,2018-01-28,2018-01-27,PHOENIX_SUNS,HOUSTON_ROCKETS,102,113,7301,11
7301,2018-01-28,2018-01-27,LOS_ANGELES_CLIPPERS,NEW_ORLEANS_PELICANS,112,103,7302,9
7302,2018-01-28,2018-01-27,DETROIT_PISTONS,CLEVELAND_CAVALIERS,104,121,7303,17
7303,2018-01-28,2018-01-27,PHILADELPHIA_76ERS,OKLAHOMA_CITY_THUNDER,112,122,7304,10
7304,2018-01-28,2018-01-27,LOS_ANGELES_LAKERS,TORONTO_RAPTORS,111,123,7305,12
7305,2018-01-29,2018-01-28,SACRAMENTO_KINGS,SAN_ANTONIO_SPURS,98,113,7306,15
7306,2018-01-30,2018-01-29,CHARLOTTE_HORNETS,INDIANA_PACERS,96,105,7307,9
7307,2018-01-30,2018-01-29,MINNESOTA_TIMBERWOLVES,ATLANTA_HAWKS,100,105,7308,5
7308,2018-01-30,2018-01-29,PHOENIX_SUNS,MEMPHIS_GRIZZLIES,109,120,7309,11
7309,2018-01-30,2018-01-29,PHILADELPHIA_76ERS,MILWAUKEE_BUCKS,95,107,7310,12
7310,2018-01-30,2018-01-29,MIAMI_HEAT,DALLAS_MAVERICKS,95,88,7311,7
7311,2018-01-30,2018-01-29,BOSTON_CELTICS,DENVER_NUGGETS,111,110,7312,1
7312,2018-01-31,2018-01-30,OKLAHOMA_CITY_THUNDER,WASHINGTON_WIZARDS,96,102,7313,6
7313,2018-01-31,2018-01-30,BROOKLYN_NETS,NEW_YORK_KNICKS,95,111,7314,16
7314,2018-01-31,2018-01-30,MINNESOTA_TIMBERWOLVES,TORONTO_RAPTORS,104,109,7315,5
7315,2018-01-31,2018-01-30,CLEVELAND_CAVALIERS,DETROIT_PISTONS,114,125,7316,11
7316,2018-01-31,2018-01-30,ORLANDO_MAGIC,HOUSTON_ROCKETS,107,114,7317,7
7317,2018-01-31,2018-01-30,SACRAMENTO_KINGS,NEW_ORLEANS_PELICANS,114,103,7318,11
7318,2018-01-31,2018-01-30,DENVER_NUGGETS,SAN_ANTONIO_SPURS,104,106,7319,2
7319,2018-01-31,2018-01-30,GOLDEN_STATE_WARRIORS,UTAH_JAZZ,99,129,7320,30
7320,2018-01-31,2018-01-30,PORTLAND_TRAIL_BLAZERS,LOS_ANGELES_CLIPPERS,104,96,7321,8
7321,2018-02-01,2018-01-31,MEMPHIS_GRIZZLIES,INDIANA_PACERS,101,105,7322,4
7322,2018-02-01,2018-01-31,LOS_ANGELES_LAKERS,ORLANDO_MAGIC,105,127,7323,22
7323,2018-02-01,2018-01-31,CHARLOTTE_HORNETS,ATLANTA_HAWKS,123,110,7324,13
7324,2018-02-01,2018-01-31,PHILADELPHIA_76ERS,BROOKLYN_NETS,108,116,7325,8
7325,2018-02-01,2018-01-31,MIAMI_HEAT,CLEVELAND_CAVALIERS,89,91,7326,2
7326,2018-02-01,2018-01-31,NEW_YORK_KNICKS,BOSTON_CELTICS,73,103,7327,30
7327,2018-02-01,2018-01-31,CHICAGO_BULLS,PORTLAND_TRAIL_BLAZERS,108,124,7328,16
7328,2018-02-01,2018-01-31,DALLAS_MAVERICKS,PHOENIX_SUNS,88,102,7329,14
7329,2018-02-02,2018-02-01,MEMPHIS_GRIZZLIES,DETROIT_PISTONS,102,104,7330,2
7330,2018-02-02,2018-02-01,TORONTO_RAPTORS,WASHINGTON_WIZARDS,119,122,7331,3
7331,2018-02-02,2018-02-01,MILWAUKEE_BUCKS,MINNESOTA_TIMBERWOLVES,89,108,7332,19
7332,2018-02-02,2018-02-01,HOUSTON_ROCKETS,SAN_ANTONIO_SPURS,102,91,7333,11
7333,2018-02-02,2018-02-01,OKLAHOMA_CITY_THUNDER,DENVER_NUGGETS,124,127,7334,3
7334,2018-02-03,2018-02-02,INDIANA_PACERS,CHARLOTTE_HORNETS,126,133,7335,7
7335,2018-02-03,2018-02-02,ATLANTA_HAWKS,BOSTON_CELTICS,110,119,7336,9
7336,2018-02-03,2018-02-02,LOS_ANGELES_LAKERS,BROOKLYN_NETS,102,99,7337,3
7337,2018-02-03,2018-02-02,PORTLAND_TRAIL_BLAZERS,TORONTO_RAPTORS,105,130,7338,25
7338,2018-02-03,2018-02-02,NEW_YORK_KNICKS,MILWAUKEE_BUCKS,90,92,7339,2
7339,2018-02-03,2018-02-02,MIAMI_HEAT,PHILADELPHIA_76ERS,97,103,7340,6
7340,2018-02-03,2018-02-02,NEW_ORLEANS_PELICANS,OKLAHOMA_CITY_THUNDER,114,100,7341,14
7341,2018-02-03,2018-02-02,UTAH_JAZZ,PHOENIX_SUNS,129,97,7342,32
7342,2018-02-03,2018-02-02,GOLDEN_STATE_WARRIORS,SACRAMENTO_KINGS,119,104,7343,15
7343,2018-02-03,2018-02-02,CHICAGO_BULLS,LOS_ANGELES_CLIPPERS,103,113,7344,10
7344,2018-02-04,2018-02-03,MIAMI_HEAT,DETROIT_PISTONS,107,111,7345,4
7345,2018-02-04,2018-02-03,PHILADELPHIA_76ERS,INDIANA_PACERS,92,100,7346,8
7346,2018-02-04,2018-02-03,WASHINGTON_WIZARDS,ORLANDO_MAGIC,115,98,7347,17
7347,2018-02-04,2018-02-03,HOUSTON_ROCKETS,CLEVELAND_CAVALIERS,120,88,7348,32
7348,2018-02-04,2018-02-03,GOLDEN_STATE_WARRIORS,DENVER_NUGGETS,108,115,7349,7
7349,2018-02-04,2018-02-03,NEW_ORLEANS_PELICANS,MINNESOTA_TIMBERWOLVES,107,118,7350,11
7350,2018-02-04,2018-02-03,UTAH_JAZZ,SAN_ANTONIO_SPURS,120,111,7351,9
7351,2018-02-04,2018-02-03,DALLAS_MAVERICKS,SACRAMENTO_KINGS,106,99,7352,7
7352,2018-02-04,2018-02-03,PORTLAND_TRAIL_BLAZERS,BOSTON_CELTICS,96,97,7353,1
7353,2018-02-04,2018-02-03,MILWAUKEE_BUCKS,BROOKLYN_NETS,109,94,7354,15
7354,2018-02-04,2018-02-03,ATLANTA_HAWKS,NEW_YORK_KNICKS,99,96,7355,3
7355,2018-02-04,2018-02-03,MEMPHIS_GRIZZLIES,TORONTO_RAPTORS,86,101,7356,15
7356,2018-02-04,2018-02-03,LOS_ANGELES_LAKERS,OKLAHOMA_CITY_THUNDER,108,104,7357,4
7357,2018-02-04,2018-02-03,CHARLOTTE_HORNETS,PHOENIX_SUNS,115,110,7358,5
7358,2018-02-06,2018-02-05,PORTLAND_TRAIL_BLAZERS,DETROIT_PISTONS,91,111,7359,20
7359,2018-02-06,2018-02-05,WASHINGTON_WIZARDS,INDIANA_PACERS,111,102,7360,9
7360,2018-02-06,2018-02-05,ORLANDO_MAGIC,MIAMI_HEAT,111,109,7361,2
7361,2018-02-06,2018-02-05,UTAH_JAZZ,NEW_ORLEANS_PELICANS,133,109,7362,24
7362,2018-02-06,2018-02-05,CHARLOTTE_HORNETS,DENVER_NUGGETS,104,121,7363,17
7363,2018-02-06,2018-02-05,CHICAGO_BULLS,SACRAMENTO_KINGS,98,104,7364,6
7364,2018-02-06,2018-02-05,DALLAS_MAVERICKS,LOS_ANGELES_CLIPPERS,101,104,7365,3
7365,2018-02-07,2018-02-06,CLEVELAND_CAVALIERS,ORLANDO_MAGIC,98,116,7366,18
7366,2018-02-07,2018-02-06,MEMPHIS_GRIZZLIES,ATLANTA_HAWKS,82,108,7367,26
7367,2018-02-07,2018-02-06,HOUSTON_ROCKETS,BROOKLYN_NETS,123,113,7368,10
7368,2018-02-07,2018-02-06,MILWAUKEE_BUCKS,NEW_YORK_KNICKS,103,89,7369,14
7369,2018-02-07,2018-02-06,BOSTON_CELTICS,TORONTO_RAPTORS,91,111,7370,20
7370,2018-02-07,2018-02-06,WASHINGTON_WIZARDS,PHILADELPHIA_76ERS,102,115,7371,13
7371,2018-02-07,2018-02-06,OKLAHOMA_CITY_THUNDER,GOLDEN_STATE_WARRIORS,125,105,7372,20
7372,2018-02-07,2018-02-06,PHOENIX_SUNS,LOS_ANGELES_LAKERS,93,112,7373,19
7373,2018-02-08,2018-02-07,BROOKLYN_NETS,DETROIT_PISTONS,106,115,7374,9
7374,2018-02-08,2018-02-07,HOUSTON_ROCKETS,MIAMI_HEAT,109,101,7375,8
7375,2018-02-08,2018-02-07,MINNESOTA_TIMBERWOLVES,CLEVELAND_CAVALIERS,138,140,7376,2
7376,2018-02-08,2018-02-07,UTAH_JAZZ,MEMPHIS_GRIZZLIES,92,88,7377,4
7377,2018-02-08,2018-02-07,SAN_ANTONIO_SPURS,PHOENIX_SUNS,129,81,7378,48
7378,2018-02-09,2018-02-08,ATLANTA_HAWKS,ORLANDO_MAGIC,98,100,7379,2
7379,2018-02-09,2018-02-08,NEW_YORK_KNICKS,TORONTO_RAPTORS,88,113,7380,25
7380,2018-02-09,2018-02-08,BOSTON_CELTICS,WASHINGTON_WIZARDS,110,104,7381,6
7381,2018-02-09,2018-02-08,CHARLOTTE_HORNETS,PORTLAND_TRAIL_BLAZERS,103,109,7382,6
7382,2018-02-09,2018-02-08,DALLAS_MAVERICKS,GOLDEN_STATE_WARRIORS,103,121,7383,18
7383,2018-02-09,2018-02-08,OKLAHOMA_CITY_THUNDER,LOS_ANGELES_LAKERS,81,106,7384,25
7384,2018-02-10,2018-02-09,LOS_ANGELES_CLIPPERS,DETROIT_PISTONS,108,95,7385,13
7385,2018-02-10,2018-02-09,NEW_ORLEANS_PELICANS,PHILADELPHIA_76ERS,82,100,7386,18
7386,2018-02-10,2018-02-09,CLEVELAND_CAVALIERS,ATLANTA_HAWKS,123,107,7387,16
7387,2018-02-10,2018-02-09,INDIANA_PACERS,BOSTON_CELTICS,97,91,7388,6
7388,2018-02-10,2018-02-09,DENVER_NUGGETS,HOUSTON_ROCKETS,104,130,7389,26
7389,2018-02-10,2018-02-09,MILWAUKEE_BUCKS,MIAMI_HEAT,85,91,7390,6
7390,2018-02-10,2018-02-09,CHARLOTTE_HORNETS,UTAH_JAZZ,94,106,7391,12
7391,2018-02-10,2018-02-09,MINNESOTA_TIMBERWOLVES,CHICAGO_BULLS,113,114,7392,1
7392,2018-02-10,2018-02-09,PORTLAND_TRAIL_BLAZERS,SACRAMENTO_KINGS,118,100,7393,18
7393,2018-02-10,2018-02-09,NEW_ORLEANS_PELICANS,BROOKLYN_NETS,138,128,7394,10
7394,2018-02-11,2018-02-10,MILWAUKEE_BUCKS,ORLANDO_MAGIC,111,104,7395,7
7395,2018-02-11,2018-02-10,LOS_ANGELES_CLIPPERS,PHILADELPHIA_76ERS,98,112,7396,14
7396,2018-02-11,2018-02-10,WASHINGTON_WIZARDS,CHICAGO_BULLS,101,90,7397,11
7397,2018-02-11,2018-02-10,LOS_ANGELES_LAKERS,DALLAS_MAVERICKS,123,130,7398,7
7398,2018-02-11,2018-02-10,SAN_ANTONIO_SPURS,GOLDEN_STATE_WARRIORS,105,122,7399,17
7399,2018-02-11,2018-02-10,DENVER_NUGGETS,PHOENIX_SUNS,123,113,7400,10
7400,2018-02-11,2018-02-10,TORONTO_RAPTORS,CHARLOTTE_HORNETS,123,103,7401,20
7401,2018-02-11,2018-02-10,DETROIT_PISTONS,ATLANTA_HAWKS,115,118,7402,3
7402,2018-02-11,2018-02-10,CLEVELAND_CAVALIERS,BOSTON_CELTICS,121,99,7403,22
7403,2018-02-11,2018-02-10,NEW_YORK_KNICKS,INDIANA_PACERS,113,121,7404,8
7404,2018-02-12,2018-02-11,DALLAS_MAVERICKS,HOUSTON_ROCKETS,97,104,7405,7
7405,2018-02-12,2018-02-11,SACRAMENTO_KINGS,MINNESOTA_TIMBERWOLVES,106,111,7406,5
7406,2018-02-12,2018-02-11,MEMPHIS_GRIZZLIES,OKLAHOMA_CITY_THUNDER,92,110,7407,18
7407,2018-02-12,2018-02-11,UTAH_JAZZ,PORTLAND_TRAIL_BLAZERS,115,96,7408,19
7408,2018-02-13,2018-02-12,NEW_ORLEANS_PELICANS,DETROIT_PISTONS,118,103,7409,15
7409,2018-02-13,2018-02-12,NEW_YORK_KNICKS,PHILADELPHIA_76ERS,92,108,7410,16
7410,2018-02-13,2018-02-12,LOS_ANGELES_CLIPPERS,BROOKLYN_NETS,114,101,7411,13
7411,2018-02-13,2018-02-12,ORLANDO_MAGIC,CHICAGO_BULLS,101,105,7412,4
7412,2018-02-13,2018-02-12,SAN_ANTONIO_SPURS,UTAH_JAZZ,99,101,7413,2
7413,2018-02-13,2018-02-12,PHOENIX_SUNS,GOLDEN_STATE_WARRIORS,83,129,7414,46
7414,2018-02-14,2018-02-13,MIAMI_HEAT,TORONTO_RAPTORS,112,115,7415,3
7415,2018-02-14,2018-02-13,ATLANTA_HAWKS,MILWAUKEE_BUCKS,92,97,7416,5
7416,2018-02-14,2018-02-13,HOUSTON_ROCKETS,MINNESOTA_TIMBERWOLVES,126,108,7417,18
7417,2018-02-14,2018-02-13,CLEVELAND_CAVALIERS,OKLAHOMA_CITY_THUNDER,120,112,7418,8
7418,2018-02-14,2018-02-13,SACRAMENTO_KINGS,DALLAS_MAVERICKS,114,109,7419,5
7419,2018-02-14,2018-02-13,SAN_ANTONIO_SPURS,DENVER_NUGGETS,109,117,7420,8
7420,2018-02-15,2018-02-14,ATLANTA_HAWKS,DETROIT_PISTONS,98,104,7421,6
7421,2018-02-15,2018-02-14,CHARLOTTE_HORNETS,ORLANDO_MAGIC,104,102,7422,2
7422,2018-02-15,2018-02-14,MIAMI_HEAT,PHILADELPHIA_76ERS,102,104,7423,2
7423,2018-02-15,2018-02-14,INDIANA_PACERS,BROOKLYN_NETS,108,103,7424,5
7424,2018-02-15,2018-02-14,WASHINGTON_WIZARDS,NEW_YORK_KNICKS,118,113,7425,5
7425,2018-02-15,2018-02-14,LOS_ANGELES_CLIPPERS,BOSTON_CELTICS,129,119,7426,10
7426,2018-02-15,2018-02-14,TORONTO_RAPTORS,CHICAGO_BULLS,122,98,7427,24
7427,2018-02-15,2018-02-14,SACRAMENTO_KINGS,HOUSTON_ROCKETS,91,100,7428,9
7428,2018-02-15,2018-02-14,OKLAHOMA_CITY_THUNDER,MEMPHIS_GRIZZLIES,121,114,7429,7
7429,2018-02-15,2018-02-14,LOS_ANGELES_LAKERS,NEW_ORLEANS_PELICANS,117,139,7430,22
7430,2018-02-15,2018-02-14,PHOENIX_SUNS,UTAH_JAZZ,97,107,7431,10
7431,2018-02-15,2018-02-14,GOLDEN_STATE_WARRIORS,PORTLAND_TRAIL_BLAZERS,117,123,7432,6
7432,2018-02-16,2018-02-15,DENVER_NUGGETS,MILWAUKEE_BUCKS,134,123,7433,11
7433,2018-02-16,2018-02-15,LOS_ANGELES_LAKERS,MINNESOTA_TIMBERWOLVES,111,119,7434,8
7434,2018-02-23,2018-02-22,BROOKLYN_NETS,CHARLOTTE_HORNETS,96,111,7435,15
7435,2018-02-23,2018-02-22,NEW_YORK_KNICKS,ORLANDO_MAGIC,120,113,7436,7
7436,2018-02-23,2018-02-22,PHILADELPHIA_76ERS,CHICAGO_BULLS,116,115,7437,1
7437,2018-02-23,2018-02-22,WASHINGTON_WIZARDS,CLEVELAND_CAVALIERS,110,103,7438,7
7438,2018-02-23,2018-02-22,OKLAHOMA_CITY_THUNDER,SACRAMENTO_KINGS,110,107,7439,3
7439,2018-02-23,2018-02-22,LOS_ANGELES_CLIPPERS,GOLDEN_STATE_WARRIORS,127,134,7440,7
7440,2018-02-24,2018-02-23,BOSTON_CELTICS,DETROIT_PISTONS,110,98,7441,12
7441,2018-02-24,2018-02-23,ATLANTA_HAWKS,INDIANA_PACERS,93,116,7442,23
7442,2018-02-24,2018-02-23,CHARLOTTE_HORNETS,WASHINGTON_WIZARDS,122,105,7443,17
7443,2018-02-24,2018-02-23,MILWAUKEE_BUCKS,TORONTO_RAPTORS,122,119,7444,3
7444,2018-02-24,2018-02-23,MINNESOTA_TIMBERWOLVES,HOUSTON_ROCKETS,102,120,7445,18
7445,2018-02-24,2018-02-23,CLEVELAND_CAVALIERS,MEMPHIS_GRIZZLIES,112,89,7446,23
7446,2018-02-24,2018-02-23,MIAMI_HEAT,NEW_ORLEANS_PELICANS,123,124,7447,1
7447,2018-02-24,2018-02-23,SAN_ANTONIO_SPURS,DENVER_NUGGETS,119,122,7448,3
7448,2018-02-24,2018-02-23,LOS_ANGELES_CLIPPERS,PHOENIX_SUNS,128,117,7449,11
7449,2018-02-24,2018-02-23,PORTLAND_TRAIL_BLAZERS,UTAH_JAZZ,100,81,7450,19
7450,2018-02-24,2018-02-23,DALLAS_MAVERICKS,LOS_ANGELES_LAKERS,102,124,7451,22
7451,2018-02-24,2018-02-23,ORLANDO_MAGIC,PHILADELPHIA_76ERS,105,116,7452,11
7452,2018-02-25,2018-02-24,MEMPHIS_GRIZZLIES,MIAMI_HEAT,89,115,7453,26
7453,2018-02-25,2018-02-24,BOSTON_CELTICS,NEW_YORK_KNICKS,121,112,7454,9
7454,2018-02-25,2018-02-24,OKLAHOMA_CITY_THUNDER,GOLDEN_STATE_WARRIORS,80,112,7455,32
7455,2018-02-25,2018-02-24,CHICAGO_BULLS,MINNESOTA_TIMBERWOLVES,104,122,7456,18
7456,2018-02-25,2018-02-24,PORTLAND_TRAIL_BLAZERS,PHOENIX_SUNS,106,104,7457,2
7457,2018-02-25,2018-02-24,DALLAS_MAVERICKS,UTAH_JAZZ,90,97,7458,7
7458,2018-02-25,2018-02-24,LOS_ANGELES_LAKERS,SACRAMENTO_KINGS,113,108,7459,5
7459,2018-02-25,2018-02-24,DETROIT_PISTONS,CHARLOTTE_HORNETS,98,114,7460,16
7460,2018-02-25,2018-02-24,NEW_ORLEANS_PELICANS,MILWAUKEE_BUCKS,123,121,7461,2
7461,2018-02-25,2018-02-24,SAN_ANTONIO_SPURS,CLEVELAND_CAVALIERS,110,94,7462,16
7462,2018-02-26,2018-02-25,HOUSTON_ROCKETS,DENVER_NUGGETS,119,114,7463,5
7463,2018-02-26,2018-02-25,PHILADELPHIA_76ERS,WASHINGTON_WIZARDS,94,109,7464,15
7464,2018-02-27,2018-02-26,LOS_ANGELES_LAKERS,ATLANTA_HAWKS,123,104,7465,19
7465,2018-02-27,2018-02-26,MEMPHIS_GRIZZLIES,BOSTON_CELTICS,98,109,7466,11
7466,2018-02-27,2018-02-26,CHICAGO_BULLS,BROOKLYN_NETS,87,104,7467,17
7467,2018-02-27,2018-02-26,GOLDEN_STATE_WARRIORS,NEW_YORK_KNICKS,125,111,7468,14
7468,2018-02-27,2018-02-26,DETROIT_PISTONS,TORONTO_RAPTORS,94,123,7469,29
7469,2018-02-27,2018-02-26,PHOENIX_SUNS,NEW_ORLEANS_PELICANS,116,125,7470,9
7470,2018-02-27,2018-02-26,ORLANDO_MAGIC,OKLAHOMA_CITY_THUNDER,105,112,7471,7
7471,2018-02-27,2018-02-26,INDIANA_PACERS,DALLAS_MAVERICKS,103,109,7472,6
7472,2018-02-27,2018-02-26,HOUSTON_ROCKETS,UTAH_JAZZ,96,85,7473,11
7473,2018-02-27,2018-02-26,MINNESOTA_TIMBERWOLVES,SACRAMENTO_KINGS,118,100,7474,18
7474,2018-02-28,2018-02-27,CHICAGO_BULLS,CHARLOTTE_HORNETS,103,118,7475,15
7475,2018-02-28,2018-02-27,BROOKLYN_NETS,CLEVELAND_CAVALIERS,123,129,7476,6
7476,2018-02-28,2018-02-27,PHILADELPHIA_76ERS,MIAMI_HEAT,101,102,7477,1
7477,2018-02-28,2018-02-27,WASHINGTON_WIZARDS,MILWAUKEE_BUCKS,107,104,7478,3
7478,2018-02-28,2018-02-27,SACRAMENTO_KINGS,PORTLAND_TRAIL_BLAZERS,99,116,7479,17
7479,2018-02-28,2018-02-27,LOS_ANGELES_CLIPPERS,DENVER_NUGGETS,122,120,7480,2
7480,2018-03-01,2018-02-28,MILWAUKEE_BUCKS,DETROIT_PISTONS,87,110,7481,23
7481,2018-03-01,2018-02-28,TORONTO_RAPTORS,ORLANDO_MAGIC,117,104,7482,13
7482,2018-03-01,2018-02-28,INDIANA_PACERS,ATLANTA_HAWKS,102,107,7483,5
7483,2018-03-01,2018-02-28,CHARLOTTE_HORNETS,BOSTON_CELTICS,106,134,7484,28
7484,2018-03-01,2018-02-28,PHOENIX_SUNS,MEMPHIS_GRIZZLIES,110,102,7485,8
7485,2018-03-01,2018-02-28,GOLDEN_STATE_WARRIORS,WASHINGTON_WIZARDS,109,101,7486,8
7486,2018-03-01,2018-02-28,OKLAHOMA_CITY_THUNDER,DALLAS_MAVERICKS,111,110,7487,1
7487,2018-03-01,2018-02-28,NEW_ORLEANS_PELICANS,SAN_ANTONIO_SPURS,121,116,7488,5
7488,2018-03-01,2018-02-28,HOUSTON_ROCKETS,LOS_ANGELES_CLIPPERS,105,92,7489,13
7489,2018-03-02,2018-03-01,LOS_ANGELES_LAKERS,MIAMI_HEAT,131,113,7490,18
7490,2018-03-02,2018-03-01,PHILADELPHIA_76ERS,CLEVELAND_CAVALIERS,108,97,7491,11
7491,2018-03-02,2018-03-01,BROOKLYN_NETS,SACRAMENTO_KINGS,111,116,7492,5
7492,2018-03-02,2018-03-01,MINNESOTA_TIMBERWOLVES,PORTLAND_TRAIL_BLAZERS,99,108,7493,9
7493,2018-03-03,2018-03-02,DETROIT_PISTONS,ORLANDO_MAGIC,106,115,7494,9
7494,2018-03-03,2018-03-02,CHARLOTTE_HORNETS,PHILADELPHIA_76ERS,99,110,7495,11
7495,2018-03-03,2018-03-02,GOLDEN_STATE_WARRIORS,ATLANTA_HAWKS,114,109,7496,5
7496,2018-03-03,2018-03-02,DALLAS_MAVERICKS,CHICAGO_BULLS,100,108,7497,8
7497,2018-03-03,2018-03-02,DENVER_NUGGETS,MEMPHIS_GRIZZLIES,108,102,7498,6
7498,2018-03-03,2018-03-02,INDIANA_PACERS,MILWAUKEE_BUCKS,103,96,7499,7
7499,2018-03-03,2018-03-02,TORONTO_RAPTORS,WASHINGTON_WIZARDS,102,95,7500,7
7500,2018-03-03,2018-03-02,OKLAHOMA_CITY_THUNDER,PHOENIX_SUNS,124,116,7501,8
7501,2018-03-03,2018-03-02,NEW_YORK_KNICKS,LOS_ANGELES_CLIPPERS,105,128,7502,23
7502,2018-03-03,2018-03-02,MINNESOTA_TIMBERWOLVES,UTAH_JAZZ,108,116,7503,8
7503,2018-03-04,2018-03-03,MEMPHIS_GRIZZLIES,ORLANDO_MAGIC,100,107,7504,7
7504,2018-03-04,2018-03-03,DENVER_NUGGETS,CLEVELAND_CAVALIERS,126,117,7505,9
7505,2018-03-04,2018-03-03,DETROIT_PISTONS,MIAMI_HEAT,96,105,7506,9
7506,2018-03-04,2018-03-03,BOSTON_CELTICS,HOUSTON_ROCKETS,120,123,7507,3
7507,2018-03-04,2018-03-03,LOS_ANGELES_LAKERS,SAN_ANTONIO_SPURS,116,112,7508,4
7508,2018-03-04,2018-03-03,OKLAHOMA_CITY_THUNDER,PORTLAND_TRAIL_BLAZERS,100,108,7509,8
7509,2018-03-04,2018-03-03,UTAH_JAZZ,SACRAMENTO_KINGS,98,91,7510,7
7510,2018-03-04,2018-03-03,PHOENIX_SUNS,ATLANTA_HAWKS,112,113,7511,1
7511,2018-03-04,2018-03-03,CHARLOTTE_HORNETS,TORONTO_RAPTORS,98,103,7512,5
7512,2018-03-04,2018-03-03,INDIANA_PACERS,WASHINGTON_WIZARDS,98,95,7513,3
7513,2018-03-05,2018-03-04,NEW_ORLEANS_PELICANS,DALLAS_MAVERICKS,126,109,7514,17
7514,2018-03-05,2018-03-04,PHILADELPHIA_76ERS,MILWAUKEE_BUCKS,110,118,7515,8
7515,2018-03-05,2018-03-04,BROOKLYN_NETS,LOS_ANGELES_CLIPPERS,120,123,7516,3
7516,2018-03-05,2018-03-04,NEW_YORK_KNICKS,SACRAMENTO_KINGS,99,102,7517,3
7517,2018-03-06,2018-03-05,DETROIT_PISTONS,CLEVELAND_CAVALIERS,90,112,7518,22
7518,2018-03-06,2018-03-05,MILWAUKEE_BUCKS,INDIANA_PACERS,89,92,7519,3
7519,2018-03-06,2018-03-05,PHOENIX_SUNS,MIAMI_HEAT,103,125,7520,22
7520,2018-03-06,2018-03-05,BOSTON_CELTICS,CHICAGO_BULLS,105,89,7521,16
7521,2018-03-06,2018-03-05,MEMPHIS_GRIZZLIES,SAN_ANTONIO_SPURS,98,100,7522,2
7522,2018-03-06,2018-03-05,ORLANDO_MAGIC,UTAH_JAZZ,80,94,7523,14
7523,2018-03-06,2018-03-05,PORTLAND_TRAIL_BLAZERS,LOS_ANGELES_LAKERS,108,103,7524,5
7524,2018-03-07,2018-03-06,PHILADELPHIA_76ERS,CHARLOTTE_HORNETS,128,114,7525,14
7525,2018-03-07,2018-03-06,ATLANTA_HAWKS,TORONTO_RAPTORS,90,106,7526,16
7526,2018-03-07,2018-03-06,MIAMI_HEAT,WASHINGTON_WIZARDS,113,117,7527,4
7527,2018-03-07,2018-03-06,HOUSTON_ROCKETS,OKLAHOMA_CITY_THUNDER,122,112,7528,10
7528,2018-03-07,2018-03-06,DENVER_NUGGETS,DALLAS_MAVERICKS,107,118,7529,11
7529,2018-03-07,2018-03-06,NEW_YORK_KNICKS,PORTLAND_TRAIL_BLAZERS,87,111,7530,24
7530,2018-03-07,2018-03-06,BROOKLYN_NETS,GOLDEN_STATE_WARRIORS,101,114,7531,13
7531,2018-03-07,2018-03-06,NEW_ORLEANS_PELICANS,LOS_ANGELES_CLIPPERS,121,116,7532,5
7532,2018-03-08,2018-03-07,UTAH_JAZZ,INDIANA_PACERS,104,84,7533,20
7533,2018-03-08,2018-03-07,MEMPHIS_GRIZZLIES,CHICAGO_BULLS,110,119,7534,9
7534,2018-03-08,2018-03-07,TORONTO_RAPTORS,DETROIT_PISTONS,121,119,7535,2
7535,2018-03-08,2018-03-07,HOUSTON_ROCKETS,MILWAUKEE_BUCKS,110,99,7536,11
7536,2018-03-08,2018-03-07,NEW_ORLEANS_PELICANS,SACRAMENTO_KINGS,114,101,7537,13
7537,2018-03-08,2018-03-07,CLEVELAND_CAVALIERS,DENVER_NUGGETS,113,108,7538,5
7538,2018-03-08,2018-03-07,ORLANDO_MAGIC,LOS_ANGELES_LAKERS,107,108,7539,1
7539,2018-03-09,2018-03-08,BROOKLYN_NETS,CHARLOTTE_HORNETS,125,111,7540,14
7540,2018-03-09,2018-03-08,PHILADELPHIA_76ERS,MIAMI_HEAT,99,108,7541,9
7541,2018-03-09,2018-03-08,BOSTON_CELTICS,MINNESOTA_TIMBERWOLVES,117,109,7542,8
7542,2018-03-09,2018-03-08,PHOENIX_SUNS,OKLAHOMA_CITY_THUNDER,87,115,7543,28
7543,2018-03-09,2018-03-08,SAN_ANTONIO_SPURS,GOLDEN_STATE_WARRIORS,107,110,7544,3
7544,2018-03-10,2018-03-09,CHICAGO_BULLS,DETROIT_PISTONS,83,99,7545,16
7545,2018-03-10,2018-03-09,ATLANTA_HAWKS,INDIANA_PACERS,87,112,7546,25
7546,2018-03-10,2018-03-09,HOUSTON_ROCKETS,TORONTO_RAPTORS,105,108,7547,3
7547,2018-03-10,2018-03-09,UTAH_JAZZ,MEMPHIS_GRIZZLIES,95,78,7548,17
7548,2018-03-10,2018-03-09,NEW_YORK_KNICKS,MILWAUKEE_BUCKS,112,120,7549,8
7549,2018-03-10,2018-03-09,WASHINGTON_WIZARDS,NEW_ORLEANS_PELICANS,116,97,7550,19
7550,2018-03-10,2018-03-09,LOS_ANGELES_LAKERS,DENVER_NUGGETS,116,125,7551,9
7551,2018-03-10,2018-03-09,GOLDEN_STATE_WARRIORS,PORTLAND_TRAIL_BLAZERS,108,125,7552,17
7552,2018-03-10,2018-03-09,ORLANDO_MAGIC,SACRAMENTO_KINGS,88,94,7553,6
7553,2018-03-10,2018-03-09,CLEVELAND_CAVALIERS,LOS_ANGELES_CLIPPERS,102,116,7554,14
7554,2018-03-10,2018-03-09,PHOENIX_SUNS,CHARLOTTE_HORNETS,115,122,7555,7
7555,2018-03-11,2018-03-10,WASHINGTON_WIZARDS,MIAMI_HEAT,102,129,7556,27
7556,2018-03-11,2018-03-10,MEMPHIS_GRIZZLIES,DALLAS_MAVERICKS,80,114,7557,34
7557,2018-03-11,2018-03-10,SAN_ANTONIO_SPURS,OKLAHOMA_CITY_THUNDER,94,104,7558,10
7558,2018-03-11,2018-03-10,ORLANDO_MAGIC,LOS_ANGELES_CLIPPERS,105,113,7559,8
7559,2018-03-11,2018-03-10,TORONTO_RAPTORS,NEW_YORK_KNICKS,132,106,7560,26
7560,2018-03-11,2018-03-10,CHICAGO_BULLS,ATLANTA_HAWKS,129,122,7561,7
7561,2018-03-11,2018-03-10,GOLDEN_STATE_WARRIORS,MINNESOTA_TIMBERWOLVES,103,109,7562,6
7562,2018-03-11,2018-03-10,UTAH_JAZZ,NEW_ORLEANS_PELICANS,116,99,7563,17
7563,2018-03-11,2018-03-10,SACRAMENTO_KINGS,DENVER_NUGGETS,104,130,7564,26
7564,2018-03-11,2018-03-10,HOUSTON_ROCKETS,DALLAS_MAVERICKS,105,82,7565,23
7565,2018-03-11,2018-03-10,INDIANA_PACERS,BOSTON_CELTICS,99,97,7566,2
7566,2018-03-11,2018-03-10,PHILADELPHIA_76ERS,BROOKLYN_NETS,120,97,7567,23
7567,2018-03-12,2018-03-11,CLEVELAND_CAVALIERS,LOS_ANGELES_LAKERS,113,127,7568,14
7568,2018-03-13,2018-03-12,SAN_ANTONIO_SPURS,HOUSTON_ROCKETS,93,109,7569,16
7569,2018-03-13,2018-03-12,MILWAUKEE_BUCKS,MEMPHIS_GRIZZLIES,121,103,7570,18
7570,2018-03-13,2018-03-12,SACRAMENTO_KINGS,OKLAHOMA_CITY_THUNDER,101,106,7571,5
7571,2018-03-13,2018-03-12,MIAMI_HEAT,PORTLAND_TRAIL_BLAZERS,99,115,7572,16
7572,2018-03-13,2018-03-12,INDIANA_PACERS,PHILADELPHIA_76ERS,101,98,7573,3
7573,2018-03-13,2018-03-12,MINNESOTA_TIMBERWOLVES,WASHINGTON_WIZARDS,116,111,7574,5
7574,2018-03-13,2018-03-12,OKLAHOMA_CITY_THUNDER,ATLANTA_HAWKS,119,107,7575,12
7575,2018-03-13,2018-03-12,TORONTO_RAPTORS,BROOKLYN_NETS,116,102,7576,14
7576,2018-03-13,2018-03-12,DALLAS_MAVERICKS,NEW_YORK_KNICKS,110,97,7577,13
7577,2018-03-14,2018-03-13,LOS_ANGELES_CLIPPERS,CHICAGO_BULLS,112,106,7578,6
7578,2018-03-14,2018-03-13,CHARLOTTE_HORNETS,NEW_ORLEANS_PELICANS,115,119,7579,4
7579,2018-03-14,2018-03-13,ORLANDO_MAGIC,SAN_ANTONIO_SPURS,72,108,7580,36
7580,2018-03-14,2018-03-13,DETROIT_PISTONS,UTAH_JAZZ,79,110,7581,31
7581,2018-03-14,2018-03-13,CLEVELAND_CAVALIERS,PHOENIX_SUNS,129,107,7582,22
7582,2018-03-14,2018-03-13,DENVER_NUGGETS,LOS_ANGELES_LAKERS,103,112,7583,9
7583,2018-03-14,2018-03-13,MILWAUKEE_BUCKS,ORLANDO_MAGIC,117,126,7584,9
7584,2018-03-15,2018-03-14,WASHINGTON_WIZARDS,BOSTON_CELTICS,125,124,7585,1
7585,2018-03-15,2018-03-14,MIAMI_HEAT,SACRAMENTO_KINGS,119,123,7586,4
7586,2018-03-15,2018-03-14,LOS_ANGELES_LAKERS,GOLDEN_STATE_WARRIORS,106,117,7587,11
7587,2018-03-15,2018-03-14,TORONTO_RAPTORS,INDIANA_PACERS,106,99,7588,7
7588,2018-03-15,2018-03-14,CHARLOTTE_HORNETS,ATLANTA_HAWKS,129,117,7589,12
7589,2018-03-15,2018-03-14,PHILADELPHIA_76ERS,NEW_YORK_KNICKS,118,110,7590,8
7590,2018-03-16,2018-03-15,LOS_ANGELES_CLIPPERS,HOUSTON_ROCKETS,96,101,7591,5
7591,2018-03-16,2018-03-15,CHICAGO_BULLS,MEMPHIS_GRIZZLIES,111,110,7592,1
7592,2018-03-16,2018-03-15,NEW_ORLEANS_PELICANS,SAN_ANTONIO_SPURS,93,98,7593,5
7593,2018-03-16,2018-03-15,DETROIT_PISTONS,DENVER_NUGGETS,113,120,7594,7
7594,2018-03-16,2018-03-15,PHOENIX_SUNS,UTAH_JAZZ,88,116,7595,28
7595,2018-03-16,2018-03-15,CLEVELAND_CAVALIERS,PORTLAND_TRAIL_BLAZERS,105,113,7596,8
7596,2018-03-16,2018-03-15,BOSTON_CELTICS,ORLANDO_MAGIC,92,83,7597,9
7597,2018-03-16,2018-03-15,BROOKLYN_NETS,PHILADELPHIA_76ERS,116,120,7598,4
7598,2018-03-16,2018-03-15,DALLAS_MAVERICKS,TORONTO_RAPTORS,115,122,7599,7
7599,2018-03-17,2018-03-16,LOS_ANGELES_CLIPPERS,OKLAHOMA_CITY_THUNDER,113,121,7600,8
7600,2018-03-17,2018-03-16,SACRAMENTO_KINGS,GOLDEN_STATE_WARRIORS,98,93,7601,5
7601,2018-03-17,2018-03-16,MIAMI_HEAT,LOS_ANGELES_LAKERS,92,91,7602,1
7602,2018-03-17,2018-03-16,ATLANTA_HAWKS,MILWAUKEE_BUCKS,117,122,7603,5
7603,2018-03-17,2018-03-16,HOUSTON_ROCKETS,NEW_ORLEANS_PELICANS,107,101,7604,6
7604,2018-03-17,2018-03-16,INDIANA_PACERS,WASHINGTON_WIZARDS,102,109,7605,7
7605,2018-03-17,2018-03-16,DALLAS_MAVERICKS,BROOKLYN_NETS,106,114,7606,8
7606,2018-03-17,2018-03-16,CHARLOTTE_HORNETS,NEW_YORK_KNICKS,101,124,7607,23
7607,2018-03-18,2018-03-17,CLEVELAND_CAVALIERS,CHICAGO_BULLS,114,109,7608,5
7608,2018-03-18,2018-03-17,DENVER_NUGGETS,MEMPHIS_GRIZZLIES,94,101,7609,7
7609,2018-03-18,2018-03-17,MINNESOTA_TIMBERWOLVES,SAN_ANTONIO_SPURS,101,117,7610,16
7610,2018-03-18,2018-03-17,SACRAMENTO_KINGS,UTAH_JAZZ,97,103,7611,6
7611,2018-03-18,2018-03-17,GOLDEN_STATE_WARRIORS,PHOENIX_SUNS,124,109,7612,15
7612,2018-03-18,2018-03-17,DETROIT_PISTONS,PORTLAND_TRAIL_BLAZERS,87,100,7613,13
7613,2018-03-18,2018-03-17,OKLAHOMA_CITY_THUNDER,TORONTO_RAPTORS,132,125,7614,7
7614,2018-03-18,2018-03-17,BOSTON_CELTICS,NEW_ORLEANS_PELICANS,89,108,7615,19
7615,2018-03-18,2018-03-17,HOUSTON_ROCKETS,MINNESOTA_TIMBERWOLVES,129,120,7616,9
7616,2018-03-19,2018-03-18,PORTLAND_TRAIL_BLAZERS,LOS_ANGELES_CLIPPERS,122,109,7617,13
7617,2018-03-19,2018-03-18,MILWAUKEE_BUCKS,CLEVELAND_CAVALIERS,117,124,7618,7
7618,2018-03-19,2018-03-18,LOS_ANGELES_LAKERS,INDIANA_PACERS,100,110,7619,10
7619,2018-03-19,2018-03-18,CHARLOTTE_HORNETS,PHILADELPHIA_76ERS,94,108,7620,14
7620,2018-03-19,2018-03-18,MEMPHIS_GRIZZLIES,BROOKLYN_NETS,115,118,7621,3
7621,2018-03-19,2018-03-18,DENVER_NUGGETS,MIAMI_HEAT,141,149,7622,8
7622,2018-03-19,2018-03-18,CHICAGO_BULLS,NEW_YORK_KNICKS,92,110,7623,18
7623,2018-03-20,2018-03-19,GOLDEN_STATE_WARRIORS,SAN_ANTONIO_SPURS,75,89,7624,14
7624,2018-03-20,2018-03-19,DETROIT_PISTONS,SACRAMENTO_KINGS,106,90,7625,16
7625,2018-03-20,2018-03-19,TORONTO_RAPTORS,ORLANDO_MAGIC,93,86,7626,7
7626,2018-03-21,2018-03-20,OKLAHOMA_CITY_THUNDER,BOSTON_CELTICS,99,100,7627,1
7627,2018-03-21,2018-03-20,LOS_ANGELES_CLIPPERS,MINNESOTA_TIMBERWOLVES,109,123,7628,14
7628,2018-03-21,2018-03-20,DALLAS_MAVERICKS,NEW_ORLEANS_PELICANS,105,115,7629,10
7629,2018-03-21,2018-03-20,ATLANTA_HAWKS,UTAH_JAZZ,99,94,7630,5
7630,2018-03-21,2018-03-20,DETROIT_PISTONS,PHOENIX_SUNS,115,88,7631,27
7631,2018-03-21,2018-03-20,HOUSTON_ROCKETS,PORTLAND_TRAIL_BLAZERS,115,111,7632,4
7632,2018-03-21,2018-03-20,TORONTO_RAPTORS,CLEVELAND_CAVALIERS,129,132,7633,3
7633,2018-03-21,2018-03-20,MEMPHIS_GRIZZLIES,PHILADELPHIA_76ERS,105,119,7634,14
7634,2018-03-21,2018-03-20,CHARLOTTE_HORNETS,BROOKLYN_NETS,111,105,7635,6
7635,2018-03-21,2018-03-20,NEW_YORK_KNICKS,MIAMI_HEAT,98,119,7636,21
7636,2018-03-22,2018-03-21,DENVER_NUGGETS,CHICAGO_BULLS,135,102,7637,33
7637,2018-03-22,2018-03-21,LOS_ANGELES_CLIPPERS,MILWAUKEE_BUCKS,127,120,7638,7
7638,2018-03-22,2018-03-21,INDIANA_PACERS,NEW_ORLEANS_PELICANS,92,96,7639,4
7639,2018-03-22,2018-03-21,WASHINGTON_WIZARDS,SAN_ANTONIO_SPURS,90,98,7640,8
7640,2018-03-22,2018-03-21,MEMPHIS_GRIZZLIES,CHARLOTTE_HORNETS,79,140,7641,61
7641,2018-03-22,2018-03-21,PHILADELPHIA_76ERS,ORLANDO_MAGIC,118,98,7642,20
7642,2018-03-23,2018-03-22,DETROIT_PISTONS,HOUSTON_ROCKETS,96,100,7643,4
7643,2018-03-23,2018-03-22,LOS_ANGELES_LAKERS,NEW_ORLEANS_PELICANS,125,128,7644,3
7644,2018-03-23,2018-03-22,UTAH_JAZZ,DALLAS_MAVERICKS,119,112,7645,7
7645,2018-03-23,2018-03-22,ATLANTA_HAWKS,SACRAMENTO_KINGS,90,105,7646,15
7646,2018-03-23,2018-03-22,LOS_ANGELES_CLIPPERS,INDIANA_PACERS,104,109,7647,5
7647,2018-03-23,2018-03-22,DENVER_NUGGETS,WASHINGTON_WIZARDS,108,100,7648,8
7648,2018-03-23,2018-03-22,PHOENIX_SUNS,CLEVELAND_CAVALIERS,95,120,7649,25
7649,2018-03-23,2018-03-22,MINNESOTA_TIMBERWOLVES,NEW_YORK_KNICKS,108,104,7650,4
7650,2018-03-23,2018-03-22,BROOKLYN_NETS,TORONTO_RAPTORS,112,116,7651,4
7651,2018-03-24,2018-03-23,MILWAUKEE_BUCKS,CHICAGO_BULLS,118,105,7652,13
7652,2018-03-24,2018-03-23,MIAMI_HEAT,OKLAHOMA_CITY_THUNDER,99,105,7653,6
7653,2018-03-24,2018-03-23,UTAH_JAZZ,SAN_ANTONIO_SPURS,120,124,7654,4
7654,2018-03-24,2018-03-23,BOSTON_CELTICS,PORTLAND_TRAIL_BLAZERS,105,100,7655,5
7655,2018-03-24,2018-03-23,ATLANTA_HAWKS,GOLDEN_STATE_WARRIORS,94,106,7656,12
7656,2018-03-24,2018-03-23,MINNESOTA_TIMBERWOLVES,PHILADELPHIA_76ERS,108,120,7657,12
7657,2018-03-24,2018-03-23,CHICAGO_BULLS,DETROIT_PISTONS,95,117,7658,22
7658,2018-03-24,2018-03-23,PHOENIX_SUNS,ORLANDO_MAGIC,99,105,7659,6
7659,2018-03-25,2018-03-24,NEW_ORLEANS_PELICANS,HOUSTON_ROCKETS,91,114,7660,23
7660,2018-03-25,2018-03-24,LOS_ANGELES_LAKERS,MEMPHIS_GRIZZLIES,100,93,7661,7
7661,2018-03-25,2018-03-24,CHARLOTTE_HORNETS,DALLAS_MAVERICKS,102,98,7662,4
7662,2018-03-25,2018-03-24,CLEVELAND_CAVALIERS,BROOKLYN_NETS,121,114,7663,7
7663,2018-03-25,2018-03-24,SAN_ANTONIO_SPURS,MILWAUKEE_BUCKS,103,106,7664,3
7664,2018-03-25,2018-03-24,MIAMI_HEAT,INDIANA_PACERS,107,113,7665,6
7665,2018-03-25,2018-03-24,BOSTON_CELTICS,SACRAMENTO_KINGS,104,93,7666,11
7666,2018-03-25,2018-03-24,LOS_ANGELES_CLIPPERS,TORONTO_RAPTORS,117,106,7667,11
7667,2018-03-25,2018-03-24,NEW_YORK_KNICKS,WASHINGTON_WIZARDS,101,97,7668,4
7668,2018-03-25,2018-03-24,PORTLAND_TRAIL_BLAZERS,OKLAHOMA_CITY_THUNDER,108,105,7669,3
7669,2018-03-26,2018-03-25,ATLANTA_HAWKS,HOUSTON_ROCKETS,99,118,7670,19
7670,2018-03-26,2018-03-25,UTAH_JAZZ,GOLDEN_STATE_WARRIORS,110,91,7671,19
7671,2018-03-26,2018-03-25,NEW_YORK_KNICKS,CHARLOTTE_HORNETS,128,137,7672,9
7672,2018-03-26,2018-03-25,LOS_ANGELES_LAKERS,DETROIT_PISTONS,106,112,7673,6
7673,2018-03-26,2018-03-25,DENVER_NUGGETS,PHILADELPHIA_76ERS,104,123,7674,19
7674,2018-03-27,2018-03-26,MEMPHIS_GRIZZLIES,MINNESOTA_TIMBERWOLVES,101,93,7675,8
7675,2018-03-27,2018-03-26,BOSTON_CELTICS,PHOENIX_SUNS,102,94,7676,8
7676,2018-03-27,2018-03-26,SAN_ANTONIO_SPURS,WASHINGTON_WIZARDS,106,116,7677,10
7677,2018-03-27,2018-03-26,DENVER_NUGGETS,TORONTO_RAPTORS,110,114,7678,4
7678,2018-03-28,2018-03-27,CHICAGO_BULLS,HOUSTON_ROCKETS,86,118,7679,32
7679,2018-03-28,2018-03-27,CLEVELAND_CAVALIERS,MIAMI_HEAT,79,98,7680,19
7680,2018-03-28,2018-03-27,PORTLAND_TRAIL_BLAZERS,NEW_ORLEANS_PELICANS,107,103,7681,4
7681,2018-03-28,2018-03-27,DALLAS_MAVERICKS,SACRAMENTO_KINGS,103,97,7682,6
7682,2018-03-28,2018-03-27,INDIANA_PACERS,GOLDEN_STATE_WARRIORS,92,81,7683,11
7683,2018-03-28,2018-03-27,MILWAUKEE_BUCKS,LOS_ANGELES_CLIPPERS,98,105,7684,7
7684,2018-03-28,2018-03-27,CLEVELAND_CAVALIERS,CHARLOTTE_HORNETS,118,105,7685,13
7685,2018-03-28,2018-03-27,BROOKLYN_NETS,ORLANDO_MAGIC,111,104,7686,7
7686,2018-03-28,2018-03-27,NEW_YORK_KNICKS,PHILADELPHIA_76ERS,101,118,7687,17
7687,2018-03-29,2018-03-28,PORTLAND_TRAIL_BLAZERS,MEMPHIS_GRIZZLIES,103,108,7688,5
7688,2018-03-29,2018-03-28,ATLANTA_HAWKS,MINNESOTA_TIMBERWOLVES,114,126,7689,12
7689,2018-03-29,2018-03-28,BOSTON_CELTICS,UTAH_JAZZ,97,94,7690,3
7690,2018-03-29,2018-03-28,LOS_ANGELES_CLIPPERS,PHOENIX_SUNS,111,99,7691,12
7691,2018-03-29,2018-03-28,DALLAS_MAVERICKS,LOS_ANGELES_LAKERS,93,103,7692,10
7692,2018-03-29,2018-03-28,WASHINGTON_WIZARDS,DETROIT_PISTONS,92,103,7693,11
7693,2018-03-29,2018-03-28,CHICAGO_BULLS,MIAMI_HEAT,92,103,7694,11
7694,2018-03-30,2018-03-29,OKLAHOMA_CITY_THUNDER,SAN_ANTONIO_SPURS,99,103,7695,4
7695,2018-03-30,2018-03-29,INDIANA_PACERS,SACRAMENTO_KINGS,106,103,7696,3
7696,2018-03-30,2018-03-29,MILWAUKEE_BUCKS,GOLDEN_STATE_WARRIORS,116,107,7697,9
7697,2018-03-30,2018-03-29,CHICAGO_BULLS,ORLANDO_MAGIC,90,82,7698,8
7698,2018-03-30,2018-03-29,PHILADELPHIA_76ERS,ATLANTA_HAWKS,101,91,7699,10
7699,2018-03-31,2018-03-30,NEW_ORLEANS_PELICANS,CLEVELAND_CAVALIERS,102,107,7700,5
7700,2018-03-31,2018-03-30,PHOENIX_SUNS,HOUSTON_ROCKETS,103,104,7701,1
7701,2018-03-31,2018-03-30,DENVER_NUGGETS,OKLAHOMA_CITY_THUNDER,126,125,7702,1
7702,2018-03-31,2018-03-30,MINNESOTA_TIMBERWOLVES,DALLAS_MAVERICKS,93,92,7703,1
7703,2018-03-31,2018-03-30,MEMPHIS_GRIZZLIES,UTAH_JAZZ,97,107,7704,10
7704,2018-03-31,2018-03-30,MILWAUKEE_BUCKS,LOS_ANGELES_LAKERS,124,122,7705,2
7705,2018-03-31,2018-03-30,LOS_ANGELES_CLIPPERS,PORTLAND_TRAIL_BLAZERS,96,105,7706,9
7706,2018-03-31,2018-03-30,CHARLOTTE_HORNETS,WASHINGTON_WIZARDS,93,107,7707,14
7707,2018-03-31,2018-03-30,DETROIT_PISTONS,NEW_YORK_KNICKS,115,109,7708,6
7708,2018-03-31,2018-03-30,TORONTO_RAPTORS,BOSTON_CELTICS,99,110,7709,11
7709,2018-04-01,2018-03-31,BROOKLYN_NETS,MIAMI_HEAT,110,109,7710,1
7710,2018-04-01,2018-03-31,GOLDEN_STATE_WARRIORS,SACRAMENTO_KINGS,112,96,7711,16
7711,2018-04-01,2018-03-31,PHILADELPHIA_76ERS,CHARLOTTE_HORNETS,119,102,7712,17
7712,2018-04-01,2018-03-31,WASHINGTON_WIZARDS,CHICAGO_BULLS,94,113,7713,19
7713,2018-04-01,2018-03-31,INDIANA_PACERS,LOS_ANGELES_CLIPPERS,111,104,7714,7
7714,2018-04-01,2018-03-31,HOUSTON_ROCKETS,SAN_ANTONIO_SPURS,83,100,7715,17
7715,2018-04-01,2018-03-31,ORLANDO_MAGIC,ATLANTA_HAWKS,88,94,7716,6
7716,2018-04-01,2018-03-31,DETROIT_PISTONS,BROOKLYN_NETS,108,96,7717,12
7717,2018-04-01,2018-03-31,DALLAS_MAVERICKS,CLEVELAND_CAVALIERS,87,98,7718,11
7718,2018-04-01,2018-03-31,OKLAHOMA_CITY_THUNDER,NEW_ORLEANS_PELICANS,109,104,7719,5
7719,2018-04-01,2018-03-31,UTAH_JAZZ,MINNESOTA_TIMBERWOLVES,121,97,7720,24
7720,2018-04-02,2018-04-01,MILWAUKEE_BUCKS,DENVER_NUGGETS,125,128,7721,3
7721,2018-04-02,2018-04-01,PHOENIX_SUNS,GOLDEN_STATE_WARRIORS,107,117,7722,10
7722,2018-04-02,2018-04-01,MEMPHIS_GRIZZLIES,PORTLAND_TRAIL_BLAZERS,98,113,7723,15
7723,2018-04-02,2018-04-01,SACRAMENTO_KINGS,LOS_ANGELES_LAKERS,84,83,7724,1
7724,2018-04-03,2018-04-02,TORONTO_RAPTORS,CLEVELAND_CAVALIERS,106,112,7725,6
7725,2018-04-03,2018-04-02,BROOKLYN_NETS,PHILADELPHIA_76ERS,95,121,7726,26
7726,2018-04-03,2018-04-02,ATLANTA_HAWKS,MIAMI_HEAT,98,101,7727,3
7727,2018-04-03,2018-04-02,ORLANDO_MAGIC,NEW_YORK_KNICKS,97,73,7728,24
7728,2018-04-04,2018-04-03,CHARLOTTE_HORNETS,CHICAGO_BULLS,114,120,7729,6
7729,2018-04-04,2018-04-03,WASHINGTON_WIZARDS,HOUSTON_ROCKETS,104,120,7730,16
7730,2018-04-04,2018-04-03,BOSTON_CELTICS,MILWAUKEE_BUCKS,102,106,7731,4
7731,2018-04-04,2018-04-03,GOLDEN_STATE_WARRIORS,OKLAHOMA_CITY_THUNDER,111,107,7732,4
7732,2018-04-04,2018-04-03,PORTLAND_TRAIL_BLAZERS,DALLAS_MAVERICKS,109,115,7733,6
7733,2018-04-04,2018-04-03,INDIANA_PACERS,DENVER_NUGGETS,104,107,7734,3
7734,2018-04-04,2018-04-03,LOS_ANGELES_LAKERS,UTAH_JAZZ,110,117,7735,7
7735,2018-04-04,2018-04-03,SACRAMENTO_KINGS,PHOENIX_SUNS,94,97,7736,3
7736,2018-04-04,2018-04-03,SAN_ANTONIO_SPURS,LOS_ANGELES_CLIPPERS,110,113,7737,3
7737,2018-04-04,2018-04-03,PHILADELPHIA_76ERS,DETROIT_PISTONS,115,108,7738,7
7738,2018-04-04,2018-04-03,DALLAS_MAVERICKS,ORLANDO_MAGIC,100,105,7739,5
7739,2018-04-04,2018-04-03,MIAMI_HEAT,ATLANTA_HAWKS,115,86,7740,29
7740,2018-04-05,2018-04-04,MEMPHIS_GRIZZLIES,NEW_ORLEANS_PELICANS,95,123,7741,28
7741,2018-04-05,2018-04-04,BOSTON_CELTICS,TORONTO_RAPTORS,78,96,7742,18
7742,2018-04-05,2018-04-04,SAN_ANTONIO_SPURS,LOS_ANGELES_LAKERS,112,122,7743,10
7743,2018-04-05,2018-04-04,GOLDEN_STATE_WARRIORS,INDIANA_PACERS,106,126,7744,20
7744,2018-04-06,2018-04-05,WASHINGTON_WIZARDS,CLEVELAND_CAVALIERS,115,119,7745,4
7745,2018-04-06,2018-04-05,PORTLAND_TRAIL_BLAZERS,HOUSTON_ROCKETS,94,96,7746,2
7746,2018-04-06,2018-04-05,BROOKLYN_NETS,MILWAUKEE_BUCKS,119,111,7747,8
7747,2018-04-06,2018-04-05,LOS_ANGELES_CLIPPERS,UTAH_JAZZ,95,117,7748,22
7748,2018-04-06,2018-04-05,MINNESOTA_TIMBERWOLVES,DENVER_NUGGETS,96,100,7749,4
7749,2018-04-06,2018-04-05,DALLAS_MAVERICKS,DETROIT_PISTONS,106,113,7750,7
7750,2018-04-06,2018-04-05,CHARLOTTE_HORNETS,ORLANDO_MAGIC,137,100,7751,37
7751,2018-04-06,2018-04-05,CLEVELAND_CAVALIERS,PHILADELPHIA_76ERS,130,132,7752,2
7752,2018-04-06,2018-04-05,ATLANTA_HAWKS,WASHINGTON_WIZARDS,103,97,7753,6
7753,2018-04-06,2018-04-05,CHICAGO_BULLS,BOSTON_CELTICS,104,111,7754,7
7754,2018-04-06,2018-04-05,MIAMI_HEAT,NEW_YORK_KNICKS,98,122,7755,24
7755,2018-04-06,2018-04-05,INDIANA_PACERS,TORONTO_RAPTORS,73,92,7756,19
7756,2018-04-07,2018-04-06,SACRAMENTO_KINGS,MEMPHIS_GRIZZLIES,94,93,7757,1
7757,2018-04-07,2018-04-06,NEW_ORLEANS_PELICANS,PHOENIX_SUNS,122,103,7758,19
7758,2018-04-07,2018-04-06,MINNESOTA_TIMBERWOLVES,LOS_ANGELES_LAKERS,113,96,7759,17
7759,2018-04-07,2018-04-06,DENVER_NUGGETS,LOS_ANGELES_CLIPPERS,134,115,7760,19
7760,2018-04-07,2018-04-06,MILWAUKEE_BUCKS,NEW_YORK_KNICKS,115,102,7761,13
7761,2018-04-08,2018-04-07,BROOKLYN_NETS,CHICAGO_BULLS,124,96,7762,28
7762,2018-04-08,2018-04-07,NEW_ORLEANS_PELICANS,GOLDEN_STATE_WARRIORS,126,120,7763,6
7763,2018-04-08,2018-04-07,OKLAHOMA_CITY_THUNDER,HOUSTON_ROCKETS,108,102,7764,6
7764,2018-04-08,2018-04-07,PORTLAND_TRAIL_BLAZERS,SAN_ANTONIO_SPURS,105,116,7765,11
7765,2018-04-08,2018-04-07,ATLANTA_HAWKS,BOSTON_CELTICS,112,106,7766,6
7766,2018-04-08,2018-04-07,INDIANA_PACERS,CHARLOTTE_HORNETS,123,117,7767,6
7767,2018-04-08,2018-04-07,DALLAS_MAVERICKS,PHILADELPHIA_76ERS,97,109,7768,12
7768,2018-04-08,2018-04-07,DETROIT_PISTONS,MEMPHIS_GRIZZLIES,117,130,7769,13
7769,2018-04-08,2018-04-07,UTAH_JAZZ,LOS_ANGELES_LAKERS,112,97,7770,15
7770,2018-04-08,2018-04-07,ORLANDO_MAGIC,TORONTO_RAPTORS,101,112,7771,11
7771,2018-04-09,2018-04-08,GOLDEN_STATE_WARRIORS,PHOENIX_SUNS,117,100,7772,17
7772,2018-04-09,2018-04-08,TORONTO_RAPTORS,DETROIT_PISTONS,108,98,7773,10
7773,2018-04-09,2018-04-08,CHICAGO_BULLS,BROOKLYN_NETS,105,114,7774,9
7774,2018-04-09,2018-04-08,OKLAHOMA_CITY_THUNDER,MIAMI_HEAT,115,93,7775,22
7775,2018-04-09,2018-04-08,CLEVELAND_CAVALIERS,NEW_YORK_KNICKS,123,109,7776,14
7776,2018-04-10,2018-04-09,ORLANDO_MAGIC,MILWAUKEE_BUCKS,86,102,7777,16
7777,2018-04-10,2018-04-09,MEMPHIS_GRIZZLIES,MINNESOTA_TIMBERWOLVES,94,113,7778,19
7778,2018-04-10,2018-04-09,SACRAMENTO_KINGS,SAN_ANTONIO_SPURS,85,98,7779,13
7779,2018-04-10,2018-04-09,PORTLAND_TRAIL_BLAZERS,DENVER_NUGGETS,82,88,7780,6
7780,2018-04-10,2018-04-09,NEW_ORLEANS_PELICANS,LOS_ANGELES_CLIPPERS,113,100,7781,13
7781,2018-04-10,2018-04-09,CHARLOTTE_HORNETS,INDIANA_PACERS,119,93,7782,26
7782,2018-04-10,2018-04-09,PHILADELPHIA_76ERS,ATLANTA_HAWKS,121,113,7783,8
7783,2018-04-11,2018-04-10,BOSTON_CELTICS,WASHINGTON_WIZARDS,101,113,7784,12
7784,2018-04-11,2018-04-10,PHOENIX_SUNS,DALLAS_MAVERICKS,124,97,7785,27
7785,2018-04-11,2018-04-10,GOLDEN_STATE_WARRIORS,UTAH_JAZZ,79,119,7786,40
7786,2018-04-11,2018-04-10,HOUSTON_ROCKETS,LOS_ANGELES_LAKERS,105,99,7787,6
7787,2018-04-12,2018-04-11,BROOKLYN_NETS,BOSTON_CELTICS,97,110,7788,13
7788,2018-04-12,2018-04-11,DETROIT_PISTONS,CHICAGO_BULLS,119,87,7789,32
7789,2018-04-12,2018-04-11,NEW_YORK_KNICKS,CLEVELAND_CAVALIERS,110,98,7790,12
7790,2018-04-12,2018-04-11,TORONTO_RAPTORS,MIAMI_HEAT,109,116,7791,7
7791,2018-04-12,2018-04-11,DENVER_NUGGETS,MINNESOTA_TIMBERWOLVES,106,112,7792,6
7792,2018-04-12,2018-04-11,SAN_ANTONIO_SPURS,NEW_ORLEANS_PELICANS,98,122,7793,24
7793,2018-04-12,2018-04-11,MEMPHIS_GRIZZLIES,OKLAHOMA_CITY_THUNDER,123,137,7794,14
7794,2018-04-12,2018-04-11,WASHINGTON_WIZARDS,ORLANDO_MAGIC,92,101,7795,9
7795,2018-04-12,2018-04-11,MILWAUKEE_BUCKS,PHILADELPHIA_76ERS,95,130,7796,35
7796,2018-04-12,2018-04-11,LOS_ANGELES_LAKERS,LOS_ANGELES_CLIPPERS,115,100,7797,15
7797,2018-04-12,2018-04-11,UTAH_JAZZ,PORTLAND_TRAIL_BLAZERS,93,102,7798,9
7798,2018-04-12,2018-04-11,HOUSTON_ROCKETS,SACRAMENTO_KINGS,83,96,7799,13
7799,2018-04-14,2018-04-13,SAN_ANTONIO_SPURS,GOLDEN_STATE_WARRIORS,92,113,7800,21
7800,2018-04-14,2018-04-13,WASHINGTON_WIZARDS,TORONTO_RAPTORS,106,114,7801,8
7801,2018-04-15,2018-04-14,MIAMI_HEAT,PHILADELPHIA_76ERS,103,130,7802,27
7802,2018-04-15,2018-04-14,NEW_ORLEANS_PELICANS,PORTLAND_TRAIL_BLAZERS,97,95,7803,2
7803,2018-04-15,2018-04-14,MILWAUKEE_BUCKS,BOSTON_CELTICS,107,113,7804,6
7804,2018-04-15,2018-04-14,INDIANA_PACERS,CLEVELAND_CAVALIERS,98,80,7805,18
7805,2018-04-15,2018-04-14,UTAH_JAZZ,OKLAHOMA_CITY_THUNDER,108,116,7806,8
7806,2018-04-16,2018-04-15,MINNESOTA_TIMBERWOLVES,HOUSTON_ROCKETS,101,104,7807,3
7807,2018-04-17,2018-04-16,MIAMI_HEAT,PHILADELPHIA_76ERS,113,103,7808,10
7808,2018-04-17,2018-04-16,SAN_ANTONIO_SPURS,GOLDEN_STATE_WARRIORS,101,116,7809,15
7809,2018-04-17,2018-04-16,WASHINGTON_WIZARDS,TORONTO_RAPTORS,119,130,7810,11
7810,2018-04-18,2018-04-17,MILWAUKEE_BUCKS,BOSTON_CELTICS,106,120,7811,14
7811,2018-04-18,2018-04-17,NEW_ORLEANS_PELICANS,PORTLAND_TRAIL_BLAZERS,111,102,7812,9
7812,2018-04-18,2018-04-17,INDIANA_PACERS,CLEVELAND_CAVALIERS,97,100,7813,3
7813,2018-04-19,2018-04-18,UTAH_JAZZ,OKLAHOMA_CITY_THUNDER,102,95,7814,7
7814,2018-04-19,2018-04-18,MINNESOTA_TIMBERWOLVES,HOUSTON_ROCKETS,82,102,7815,20
7815,2018-04-19,2018-04-18,PHILADELPHIA_76ERS,MIAMI_HEAT,128,108,7816,20
7816,2018-04-20,2018-04-19,PORTLAND_TRAIL_BLAZERS,NEW_ORLEANS_PELICANS,102,119,7817,17
7817,2018-04-20,2018-04-19,GOLDEN_STATE_WARRIORS,SAN_ANTONIO_SPURS,110,97,7818,13
7818,2018-04-20,2018-04-19,CLEVELAND_CAVALIERS,INDIANA_PACERS,90,92,7819,2
7819,2018-04-21,2018-04-20,TORONTO_RAPTORS,WASHINGTON_WIZARDS,103,122,7820,19
7820,2018-04-21,2018-04-20,BOSTON_CELTICS,MILWAUKEE_BUCKS,92,116,7821,24
7821,2018-04-21,2018-04-20,PHILADELPHIA_76ERS,MIAMI_HEAT,106,102,7822,4
7822,2018-04-21,2018-04-20,PORTLAND_TRAIL_BLAZERS,NEW_ORLEANS_PELICANS,123,131,7823,8
7823,2018-04-21,2018-04-20,HOUSTON_ROCKETS,MINNESOTA_TIMBERWOLVES,105,121,7824,16
7824,2018-04-22,2018-04-21,OKLAHOMA_CITY_THUNDER,UTAH_JAZZ,102,115,7825,13
7825,2018-04-22,2018-04-21,BOSTON_CELTICS,MILWAUKEE_BUCKS,102,104,7826,2
7826,2018-04-22,2018-04-21,GOLDEN_STATE_WARRIORS,SAN_ANTONIO_SPURS,90,103,7827,13
7827,2018-04-22,2018-04-21,TORONTO_RAPTORS,WASHINGTON_WIZARDS,98,106,7828,8
7828,2018-04-23,2018-04-22,CLEVELAND_CAVALIERS,INDIANA_PACERS,104,100,7829,4
7829,2018-04-24,2018-04-23,HOUSTON_ROCKETS,MINNESOTA_TIMBERWOLVES,119,100,7830,19
7830,2018-04-24,2018-04-23,OKLAHOMA_CITY_THUNDER,UTAH_JAZZ,96,113,7831,17
7831,2018-04-24,2018-04-23,MILWAUKEE_BUCKS,BOSTON_CELTICS,87,92,7832,5
7832,2018-04-25,2018-04-24,MIAMI_HEAT,PHILADELPHIA_76ERS,91,104,7833,13
7833,2018-04-25,2018-04-24,SAN_ANTONIO_SPURS,GOLDEN_STATE_WARRIORS,91,99,7834,8
7834,2018-04-25,2018-04-24,INDIANA_PACERS,CLEVELAND_CAVALIERS,95,98,7835,3
7835,2018-04-25,2018-04-24,WASHINGTON_WIZARDS,TORONTO_RAPTORS,98,108,7836,10
7836,2018-04-26,2018-04-25,MINNESOTA_TIMBERWOLVES,HOUSTON_ROCKETS,104,122,7837,18
7837,2018-04-26,2018-04-25,UTAH_JAZZ,OKLAHOMA_CITY_THUNDER,99,107,7838,8
7838,2018-04-27,2018-04-26,BOSTON_CELTICS,MILWAUKEE_BUCKS,86,97,7839,11
7839,2018-04-27,2018-04-26,TORONTO_RAPTORS,WASHINGTON_WIZARDS,102,92,7840,10
7840,2018-04-28,2018-04-27,CLEVELAND_CAVALIERS,INDIANA_PACERS,87,121,7841,34
7841,2018-04-28,2018-04-27,OKLAHOMA_CITY_THUNDER,UTAH_JAZZ,91,96,7842,5
7842,2018-04-29,2018-04-28,MILWAUKEE_BUCKS,BOSTON_CELTICS,96,112,7843,16
7843,2018-04-29,2018-04-28,NEW_ORLEANS_PELICANS,GOLDEN_STATE_WARRIORS,101,123,7844,22
7844,2018-04-29,2018-04-28,INDIANA_PACERS,CLEVELAND_CAVALIERS,101,105,7845,4
7845,2018-04-29,2018-04-28,UTAH_JAZZ,HOUSTON_ROCKETS,96,110,7846,14
7846,2018-05-01,2018-04-30,PHILADELPHIA_76ERS,BOSTON_CELTICS,101,117,7847,16
7847,2018-05-02,2018-05-01,CLEVELAND_CAVALIERS,TORONTO_RAPTORS,113,112,7848,1
7848,2018-05-02,2018-05-01,NEW_ORLEANS_PELICANS,GOLDEN_STATE_WARRIORS,116,121,7849,5
7849,2018-05-03,2018-05-02,UTAH_JAZZ,HOUSTON_ROCKETS,116,108,7850,8
7850,2018-05-03,2018-05-02,CLEVELAND_CAVALIERS,TORONTO_RAPTORS,128,110,7851,18
7851,2018-05-04,2018-05-03,PHILADELPHIA_76ERS,BOSTON_CELTICS,103,108,7852,5
7852,2018-05-05,2018-05-04,GOLDEN_STATE_WARRIORS,NEW_ORLEANS_PELICANS,100,119,7853,19
7853,2018-05-05,2018-05-04,HOUSTON_ROCKETS,UTAH_JAZZ,113,92,7854,21
7854,2018-05-05,2018-05-04,BOSTON_CELTICS,PHILADELPHIA_76ERS,101,98,7855,3
7855,2018-05-06,2018-05-05,TORONTO_RAPTORS,CLEVELAND_CAVALIERS,103,105,7856,2
7856,2018-05-06,2018-05-05,GOLDEN_STATE_WARRIORS,NEW_ORLEANS_PELICANS,118,92,7857,26
7857,2018-05-07,2018-05-06,HOUSTON_ROCKETS,UTAH_JAZZ,100,87,7858,13
7858,2018-05-07,2018-05-06,BOSTON_CELTICS,PHILADELPHIA_76ERS,92,103,7859,11
7859,2018-05-08,2018-05-07,TORONTO_RAPTORS,CLEVELAND_CAVALIERS,93,128,7860,35
7860,2018-05-09,2018-05-08,UTAH_JAZZ,HOUSTON_ROCKETS,102,112,7861,10
7861,2018-05-09,2018-05-08,NEW_ORLEANS_PELICANS,GOLDEN_STATE_WARRIORS,104,113,7862,9
7862,2018-05-10,2018-05-09,PHILADELPHIA_76ERS,BOSTON_CELTICS,112,114,7863,2
7863,2018-05-13,2018-05-12,CLEVELAND_CAVALIERS,BOSTON_CELTICS,83,108,7864,25
7864,2018-05-15,2018-05-14,GOLDEN_STATE_WARRIORS,HOUSTON_ROCKETS,119,106,7865,13
7865,2018-05-16,2018-05-15,CLEVELAND_CAVALIERS,BOSTON_CELTICS,94,107,7866,13
7866,2018-05-17,2018-05-16,GOLDEN_STATE_WARRIORS,HOUSTON_ROCKETS,105,127,7867,22
7867,2018-05-20,2018-05-19,BOSTON_CELTICS,CLEVELAND_CAVALIERS,86,116,7868,30
7868,2018-05-21,2018-05-20,HOUSTON_ROCKETS,GOLDEN_STATE_WARRIORS,85,126,7869,41
7869,2018-05-22,2018-05-21,BOSTON_CELTICS,CLEVELAND_CAVALIERS,102,111,7870,9
7870,2018-05-23,2018-05-22,HOUSTON_ROCKETS,GOLDEN_STATE_WARRIORS,95,92,7871,3
7871,2018-05-24,2018-05-23,CLEVELAND_CAVALIERS,BOSTON_CELTICS,83,96,7872,13
7872,2018-05-25,2018-05-24,GOLDEN_STATE_WARRIORS,HOUSTON_ROCKETS,94,98,7873,4
7873,2018-05-26,2018-05-25,BOSTON_CELTICS,CLEVELAND_CAVALIERS,99,109,7874,10
7874,2018-05-27,2018-05-26,HOUSTON_ROCKETS,GOLDEN_STATE_WARRIORS,86,115,7875,29
7875,2018-05-28,2018-05-27,CLEVELAND_CAVALIERS,BOSTON_CELTICS,87,79,7876,8
7876,2018-05-29,2018-05-28,GOLDEN_STATE_WARRIORS,HOUSTON_ROCKETS,101,92,7877,9
7877,2018-06-01,2018-05-31,CLEVELAND_CAVALIERS,GOLDEN_STATE_WARRIORS,114,124,7878,10
7878,2018-06-04,2018-06-03,CLEVELAND_CAVALIERS,GOLDEN_STATE_WARRIORS,103,122,7879,19
7879,2018-06-07,2018-06-06,GOLDEN_STATE_WARRIORS,CLEVELAND_CAVALIERS,110,102,7880,8
7880,2018-06-09,2018-06-08,GOLDEN_STATE_WARRIORS,CLEVELAND_CAVALIERS,108,85,7881,23
7881,2018-10-17,2018-10-16,PHILADELPHIA_76ERS,BOSTON_CELTICS,87,105,7882,18
7882,2018-10-17,2018-10-16,OKLAHOMA_CITY_THUNDER,GOLDEN_STATE_WARRIORS,100,108,7883,8
7883,2018-10-17,2018-10-16,MILWAUKEE_BUCKS,CHARLOTTE_HORNETS,113,112,7884,1
7884,2018-10-17,2018-10-16,BROOKLYN_NETS,DETROIT_PISTONS,100,103,7885,3
7885,2018-10-17,2018-10-16,MEMPHIS_GRIZZLIES,INDIANA_PACERS,83,111,7886,28
7886,2018-10-17,2018-10-16,MIAMI_HEAT,ORLANDO_MAGIC,101,104,7887,3
7887,2018-10-17,2018-10-16,ATLANTA_HAWKS,NEW_YORK_KNICKS,107,126,7888,19
7888,2018-10-17,2018-10-16,CLEVELAND_CAVALIERS,TORONTO_RAPTORS,104,116,7889,12
7889,2018-10-18,2018-10-17,NEW_ORLEANS_PELICANS,HOUSTON_ROCKETS,131,112,7890,19
7890,2018-10-18,2018-10-17,MINNESOTA_TIMBERWOLVES,SAN_ANTONIO_SPURS,108,112,7891,4
7891,2018-10-18,2018-10-17,UTAH_JAZZ,SACRAMENTO_KINGS,123,117,7892,6
7892,2018-10-18,2018-10-17,DENVER_NUGGETS,LOS_ANGELES_CLIPPERS,107,98,7893,9
7893,2018-10-18,2018-10-17,DALLAS_MAVERICKS,PHOENIX_SUNS,100,121,7894,21
7894,2018-10-19,2018-10-18,CHICAGO_BULLS,PHILADELPHIA_76ERS,108,127,7895,19
7895,2018-10-19,2018-10-18,MIAMI_HEAT,WASHINGTON_WIZARDS,113,112,7896,1
7896,2018-10-19,2018-10-18,LOS_ANGELES_LAKERS,PORTLAND_TRAIL_BLAZERS,119,128,7897,9
7897,2018-10-19,2018-10-18,CHARLOTTE_HORNETS,ORLANDO_MAGIC,120,88,7898,32
7898,2018-10-19,2018-10-18,NEW_YORK_KNICKS,BROOKLYN_NETS,105,107,7899,2
7899,2018-10-20,2018-10-19,ATLANTA_HAWKS,MEMPHIS_GRIZZLIES,117,131,7900,14
7900,2018-10-20,2018-10-19,CLEVELAND_CAVALIERS,MINNESOTA_TIMBERWOLVES,123,131,7901,8
7901,2018-10-20,2018-10-19,SACRAMENTO_KINGS,NEW_ORLEANS_PELICANS,129,149,7902,20
7902,2018-10-20,2018-10-19,BOSTON_CELTICS,TORONTO_RAPTORS,101,113,7903,12
7903,2018-10-20,2018-10-19,INDIANA_PACERS,MILWAUKEE_BUCKS,101,118,7904,17
7904,2018-10-20,2018-10-19,OKLAHOMA_CITY_THUNDER,LOS_ANGELES_CLIPPERS,92,108,7905,16
7905,2018-10-20,2018-10-19,GOLDEN_STATE_WARRIORS,UTAH_JAZZ,124,123,7906,1
7906,2018-10-20,2018-10-19,BROOKLYN_NETS,INDIANA_PACERS,112,132,7907,20
7907,2018-10-20,2018-10-19,TORONTO_RAPTORS,WASHINGTON_WIZARDS,117,113,7908,4
7908,2018-10-20,2018-10-19,BOSTON_CELTICS,NEW_YORK_KNICKS,103,101,7909,2
7909,2018-10-20,2018-10-19,ORLANDO_MAGIC,PHILADELPHIA_76ERS,115,116,7910,1
7910,2018-10-21,2018-10-20,DETROIT_PISTONS,CHICAGO_BULLS,118,116,7911,2
7911,2018-10-21,2018-10-20,CHARLOTTE_HORNETS,MIAMI_HEAT,113,112,7912,1
7912,2018-10-21,2018-10-20,MINNESOTA_TIMBERWOLVES,DALLAS_MAVERICKS,136,140,7913,4
7913,2018-10-21,2018-10-20,PHOENIX_SUNS,DENVER_NUGGETS,91,119,7914,28
7914,2018-10-21,2018-10-20,SAN_ANTONIO_SPURS,PORTLAND_TRAIL_BLAZERS,108,121,7915,13
7915,2018-10-21,2018-10-20,HOUSTON_ROCKETS,LOS_ANGELES_LAKERS,124,115,7916,9
7916,2018-10-21,2018-10-20,ATLANTA_HAWKS,CLEVELAND_CAVALIERS,133,111,7917,22
7917,2018-10-21,2018-10-20,SACRAMENTO_KINGS,OKLAHOMA_CITY_THUNDER,131,120,7918,11
7918,2018-10-22,2018-10-21,GOLDEN_STATE_WARRIORS,DENVER_NUGGETS,98,100,7919,2
7919,2018-10-22,2018-10-21,HOUSTON_ROCKETS,LOS_ANGELES_CLIPPERS,112,115,7920,3
7920,2018-10-22,2018-10-21,ORLANDO_MAGIC,BOSTON_CELTICS,93,90,7921,3
7921,2018-10-22,2018-10-21,CHARLOTTE_HORNETS,TORONTO_RAPTORS,106,127,7922,21
7922,2018-10-23,2018-10-22,NEW_YORK_KNICKS,MILWAUKEE_BUCKS,113,124,7923,11
7923,2018-10-23,2018-10-22,INDIANA_PACERS,MINNESOTA_TIMBERWOLVES,91,101,7924,10
7924,2018-10-23,2018-10-22,CHICAGO_BULLS,DALLAS_MAVERICKS,109,115,7925,6
7925,2018-10-23,2018-10-22,MEMPHIS_GRIZZLIES,UTAH_JAZZ,92,84,7926,8
7926,2018-10-23,2018-10-22,WASHINGTON_WIZARDS,PORTLAND_TRAIL_BLAZERS,125,124,7927,1
7927,2018-10-23,2018-10-22,PHOENIX_SUNS,GOLDEN_STATE_WARRIORS,103,123,7928,20
7928,2018-10-23,2018-10-22,SAN_ANTONIO_SPURS,LOS_ANGELES_LAKERS,143,142,7929,1
7929,2018-10-23,2018-10-22,PHILADELPHIA_76ERS,DETROIT_PISTONS,132,133,7930,1
7930,2018-10-24,2018-10-23,LOS_ANGELES_CLIPPERS,NEW_ORLEANS_PELICANS,109,116,7931,7
7931,2018-10-24,2018-10-23,SACRAMENTO_KINGS,DENVER_NUGGETS,112,126,7932,14
7932,2018-10-24,2018-10-23,DALLAS_MAVERICKS,ATLANTA_HAWKS,104,111,7933,7
7933,2018-10-24,2018-10-23,BROOKLYN_NETS,CLEVELAND_CAVALIERS,102,86,7934,16
7934,2018-10-24,2018-10-23,NEW_YORK_KNICKS,MIAMI_HEAT,87,110,7935,23
7935,2018-10-24,2018-10-23,MINNESOTA_TIMBERWOLVES,TORONTO_RAPTORS,105,112,7936,7
7936,2018-10-25,2018-10-24,CHARLOTTE_HORNETS,CHICAGO_BULLS,110,112,7937,2
7937,2018-10-25,2018-10-24,UTAH_JAZZ,HOUSTON_ROCKETS,100,89,7938,11
7938,2018-10-25,2018-10-24,INDIANA_PACERS,SAN_ANTONIO_SPURS,116,96,7939,20
7939,2018-10-25,2018-10-24,PHILADELPHIA_76ERS,MILWAUKEE_BUCKS,108,123,7940,15
7940,2018-10-25,2018-10-24,LOS_ANGELES_LAKERS,PHOENIX_SUNS,131,113,7941,18
7941,2018-10-25,2018-10-24,MEMPHIS_GRIZZLIES,SACRAMENTO_KINGS,92,97,7942,5
7942,2018-10-25,2018-10-24,WASHINGTON_WIZARDS,GOLDEN_STATE_WARRIORS,122,144,7943,22
7943,2018-10-25,2018-10-24,CLEVELAND_CAVALIERS,DETROIT_PISTONS,103,110,7944,7
7944,2018-10-25,2018-10-24,PORTLAND_TRAIL_BLAZERS,ORLANDO_MAGIC,128,114,7945,14
7945,2018-10-26,2018-10-25,BOSTON_CELTICS,OKLAHOMA_CITY_THUNDER,101,95,7946,6
7946,2018-10-26,2018-10-25,DENVER_NUGGETS,LOS_ANGELES_LAKERS,114,121,7947,7
7947,2018-10-26,2018-10-25,CHICAGO_BULLS,CHARLOTTE_HORNETS,106,135,7948,29
7948,2018-10-26,2018-10-25,GOLDEN_STATE_WARRIORS,NEW_YORK_KNICKS,128,100,7949,28
7949,2018-10-26,2018-10-25,DALLAS_MAVERICKS,TORONTO_RAPTORS,107,116,7950,9
7950,2018-10-27,2018-10-26,LOS_ANGELES_CLIPPERS,HOUSTON_ROCKETS,133,113,7951,20
7951,2018-10-27,2018-10-26,MILWAUKEE_BUCKS,MINNESOTA_TIMBERWOLVES,125,95,7952,30
7952,2018-10-27,2018-10-26,BROOKLYN_NETS,NEW_ORLEANS_PELICANS,115,117,7953,2
7953,2018-10-27,2018-10-26,WASHINGTON_WIZARDS,SACRAMENTO_KINGS,112,116,7954,4
7954,2018-10-27,2018-10-26,BOSTON_CELTICS,DETROIT_PISTONS,109,89,7955,20
7955,2018-10-27,2018-10-26,UTAH_JAZZ,NEW_ORLEANS_PELICANS,132,111,7956,21
7956,2018-10-27,2018-10-26,CHICAGO_BULLS,ATLANTA_HAWKS,97,85,7957,12
7957,2018-10-27,2018-10-26,INDIANA_PACERS,CLEVELAND_CAVALIERS,119,107,7958,12
7958,2018-10-27,2018-10-26,CHARLOTTE_HORNETS,PHILADELPHIA_76ERS,103,105,7959,2
7959,2018-10-28,2018-10-27,PHOENIX_SUNS,MEMPHIS_GRIZZLIES,96,117,7960,21
7960,2018-10-28,2018-10-27,PORTLAND_TRAIL_BLAZERS,MIAMI_HEAT,111,120,7961,9
7961,2018-10-28,2018-10-27,ORLANDO_MAGIC,MILWAUKEE_BUCKS,91,113,7962,22
7962,2018-10-28,2018-10-27,LOS_ANGELES_LAKERS,SAN_ANTONIO_SPURS,106,110,7963,4
7963,2018-10-28,2018-10-27,GOLDEN_STATE_WARRIORS,BROOKLYN_NETS,120,114,7964,6
7964,2018-10-28,2018-10-27,UTAH_JAZZ,DALLAS_MAVERICKS,113,104,7965,9
7965,2018-10-28,2018-10-27,PHOENIX_SUNS,OKLAHOMA_CITY_THUNDER,110,117,7966,7
7966,2018-10-29,2018-10-28,WASHINGTON_WIZARDS,LOS_ANGELES_CLIPPERS,104,136,7967,32
7967,2018-10-29,2018-10-28,PORTLAND_TRAIL_BLAZERS,INDIANA_PACERS,103,93,7968,10
7968,2018-10-29,2018-10-28,ATLANTA_HAWKS,PHILADELPHIA_76ERS,92,113,7969,21
7969,2018-10-29,2018-10-28,SACRAMENTO_KINGS,MIAMI_HEAT,123,113,7970,10
7970,2018-10-29,2018-10-28,BROOKLYN_NETS,NEW_YORK_KNICKS,96,115,7971,19
7971,2018-10-30,2018-10-29,GOLDEN_STATE_WARRIORS,CHICAGO_BULLS,149,124,7972,25
7972,2018-10-30,2018-10-29,TORONTO_RAPTORS,MILWAUKEE_BUCKS,109,124,7973,15
7973,2018-10-30,2018-10-29,LOS_ANGELES_LAKERS,MINNESOTA_TIMBERWOLVES,120,124,7974,4
7974,2018-10-30,2018-10-29,DALLAS_MAVERICKS,SAN_ANTONIO_SPURS,108,113,7975,5
7975,2018-10-30,2018-10-29,NEW_ORLEANS_PELICANS,DENVER_NUGGETS,111,116,7976,5
7976,2018-10-30,2018-10-29,MIAMI_HEAT,CHARLOTTE_HORNETS,113,125,7977,12
7977,2018-10-30,2018-10-29,ATLANTA_HAWKS,CLEVELAND_CAVALIERS,114,136,7978,22
7978,2018-10-30,2018-10-29,SACRAMENTO_KINGS,ORLANDO_MAGIC,107,99,7979,8
7979,2018-10-30,2018-10-29,DETROIT_PISTONS,BOSTON_CELTICS,105,108,7980,3
7980,2018-10-30,2018-10-29,PHILADELPHIA_76ERS,TORONTO_RAPTORS,112,129,7981,17
7981,2018-10-31,2018-10-30,PORTLAND_TRAIL_BLAZERS,HOUSTON_ROCKETS,104,85,7982,19
7982,2018-10-31,2018-10-30,WASHINGTON_WIZARDS,MEMPHIS_GRIZZLIES,95,107,7983,12
7983,2018-10-31,2018-10-30,LOS_ANGELES_CLIPPERS,OKLAHOMA_CITY_THUNDER,110,128,7984,18
7984,2018-10-31,2018-10-30,DETROIT_PISTONS,BROOKLYN_NETS,119,120,7985,1
7985,2018-11-01,2018-10-31,DENVER_NUGGETS,CHICAGO_BULLS,108,107,7986,1
7986,2018-11-01,2018-10-31,UTAH_JAZZ,MINNESOTA_TIMBERWOLVES,125,128,7987,3
7987,2018-11-01,2018-10-31,INDIANA_PACERS,NEW_YORK_KNICKS,107,101,7988,6
7988,2018-11-01,2018-10-31,NEW_ORLEANS_PELICANS,GOLDEN_STATE_WARRIORS,121,131,7989,10
7989,2018-11-01,2018-10-31,DALLAS_MAVERICKS,LOS_ANGELES_LAKERS,113,114,7990,1
7990,2018-11-01,2018-10-31,SAN_ANTONIO_SPURS,PHOENIX_SUNS,120,90,7991,30
7991,2018-11-01,2018-10-31,OKLAHOMA_CITY_THUNDER,CHARLOTTE_HORNETS,111,107,7992,4
7992,2018-11-01,2018-10-31,DENVER_NUGGETS,CLEVELAND_CAVALIERS,110,91,7993,19
7993,2018-11-01,2018-10-31,LOS_ANGELES_CLIPPERS,PHILADELPHIA_76ERS,113,122,7994,9
7994,2018-11-01,2018-10-31,SACRAMENTO_KINGS,ATLANTA_HAWKS,146,115,7995,31
7995,2018-11-02,2018-11-01,MILWAUKEE_BUCKS,BOSTON_CELTICS,113,117,7996,4
7996,2018-11-02,2018-11-01,NEW_ORLEANS_PELICANS,PORTLAND_TRAIL_BLAZERS,119,132,7997,13
7997,2018-11-02,2018-11-01,LOS_ANGELES_CLIPPERS,ORLANDO_MAGIC,120,95,7998,25
7998,2018-11-02,2018-11-01,HOUSTON_ROCKETS,BROOKLYN_NETS,119,111,7999,8
7999,2018-11-03,2018-11-02,INDIANA_PACERS,CHICAGO_BULLS,107,105,8000,2
8000,2018-11-03,2018-11-02,OKLAHOMA_CITY_THUNDER,WASHINGTON_WIZARDS,134,111,8001,23
8001,2018-11-03,2018-11-02,NEW_YORK_KNICKS,DALLAS_MAVERICKS,118,106,8002,12
8002,2018-11-03,2018-11-02,MEMPHIS_GRIZZLIES,UTAH_JAZZ,110,100,8003,10
8003,2018-11-03,2018-11-02,TORONTO_RAPTORS,PHOENIX_SUNS,107,98,8004,9
8004,2018-11-03,2018-11-02,MINNESOTA_TIMBERWOLVES,GOLDEN_STATE_WARRIORS,99,116,8005,17
8005,2018-11-03,2018-11-02,DETROIT_PISTONS,PHILADELPHIA_76ERS,99,109,8006,10
8006,2018-11-03,2018-11-02,CLEVELAND_CAVALIERS,CHARLOTTE_HORNETS,94,126,8007,32
8007,2018-11-03,2018-11-02,BOSTON_CELTICS,INDIANA_PACERS,101,102,8008,1
8008,2018-11-03,2018-11-02,MIAMI_HEAT,ATLANTA_HAWKS,118,123,8009,5
8009,2018-11-04,2018-11-03,HOUSTON_ROCKETS,CHICAGO_BULLS,96,88,8010,8
8010,2018-11-04,2018-11-03,NEW_ORLEANS_PELICANS,SAN_ANTONIO_SPURS,95,109,8011,14
8011,2018-11-04,2018-11-03,UTAH_JAZZ,DENVER_NUGGETS,88,103,8012,15
8012,2018-11-04,2018-11-03,LOS_ANGELES_LAKERS,PORTLAND_TRAIL_BLAZERS,114,110,8013,4
8013,2018-11-04,2018-11-03,SACRAMENTO_KINGS,MILWAUKEE_BUCKS,109,144,8014,35
8014,2018-11-04,2018-11-03,PHILADELPHIA_76ERS,BROOKLYN_NETS,97,122,8015,25
8015,2018-11-04,2018-11-03,NEW_YORK_KNICKS,WASHINGTON_WIZARDS,95,108,8016,13
8016,2018-11-05,2018-11-04,ORLANDO_MAGIC,SAN_ANTONIO_SPURS,117,110,8017,7
8017,2018-11-05,2018-11-04,MEMPHIS_GRIZZLIES,PHOENIX_SUNS,100,102,8018,2
8018,2018-11-05,2018-11-04,MINNESOTA_TIMBERWOLVES,PORTLAND_TRAIL_BLAZERS,81,111,8019,30
8019,2018-11-05,2018-11-04,TORONTO_RAPTORS,LOS_ANGELES_LAKERS,121,107,8020,14
8020,2018-11-06,2018-11-05,MIAMI_HEAT,DETROIT_PISTONS,120,115,8021,5
8021,2018-11-06,2018-11-05,HOUSTON_ROCKETS,INDIANA_PACERS,98,94,8022,4
8022,2018-11-06,2018-11-05,CLEVELAND_CAVALIERS,ORLANDO_MAGIC,100,102,8023,2
8023,2018-11-06,2018-11-05,CHICAGO_BULLS,NEW_YORK_KNICKS,116,115,8024,1
8024,2018-11-06,2018-11-05,NEW_ORLEANS_PELICANS,OKLAHOMA_CITY_THUNDER,116,122,8025,6
8025,2018-11-06,2018-11-05,BOSTON_CELTICS,DENVER_NUGGETS,107,115,8026,8
8026,2018-11-06,2018-11-05,TORONTO_RAPTORS,UTAH_JAZZ,124,111,8027,13
8027,2018-11-06,2018-11-05,MEMPHIS_GRIZZLIES,GOLDEN_STATE_WARRIORS,101,117,8028,16
8028,2018-11-06,2018-11-05,MINNESOTA_TIMBERWOLVES,LOS_ANGELES_CLIPPERS,109,120,8029,11
8029,2018-11-07,2018-11-06,ATLANTA_HAWKS,CHARLOTTE_HORNETS,102,113,8030,11
8030,2018-11-07,2018-11-06,WASHINGTON_WIZARDS,DALLAS_MAVERICKS,100,119,8031,19
8031,2018-11-07,2018-11-06,BROOKLYN_NETS,PHOENIX_SUNS,104,82,8032,22
8032,2018-11-07,2018-11-06,MILWAUKEE_BUCKS,PORTLAND_TRAIL_BLAZERS,103,118,8033,15
8033,2018-11-08,2018-11-07,OKLAHOMA_CITY_THUNDER,CLEVELAND_CAVALIERS,95,86,8034,9
8034,2018-11-08,2018-11-07,DETROIT_PISTONS,ORLANDO_MAGIC,103,96,8035,7
8035,2018-11-08,2018-11-07,NEW_YORK_KNICKS,ATLANTA_HAWKS,112,107,8036,5
8036,2018-11-08,2018-11-07,SAN_ANTONIO_SPURS,MIAMI_HEAT,88,95,8037,7
8037,2018-11-08,2018-11-07,PHILADELPHIA_76ERS,INDIANA_PACERS,100,94,8038,6
8038,2018-11-08,2018-11-07,DENVER_NUGGETS,MEMPHIS_GRIZZLIES,87,89,8039,2
8039,2018-11-08,2018-11-07,CHICAGO_BULLS,NEW_ORLEANS_PELICANS,98,107,8040,9
8040,2018-11-08,2018-11-07,DALLAS_MAVERICKS,UTAH_JAZZ,102,117,8041,15
8041,2018-11-08,2018-11-07,TORONTO_RAPTORS,SACRAMENTO_KINGS,114,105,8042,9
8042,2018-11-08,2018-11-07,MINNESOTA_TIMBERWOLVES,LOS_ANGELES_LAKERS,110,114,8043,4
8043,2018-11-09,2018-11-08,HOUSTON_ROCKETS,OKLAHOMA_CITY_THUNDER,80,98,8044,18
8044,2018-11-09,2018-11-08,BOSTON_CELTICS,PHOENIX_SUNS,116,109,8045,7
8045,2018-11-09,2018-11-08,LOS_ANGELES_CLIPPERS,PORTLAND_TRAIL_BLAZERS,105,116,8046,11
8046,2018-11-09,2018-11-08,MILWAUKEE_BUCKS,GOLDEN_STATE_WARRIORS,134,111,8047,23
8047,2018-11-10,2018-11-09,WASHINGTON_WIZARDS,ORLANDO_MAGIC,108,117,8048,9
8048,2018-11-10,2018-11-09,CHARLOTTE_HORNETS,PHILADELPHIA_76ERS,132,133,8049,1
8049,2018-11-10,2018-11-09,DETROIT_PISTONS,ATLANTA_HAWKS,124,109,8050,15
8050,2018-11-10,2018-11-09,INDIANA_PACERS,MIAMI_HEAT,110,102,8051,8
8051,2018-11-10,2018-11-09,BROOKLYN_NETS,DENVER_NUGGETS,112,110,8052,2
8052,2018-11-10,2018-11-09,BOSTON_CELTICS,UTAH_JAZZ,115,123,8053,8
8053,2018-11-10,2018-11-09,MINNESOTA_TIMBERWOLVES,SACRAMENTO_KINGS,110,121,8054,11
8054,2018-11-10,2018-11-09,NEW_YORK_KNICKS,TORONTO_RAPTORS,112,128,8055,16
8055,2018-11-10,2018-11-09,MILWAUKEE_BUCKS,LOS_ANGELES_CLIPPERS,126,128,8056,2
8056,2018-11-11,2018-11-10,PHOENIX_SUNS,NEW_ORLEANS_PELICANS,99,119,8057,20
8057,2018-11-11,2018-11-10,CLEVELAND_CAVALIERS,CHICAGO_BULLS,98,99,8058,1
8058,2018-11-11,2018-11-10,PHILADELPHIA_76ERS,MEMPHIS_GRIZZLIES,106,112,8059,6
8059,2018-11-11,2018-11-10,WASHINGTON_WIZARDS,MIAMI_HEAT,116,110,8060,6
8060,2018-11-11,2018-11-10,BROOKLYN_NETS,GOLDEN_STATE_WARRIORS,100,116,8061,16
8061,2018-11-11,2018-11-10,HOUSTON_ROCKETS,SAN_ANTONIO_SPURS,89,96,8062,7
8062,2018-11-11,2018-11-10,OKLAHOMA_CITY_THUNDER,DALLAS_MAVERICKS,96,111,8063,15
8063,2018-11-11,2018-11-10,LOS_ANGELES_LAKERS,SACRAMENTO_KINGS,101,86,8064,15
8064,2018-11-11,2018-11-10,CHARLOTTE_HORNETS,DETROIT_PISTONS,113,103,8065,10
8065,2018-11-12,2018-11-11,INDIANA_PACERS,HOUSTON_ROCKETS,103,115,8066,12
8066,2018-11-12,2018-11-11,ORLANDO_MAGIC,NEW_YORK_KNICKS,115,89,8067,26
8067,2018-11-12,2018-11-11,MILWAUKEE_BUCKS,DENVER_NUGGETS,121,114,8068,7
8068,2018-11-12,2018-11-11,BOSTON_CELTICS,PORTLAND_TRAIL_BLAZERS,94,100,8069,6
8069,2018-11-12,2018-11-11,ATLANTA_HAWKS,LOS_ANGELES_LAKERS,106,107,8070,1
8070,2018-11-13,2018-11-12,ORLANDO_MAGIC,WASHINGTON_WIZARDS,109,117,8071,8
8071,2018-11-13,2018-11-12,PHILADELPHIA_76ERS,MIAMI_HEAT,124,114,8072,10
8072,2018-11-13,2018-11-12,NEW_ORLEANS_PELICANS,TORONTO_RAPTORS,126,110,8073,16
8073,2018-11-13,2018-11-12,DALLAS_MAVERICKS,CHICAGO_BULLS,103,98,8074,5
8074,2018-11-13,2018-11-12,UTAH_JAZZ,MEMPHIS_GRIZZLIES,96,88,8075,8
8075,2018-11-13,2018-11-12,BROOKLYN_NETS,MINNESOTA_TIMBERWOLVES,113,120,8076,7
8076,2018-11-13,2018-11-12,PHOENIX_SUNS,OKLAHOMA_CITY_THUNDER,101,118,8077,17
8077,2018-11-13,2018-11-12,SAN_ANTONIO_SPURS,SACRAMENTO_KINGS,99,104,8078,5
8078,2018-11-13,2018-11-12,GOLDEN_STATE_WARRIORS,LOS_ANGELES_CLIPPERS,116,121,8079,5
8079,2018-11-14,2018-11-13,CHARLOTTE_HORNETS,CLEVELAND_CAVALIERS,89,113,8080,24
8080,2018-11-14,2018-11-13,HOUSTON_ROCKETS,DENVER_NUGGETS,109,99,8081,10
8081,2018-11-14,2018-11-13,ATLANTA_HAWKS,GOLDEN_STATE_WARRIORS,103,110,8082,7
8082,2018-11-15,2018-11-14,PHILADELPHIA_76ERS,ORLANDO_MAGIC,106,111,8083,5
8083,2018-11-15,2018-11-14,CLEVELAND_CAVALIERS,WASHINGTON_WIZARDS,95,119,8084,24
8084,2018-11-15,2018-11-14,CHICAGO_BULLS,BOSTON_CELTICS,82,111,8085,29
8085,2018-11-15,2018-11-14,MIAMI_HEAT,BROOKLYN_NETS,120,107,8086,13
8086,2018-11-15,2018-11-14,DETROIT_PISTONS,TORONTO_RAPTORS,106,104,8087,2
8087,2018-11-15,2018-11-14,MEMPHIS_GRIZZLIES,MILWAUKEE_BUCKS,116,113,8088,3
8088,2018-11-15,2018-11-14,NEW_ORLEANS_PELICANS,MINNESOTA_TIMBERWOLVES,100,107,8089,7
8089,2018-11-15,2018-11-14,NEW_YORK_KNICKS,OKLAHOMA_CITY_THUNDER,103,128,8090,25
8090,2018-11-15,2018-11-14,UTAH_JAZZ,DALLAS_MAVERICKS,68,118,8091,50
8091,2018-11-15,2018-11-14,SAN_ANTONIO_SPURS,PHOENIX_SUNS,96,116,8092,20
8092,2018-11-15,2018-11-14,PORTLAND_TRAIL_BLAZERS,LOS_ANGELES_LAKERS,117,126,8093,9
8093,2018-11-16,2018-11-15,GOLDEN_STATE_WARRIORS,HOUSTON_ROCKETS,86,107,8094,21
8094,2018-11-16,2018-11-15,ATLANTA_HAWKS,DENVER_NUGGETS,93,138,8095,45
8095,2018-11-16,2018-11-15,SAN_ANTONIO_SPURS,LOS_ANGELES_CLIPPERS,111,116,8096,5
8096,2018-11-17,2018-11-16,TORONTO_RAPTORS,BOSTON_CELTICS,116,123,8097,7
8097,2018-11-17,2018-11-16,MIAMI_HEAT,INDIANA_PACERS,91,99,8098,8
8098,2018-11-17,2018-11-16,UTAH_JAZZ,PHILADELPHIA_76ERS,107,113,8099,6
8099,2018-11-17,2018-11-16,BROOKLYN_NETS,WASHINGTON_WIZARDS,115,104,8100,11
8100,2018-11-17,2018-11-16,SACRAMENTO_KINGS,MEMPHIS_GRIZZLIES,104,112,8101,8
8101,2018-11-17,2018-11-16,PORTLAND_TRAIL_BLAZERS,MINNESOTA_TIMBERWOLVES,96,112,8102,16
8102,2018-11-17,2018-11-16,NEW_YORK_KNICKS,NEW_ORLEANS_PELICANS,124,129,8103,5
8103,2018-11-17,2018-11-16,CHICAGO_BULLS,MILWAUKEE_BUCKS,104,123,8104,19
8104,2018-11-17,2018-11-16,LOS_ANGELES_CLIPPERS,BROOKLYN_NETS,127,119,8105,8
8105,2018-11-18,2018-11-17,PHILADELPHIA_76ERS,CHARLOTTE_HORNETS,122,119,8106,3
8106,2018-11-18,2018-11-17,ATLANTA_HAWKS,INDIANA_PACERS,89,97,8107,8
8107,2018-11-18,2018-11-17,DENVER_NUGGETS,NEW_ORLEANS_PELICANS,115,125,8108,10
8108,2018-11-18,2018-11-17,LOS_ANGELES_LAKERS,ORLANDO_MAGIC,117,130,8109,13
8109,2018-11-18,2018-11-17,UTAH_JAZZ,BOSTON_CELTICS,98,86,8110,12
8110,2018-11-18,2018-11-17,TORONTO_RAPTORS,CHICAGO_BULLS,122,83,8111,39
8111,2018-11-18,2018-11-17,SACRAMENTO_KINGS,HOUSTON_ROCKETS,112,132,8112,20
8112,2018-11-18,2018-11-17,GOLDEN_STATE_WARRIORS,DALLAS_MAVERICKS,109,112,8113,3
8113,2018-11-18,2018-11-17,OKLAHOMA_CITY_THUNDER,PHOENIX_SUNS,110,100,8114,10
8114,2018-11-18,2018-11-17,MEMPHIS_GRIZZLIES,MINNESOTA_TIMBERWOLVES,100,87,8115,13
8115,2018-11-18,2018-11-17,LOS_ANGELES_LAKERS,MIAMI_HEAT,113,97,8116,16
8116,2018-11-18,2018-11-17,NEW_YORK_KNICKS,ORLANDO_MAGIC,117,131,8117,14
8117,2018-11-18,2018-11-17,PORTLAND_TRAIL_BLAZERS,WASHINGTON_WIZARDS,119,109,8118,10
8118,2018-11-19,2018-11-18,GOLDEN_STATE_WARRIORS,SAN_ANTONIO_SPURS,92,104,8119,12
8119,2018-11-20,2018-11-19,BOSTON_CELTICS,CHARLOTTE_HORNETS,112,117,8120,5
8120,2018-11-20,2018-11-19,CLEVELAND_CAVALIERS,DETROIT_PISTONS,102,113,8121,11
8121,2018-11-20,2018-11-19,UTAH_JAZZ,INDIANA_PACERS,94,121,8122,27
8122,2018-11-20,2018-11-19,PHOENIX_SUNS,PHILADELPHIA_76ERS,114,119,8123,5
8123,2018-11-20,2018-11-19,LOS_ANGELES_CLIPPERS,ATLANTA_HAWKS,127,119,8124,8
8124,2018-11-20,2018-11-19,DALLAS_MAVERICKS,MEMPHIS_GRIZZLIES,88,98,8125,10
8125,2018-11-20,2018-11-19,DENVER_NUGGETS,MILWAUKEE_BUCKS,98,104,8126,6
8126,2018-11-20,2018-11-19,SAN_ANTONIO_SPURS,NEW_ORLEANS_PELICANS,126,140,8127,14
8127,2018-11-20,2018-11-19,OKLAHOMA_CITY_THUNDER,SACRAMENTO_KINGS,113,117,8128,4
8128,2018-11-21,2018-11-20,TORONTO_RAPTORS,ORLANDO_MAGIC,93,91,8129,2
8129,2018-11-21,2018-11-20,LOS_ANGELES_CLIPPERS,WASHINGTON_WIZARDS,118,125,8130,7
8130,2018-11-21,2018-11-20,BROOKLYN_NETS,MIAMI_HEAT,104,92,8131,12
8131,2018-11-21,2018-11-20,PORTLAND_TRAIL_BLAZERS,NEW_YORK_KNICKS,118,114,8132,4
8132,2018-11-22,2018-11-21,INDIANA_PACERS,CHARLOTTE_HORNETS,109,127,8133,18
8133,2018-11-22,2018-11-21,NEW_ORLEANS_PELICANS,PHILADELPHIA_76ERS,120,121,8134,1
8134,2018-11-22,2018-11-21,TORONTO_RAPTORS,ATLANTA_HAWKS,124,108,8135,16
8135,2018-11-22,2018-11-21,NEW_YORK_KNICKS,BOSTON_CELTICS,117,109,8136,8
8136,2018-11-22,2018-11-21,PHOENIX_SUNS,CHICAGO_BULLS,116,124,8137,8
8137,2018-11-22,2018-11-21,LOS_ANGELES_LAKERS,CLEVELAND_CAVALIERS,109,105,8138,4
8138,2018-11-22,2018-11-21,DETROIT_PISTONS,HOUSTON_ROCKETS,124,126,8139,2
8139,2018-11-22,2018-11-21,PORTLAND_TRAIL_BLAZERS,MILWAUKEE_BUCKS,100,143,8140,43
8140,2018-11-22,2018-11-21,DENVER_NUGGETS,MINNESOTA_TIMBERWOLVES,103,101,8141,2
8141,2018-11-22,2018-11-21,BROOKLYN_NETS,DALLAS_MAVERICKS,113,119,8142,6
8142,2018-11-22,2018-11-21,MEMPHIS_GRIZZLIES,SAN_ANTONIO_SPURS,104,103,8143,1
8143,2018-11-22,2018-11-21,SACRAMENTO_KINGS,UTAH_JAZZ,119,110,8144,9
8144,2018-11-22,2018-11-21,OKLAHOMA_CITY_THUNDER,GOLDEN_STATE_WARRIORS,123,95,8145,28
8145,2018-11-23,2018-11-22,MINNESOTA_TIMBERWOLVES,BROOKLYN_NETS,112,102,8146,10
8146,2018-11-23,2018-11-22,MEMPHIS_GRIZZLIES,LOS_ANGELES_CLIPPERS,107,112,8147,5
8147,2018-11-24,2018-11-23,HOUSTON_ROCKETS,DETROIT_PISTONS,111,116,8148,5
8148,2018-11-24,2018-11-23,BOSTON_CELTICS,ATLANTA_HAWKS,114,96,8149,18
8149,2018-11-24,2018-11-23,NEW_ORLEANS_PELICANS,NEW_YORK_KNICKS,109,114,8150,5
8150,2018-11-24,2018-11-23,CLEVELAND_CAVALIERS,PHILADELPHIA_76ERS,121,112,8151,9
8151,2018-11-24,2018-11-23,WASHINGTON_WIZARDS,TORONTO_RAPTORS,107,125,8152,18
8152,2018-11-24,2018-11-23,MIAMI_HEAT,CHICAGO_BULLS,103,96,8153,7
8153,2018-11-24,2018-11-23,SAN_ANTONIO_SPURS,INDIANA_PACERS,111,100,8154,11
8154,2018-11-24,2018-11-23,CHARLOTTE_HORNETS,OKLAHOMA_CITY_THUNDER,104,109,8155,5
8155,2018-11-24,2018-11-23,PHOENIX_SUNS,MILWAUKEE_BUCKS,116,114,8156,2
8156,2018-11-24,2018-11-23,ORLANDO_MAGIC,DENVER_NUGGETS,87,112,8157,25
8157,2018-11-24,2018-11-23,PORTLAND_TRAIL_BLAZERS,GOLDEN_STATE_WARRIORS,97,125,8158,28
8158,2018-11-24,2018-11-23,UTAH_JAZZ,LOS_ANGELES_LAKERS,83,90,8159,7
8159,2018-11-25,2018-11-24,HOUSTON_ROCKETS,CLEVELAND_CAVALIERS,108,117,8160,9
8160,2018-11-25,2018-11-24,CHICAGO_BULLS,MINNESOTA_TIMBERWOLVES,96,111,8161,15
8161,2018-11-25,2018-11-24,DENVER_NUGGETS,OKLAHOMA_CITY_THUNDER,105,98,8162,7
8162,2018-11-25,2018-11-24,NEW_ORLEANS_PELICANS,WASHINGTON_WIZARDS,114,124,8163,10
8163,2018-11-25,2018-11-24,BOSTON_CELTICS,DALLAS_MAVERICKS,104,113,8164,9
8164,2018-11-25,2018-11-24,SACRAMENTO_KINGS,GOLDEN_STATE_WARRIORS,116,117,8165,1
8165,2018-11-25,2018-11-24,SAN_ANTONIO_SPURS,MILWAUKEE_BUCKS,129,135,8166,6
8166,2018-11-25,2018-11-24,ORLANDO_MAGIC,LOS_ANGELES_LAKERS,108,104,8167,4
8167,2018-11-25,2018-11-24,PHOENIX_SUNS,DETROIT_PISTONS,107,118,8168,11
8168,2018-11-25,2018-11-24,CHARLOTTE_HORNETS,ATLANTA_HAWKS,123,124,8169,1
8169,2018-11-25,2018-11-24,PHILADELPHIA_76ERS,BROOKLYN_NETS,127,125,8170,2
8170,2018-11-25,2018-11-24,NEW_YORK_KNICKS,MEMPHIS_GRIZZLIES,103,98,8171,5
8171,2018-11-25,2018-11-24,MIAMI_HEAT,TORONTO_RAPTORS,115,125,8172,10
8172,2018-11-26,2018-11-25,UTAH_JAZZ,SACRAMENTO_KINGS,133,112,8173,21
8173,2018-11-26,2018-11-25,LOS_ANGELES_CLIPPERS,PORTLAND_TRAIL_BLAZERS,104,100,8174,4
8174,2018-11-27,2018-11-26,MILWAUKEE_BUCKS,CHARLOTTE_HORNETS,107,110,8175,3
8175,2018-11-27,2018-11-26,MINNESOTA_TIMBERWOLVES,CLEVELAND_CAVALIERS,102,95,8176,7
8176,2018-11-27,2018-11-26,HOUSTON_ROCKETS,WASHINGTON_WIZARDS,131,135,8177,4
8177,2018-11-27,2018-11-26,SAN_ANTONIO_SPURS,CHICAGO_BULLS,108,107,8178,1
8178,2018-11-27,2018-11-26,BOSTON_CELTICS,NEW_ORLEANS_PELICANS,124,107,8179,17
8179,2018-11-27,2018-11-26,INDIANA_PACERS,UTAH_JAZZ,121,88,8180,33
8180,2018-11-27,2018-11-26,ORLANDO_MAGIC,GOLDEN_STATE_WARRIORS,110,116,8181,6
8181,2018-11-28,2018-11-27,NEW_YORK_KNICKS,DETROIT_PISTONS,108,115,8182,7
8182,2018-11-28,2018-11-27,ATLANTA_HAWKS,MIAMI_HEAT,115,113,8183,2
8183,2018-11-28,2018-11-27,TORONTO_RAPTORS,MEMPHIS_GRIZZLIES,122,114,8184,8
8184,2018-11-28,2018-11-27,LOS_ANGELES_LAKERS,DENVER_NUGGETS,85,117,8185,32
8185,2018-11-28,2018-11-27,INDIANA_PACERS,PHOENIX_SUNS,109,104,8186,5
8186,2018-11-29,2018-11-28,ATLANTA_HAWKS,CHARLOTTE_HORNETS,94,108,8187,14
8187,2018-11-29,2018-11-28,NEW_YORK_KNICKS,PHILADELPHIA_76ERS,91,117,8188,26
8188,2018-11-29,2018-11-28,UTAH_JAZZ,BROOKLYN_NETS,101,91,8189,10
8189,2018-11-29,2018-11-28,DALLAS_MAVERICKS,HOUSTON_ROCKETS,128,108,8190,20
8190,2018-11-29,2018-11-28,CHICAGO_BULLS,MILWAUKEE_BUCKS,113,116,8191,3
8191,2018-11-29,2018-11-28,SAN_ANTONIO_SPURS,MINNESOTA_TIMBERWOLVES,89,128,8192,39
8192,2018-11-29,2018-11-28,WASHINGTON_WIZARDS,NEW_ORLEANS_PELICANS,104,125,8193,21
8193,2018-11-29,2018-11-28,CLEVELAND_CAVALIERS,OKLAHOMA_CITY_THUNDER,83,100,8194,17
8194,2018-11-29,2018-11-28,ORLANDO_MAGIC,PORTLAND_TRAIL_BLAZERS,112,115,8195,3
8195,2018-11-29,2018-11-28,PHOENIX_SUNS,LOS_ANGELES_CLIPPERS,99,115,8196,16
8196,2018-11-30,2018-11-29,GOLDEN_STATE_WARRIORS,TORONTO_RAPTORS,128,131,8197,3
8197,2018-11-30,2018-11-29,INDIANA_PACERS,LOS_ANGELES_LAKERS,96,104,8198,8
8198,2018-11-30,2018-11-29,LOS_ANGELES_CLIPPERS,SACRAMENTO_KINGS,133,121,8199,12
8199,2018-12-01,2018-11-30,CLEVELAND_CAVALIERS,BOSTON_CELTICS,95,128,8200,33
8200,2018-12-01,2018-11-30,UTAH_JAZZ,CHARLOTTE_HORNETS,119,111,8201,8
8201,2018-12-01,2018-11-30,CHICAGO_BULLS,DETROIT_PISTONS,88,107,8202,19
8202,2018-12-01,2018-11-30,WASHINGTON_WIZARDS,PHILADELPHIA_76ERS,98,123,8203,25
8203,2018-12-01,2018-11-30,MEMPHIS_GRIZZLIES,BROOKLYN_NETS,131,125,8204,6
8204,2018-12-01,2018-11-30,NEW_ORLEANS_PELICANS,MIAMI_HEAT,101,106,8205,5
8205,2018-12-01,2018-11-30,ATLANTA_HAWKS,OKLAHOMA_CITY_THUNDER,109,124,8206,15
8206,2018-12-01,2018-11-30,HOUSTON_ROCKETS,SAN_ANTONIO_SPURS,136,105,8207,31
8207,2018-12-01,2018-11-30,ORLANDO_MAGIC,PHOENIX_SUNS,99,85,8208,14
8208,2018-12-01,2018-11-30,DALLAS_MAVERICKS,LOS_ANGELES_LAKERS,103,114,8209,11
8209,2018-12-01,2018-11-30,DENVER_NUGGETS,PORTLAND_TRAIL_BLAZERS,113,112,8210,1
8210,2018-12-01,2018-11-30,MILWAUKEE_BUCKS,NEW_YORK_KNICKS,134,136,8211,2
8211,2018-12-02,2018-12-01,GOLDEN_STATE_WARRIORS,DETROIT_PISTONS,102,111,8212,9
8212,2018-12-02,2018-12-01,BROOKLYN_NETS,WASHINGTON_WIZARDS,88,102,8213,14
8213,2018-12-02,2018-12-01,TORONTO_RAPTORS,CLEVELAND_CAVALIERS,106,95,8214,11
8214,2018-12-02,2018-12-01,CHICAGO_BULLS,HOUSTON_ROCKETS,105,121,8215,16
8215,2018-12-02,2018-12-01,BOSTON_CELTICS,MINNESOTA_TIMBERWOLVES,118,109,8216,9
8216,2018-12-02,2018-12-01,INDIANA_PACERS,SACRAMENTO_KINGS,110,111,8217,1
8217,2018-12-02,2018-12-01,PHOENIX_SUNS,LOS_ANGELES_LAKERS,96,120,8218,24
8218,2018-12-02,2018-12-01,NEW_ORLEANS_PELICANS,CHARLOTTE_HORNETS,119,109,8219,10
8219,2018-12-02,2018-12-01,UTAH_JAZZ,MIAMI_HEAT,100,102,8220,2
8220,2018-12-02,2018-12-01,MEMPHIS_GRIZZLIES,PHILADELPHIA_76ERS,95,103,8221,8
8221,2018-12-03,2018-12-02,LOS_ANGELES_CLIPPERS,DALLAS_MAVERICKS,110,114,8222,4
8222,2018-12-03,2018-12-02,PORTLAND_TRAIL_BLAZERS,SAN_ANTONIO_SPURS,118,131,8223,13
8223,2018-12-04,2018-12-03,OKLAHOMA_CITY_THUNDER,DETROIT_PISTONS,110,83,8224,27
8224,2018-12-04,2018-12-03,GOLDEN_STATE_WARRIORS,ATLANTA_HAWKS,128,111,8225,17
8225,2018-12-04,2018-12-03,CLEVELAND_CAVALIERS,BROOKLYN_NETS,99,97,8226,2
8226,2018-12-04,2018-12-03,WASHINGTON_WIZARDS,NEW_YORK_KNICKS,110,107,8227,3
8227,2018-12-04,2018-12-03,DENVER_NUGGETS,TORONTO_RAPTORS,106,103,8228,3
8228,2018-12-04,2018-12-03,HOUSTON_ROCKETS,MINNESOTA_TIMBERWOLVES,91,103,8229,12
8229,2018-12-04,2018-12-03,LOS_ANGELES_CLIPPERS,NEW_ORLEANS_PELICANS,129,126,8230,3
8230,2018-12-05,2018-12-04,CHICAGO_BULLS,INDIANA_PACERS,90,96,8231,6
8231,2018-12-05,2018-12-04,ORLANDO_MAGIC,MIAMI_HEAT,105,90,8232,15
8232,2018-12-05,2018-12-04,PORTLAND_TRAIL_BLAZERS,DALLAS_MAVERICKS,102,111,8233,9
8233,2018-12-05,2018-12-04,SACRAMENTO_KINGS,PHOENIX_SUNS,122,105,8234,17
8234,2018-12-05,2018-12-04,SAN_ANTONIO_SPURS,UTAH_JAZZ,105,139,8235,34
8235,2018-12-06,2018-12-05,GOLDEN_STATE_WARRIORS,CLEVELAND_CAVALIERS,129,105,8236,24
8236,2018-12-06,2018-12-05,DENVER_NUGGETS,ORLANDO_MAGIC,124,118,8237,6
8237,2018-12-06,2018-12-05,WASHINGTON_WIZARDS,ATLANTA_HAWKS,131,117,8238,14
8238,2018-12-06,2018-12-05,OKLAHOMA_CITY_THUNDER,BROOKLYN_NETS,114,112,8239,2
8239,2018-12-06,2018-12-05,LOS_ANGELES_CLIPPERS,MEMPHIS_GRIZZLIES,86,96,8240,10
8240,2018-12-06,2018-12-05,DETROIT_PISTONS,MILWAUKEE_BUCKS,92,115,8241,23
8241,2018-12-06,2018-12-05,CHARLOTTE_HORNETS,MINNESOTA_TIMBERWOLVES,104,121,8242,17
8242,2018-12-06,2018-12-05,DALLAS_MAVERICKS,NEW_ORLEANS_PELICANS,106,132,8243,26
8243,2018-12-06,2018-12-05,PHILADELPHIA_76ERS,TORONTO_RAPTORS,102,113,8244,11
8244,2018-12-06,2018-12-05,SAN_ANTONIO_SPURS,LOS_ANGELES_LAKERS,113,121,8245,8
8245,2018-12-07,2018-12-06,NEW_YORK_KNICKS,BOSTON_CELTICS,100,128,8246,28
8246,2018-12-07,2018-12-06,PHOENIX_SUNS,PORTLAND_TRAIL_BLAZERS,86,108,8247,22
8247,2018-12-07,2018-12-06,HOUSTON_ROCKETS,UTAH_JAZZ,91,118,8248,27
8248,2018-12-08,2018-12-07,DENVER_NUGGETS,CHARLOTTE_HORNETS,107,113,8249,6
8249,2018-12-08,2018-12-07,PHILADELPHIA_76ERS,DETROIT_PISTONS,117,111,8250,6
8250,2018-12-08,2018-12-07,INDIANA_PACERS,ORLANDO_MAGIC,112,90,8251,22
8251,2018-12-08,2018-12-07,TORONTO_RAPTORS,BROOKLYN_NETS,105,106,8252,1
8252,2018-12-08,2018-12-07,SACRAMENTO_KINGS,CLEVELAND_CAVALIERS,129,110,8253,19
8253,2018-12-08,2018-12-07,OKLAHOMA_CITY_THUNDER,CHICAGO_BULLS,112,114,8254,2
8254,2018-12-08,2018-12-07,MEMPHIS_GRIZZLIES,NEW_ORLEANS_PELICANS,107,103,8255,4
8255,2018-12-08,2018-12-07,LOS_ANGELES_LAKERS,SAN_ANTONIO_SPURS,120,133,8256,13
8256,2018-12-08,2018-12-07,MIAMI_HEAT,PHOENIX_SUNS,115,98,8257,17
8257,2018-12-08,2018-12-07,GOLDEN_STATE_WARRIORS,MILWAUKEE_BUCKS,105,95,8258,10
8258,2018-12-08,2018-12-07,HOUSTON_ROCKETS,DALLAS_MAVERICKS,104,107,8259,3
8259,2018-12-09,2018-12-08,SACRAMENTO_KINGS,INDIANA_PACERS,97,107,8260,10
8260,2018-12-09,2018-12-08,DENVER_NUGGETS,ATLANTA_HAWKS,98,106,8261,8
8261,2018-12-09,2018-12-08,WASHINGTON_WIZARDS,CLEVELAND_CAVALIERS,101,116,8262,15
8262,2018-12-09,2018-12-08,BROOKLYN_NETS,NEW_YORK_KNICKS,112,104,8263,8
8263,2018-12-09,2018-12-08,BOSTON_CELTICS,CHICAGO_BULLS,133,77,8264,56
8264,2018-12-09,2018-12-08,LOS_ANGELES_LAKERS,MEMPHIS_GRIZZLIES,111,88,8265,23
8265,2018-12-09,2018-12-08,MINNESOTA_TIMBERWOLVES,PORTLAND_TRAIL_BLAZERS,105,113,8266,8
8266,2018-12-09,2018-12-08,MIAMI_HEAT,LOS_ANGELES_CLIPPERS,121,98,8267,23
8267,2018-12-09,2018-12-08,NEW_ORLEANS_PELICANS,DETROIT_PISTONS,116,108,8268,8
8268,2018-12-09,2018-12-08,MILWAUKEE_BUCKS,TORONTO_RAPTORS,104,99,8269,5
8269,2018-12-10,2018-12-09,UTAH_JAZZ,SAN_ANTONIO_SPURS,97,110,8270,13
8270,2018-12-10,2018-12-09,CHARLOTTE_HORNETS,NEW_YORK_KNICKS,119,107,8271,12
8271,2018-12-11,2018-12-10,WASHINGTON_WIZARDS,INDIANA_PACERS,101,109,8272,8
8272,2018-12-11,2018-12-10,DETROIT_PISTONS,PHILADELPHIA_76ERS,102,116,8273,14
8273,2018-12-11,2018-12-10,NEW_ORLEANS_PELICANS,BOSTON_CELTICS,100,113,8274,13
8274,2018-12-11,2018-12-10,SACRAMENTO_KINGS,CHICAGO_BULLS,108,89,8275,19
8275,2018-12-11,2018-12-10,CLEVELAND_CAVALIERS,MILWAUKEE_BUCKS,92,108,8276,16
8276,2018-12-11,2018-12-10,UTAH_JAZZ,OKLAHOMA_CITY_THUNDER,113,122,8277,9
8277,2018-12-11,2018-12-10,ORLANDO_MAGIC,DALLAS_MAVERICKS,76,101,8278,25
8278,2018-12-11,2018-12-10,MEMPHIS_GRIZZLIES,DENVER_NUGGETS,99,105,8279,6
8279,2018-12-11,2018-12-10,LOS_ANGELES_CLIPPERS,PHOENIX_SUNS,123,119,8280,4
8280,2018-12-11,2018-12-10,MINNESOTA_TIMBERWOLVES,GOLDEN_STATE_WARRIORS,108,116,8281,8
8281,2018-12-11,2018-12-10,MIAMI_HEAT,LOS_ANGELES_LAKERS,105,108,8282,3
8282,2018-12-12,2018-12-11,PORTLAND_TRAIL_BLAZERS,HOUSTON_ROCKETS,104,111,8283,7
8283,2018-12-12,2018-12-11,PHOENIX_SUNS,SAN_ANTONIO_SPURS,86,111,8284,25
8284,2018-12-12,2018-12-11,TORONTO_RAPTORS,LOS_ANGELES_CLIPPERS,123,99,8285,24
8285,2018-12-13,2018-12-12,DETROIT_PISTONS,CHARLOTTE_HORNETS,107,108,8286,1
8286,2018-12-13,2018-12-12,NEW_YORK_KNICKS,CLEVELAND_CAVALIERS,106,113,8287,7
8287,2018-12-13,2018-12-12,MILWAUKEE_BUCKS,INDIANA_PACERS,97,113,8288,16
8288,2018-12-13,2018-12-12,BROOKLYN_NETS,PHILADELPHIA_76ERS,127,124,8289,3
8289,2018-12-13,2018-12-12,BOSTON_CELTICS,WASHINGTON_WIZARDS,130,125,8290,5
8290,2018-12-13,2018-12-12,PORTLAND_TRAIL_BLAZERS,MEMPHIS_GRIZZLIES,83,92,8291,9
8291,2018-12-13,2018-12-12,OKLAHOMA_CITY_THUNDER,NEW_ORLEANS_PELICANS,114,118,8292,4
8292,2018-12-13,2018-12-12,ATLANTA_HAWKS,DALLAS_MAVERICKS,107,114,8293,7
8293,2018-12-13,2018-12-12,MIAMI_HEAT,UTAH_JAZZ,84,111,8294,27
8294,2018-12-13,2018-12-12,MINNESOTA_TIMBERWOLVES,SACRAMENTO_KINGS,130,141,8295,11
8295,2018-12-13,2018-12-12,TORONTO_RAPTORS,GOLDEN_STATE_WARRIORS,113,93,8296,20
8296,2018-12-14,2018-12-13,LOS_ANGELES_LAKERS,HOUSTON_ROCKETS,111,126,8297,15
8297,2018-12-14,2018-12-13,LOS_ANGELES_CLIPPERS,SAN_ANTONIO_SPURS,87,125,8298,38
8298,2018-12-14,2018-12-13,CHICAGO_BULLS,ORLANDO_MAGIC,91,97,8299,6
8299,2018-12-14,2018-12-13,DALLAS_MAVERICKS,PHOENIX_SUNS,89,99,8300,10
8300,2018-12-15,2018-12-14,ATLANTA_HAWKS,BOSTON_CELTICS,108,129,8301,21
8301,2018-12-15,2018-12-14,NEW_YORK_KNICKS,CHARLOTTE_HORNETS,126,124,8302,2
8302,2018-12-15,2018-12-14,WASHINGTON_WIZARDS,BROOKLYN_NETS,118,125,8303,7
8303,2018-12-15,2018-12-14,MILWAUKEE_BUCKS,CLEVELAND_CAVALIERS,114,102,8304,12
8304,2018-12-15,2018-12-14,INDIANA_PACERS,PHILADELPHIA_76ERS,113,101,8305,12
8305,2018-12-15,2018-12-14,MIAMI_HEAT,MEMPHIS_GRIZZLIES,100,97,8306,3
8306,2018-12-15,2018-12-14,OKLAHOMA_CITY_THUNDER,DENVER_NUGGETS,98,109,8307,11
8307,2018-12-15,2018-12-14,TORONTO_RAPTORS,PORTLAND_TRAIL_BLAZERS,122,128,8308,6
8308,2018-12-15,2018-12-14,GOLDEN_STATE_WARRIORS,SACRAMENTO_KINGS,130,125,8309,5
8309,2018-12-15,2018-12-14,UTAH_JAZZ,ORLANDO_MAGIC,89,96,8310,7
8310,2018-12-16,2018-12-15,LOS_ANGELES_LAKERS,CHARLOTTE_HORNETS,128,100,8311,28
8311,2018-12-16,2018-12-15,BOSTON_CELTICS,DETROIT_PISTONS,104,113,8312,9
8312,2018-12-16,2018-12-15,HOUSTON_ROCKETS,MEMPHIS_GRIZZLIES,105,97,8313,8
8313,2018-12-16,2018-12-15,CHICAGO_BULLS,SAN_ANTONIO_SPURS,98,93,8314,5
8314,2018-12-16,2018-12-15,LOS_ANGELES_CLIPPERS,OKLAHOMA_CITY_THUNDER,104,110,8315,6
8315,2018-12-16,2018-12-15,MINNESOTA_TIMBERWOLVES,PHOENIX_SUNS,99,107,8316,8
8316,2018-12-16,2018-12-15,ATLANTA_HAWKS,BROOKLYN_NETS,127,144,8317,17
8317,2018-12-16,2018-12-15,PHILADELPHIA_76ERS,CLEVELAND_CAVALIERS,128,105,8318,23
8318,2018-12-16,2018-12-15,NEW_YORK_KNICKS,INDIANA_PACERS,99,110,8319,11
8319,2018-12-16,2018-12-15,LOS_ANGELES_LAKERS,WASHINGTON_WIZARDS,110,128,8320,18
8320,2018-12-17,2018-12-16,SACRAMENTO_KINGS,DALLAS_MAVERICKS,120,113,8321,7
8321,2018-12-17,2018-12-16,MIAMI_HEAT,NEW_ORLEANS_PELICANS,102,96,8322,6
8322,2018-12-17,2018-12-16,TORONTO_RAPTORS,DENVER_NUGGETS,86,95,8323,9
8323,2018-12-18,2018-12-17,MILWAUKEE_BUCKS,DETROIT_PISTONS,107,104,8324,3
8324,2018-12-18,2018-12-17,PHOENIX_SUNS,NEW_YORK_KNICKS,128,110,8325,18
8325,2018-12-18,2018-12-17,UTAH_JAZZ,HOUSTON_ROCKETS,97,102,8326,5
8326,2018-12-18,2018-12-17,SACRAMENTO_KINGS,MINNESOTA_TIMBERWOLVES,105,132,8327,27
8327,2018-12-18,2018-12-17,CHICAGO_BULLS,OKLAHOMA_CITY_THUNDER,96,121,8328,25
8328,2018-12-18,2018-12-17,PHILADELPHIA_76ERS,SAN_ANTONIO_SPURS,96,123,8329,27
8329,2018-12-18,2018-12-17,MEMPHIS_GRIZZLIES,GOLDEN_STATE_WARRIORS,93,110,8330,17
8330,2018-12-18,2018-12-17,PORTLAND_TRAIL_BLAZERS,LOS_ANGELES_CLIPPERS,131,127,8331,4
8331,2018-12-19,2018-12-18,CLEVELAND_CAVALIERS,INDIANA_PACERS,92,91,8332,1
8332,2018-12-19,2018-12-18,WASHINGTON_WIZARDS,ATLANTA_HAWKS,110,118,8333,8
8333,2018-12-19,2018-12-18,LOS_ANGELES_LAKERS,BROOKLYN_NETS,110,115,8334,5
8334,2018-12-19,2018-12-18,DALLAS_MAVERICKS,DENVER_NUGGETS,118,126,8335,8
8335,2018-12-20,2018-12-19,CLEVELAND_CAVALIERS,CHARLOTTE_HORNETS,99,110,8336,11
8336,2018-12-20,2018-12-19,SAN_ANTONIO_SPURS,ORLANDO_MAGIC,129,90,8337,39
8337,2018-12-20,2018-12-19,NEW_YORK_KNICKS,PHILADELPHIA_76ERS,109,131,8338,22
8338,2018-12-20,2018-12-19,PHOENIX_SUNS,BOSTON_CELTICS,111,103,8339,8
8339,2018-12-20,2018-12-19,INDIANA_PACERS,TORONTO_RAPTORS,96,99,8340,3
8340,2018-12-20,2018-12-19,BROOKLYN_NETS,CHICAGO_BULLS,96,93,8341,3
8341,2018-12-20,2018-12-19,WASHINGTON_WIZARDS,HOUSTON_ROCKETS,118,136,8342,18
8342,2018-12-20,2018-12-19,NEW_ORLEANS_PELICANS,MILWAUKEE_BUCKS,115,123,8343,8
8343,2018-12-20,2018-12-19,DETROIT_PISTONS,MINNESOTA_TIMBERWOLVES,129,123,8344,6
8344,2018-12-20,2018-12-19,GOLDEN_STATE_WARRIORS,UTAH_JAZZ,103,108,8345,5
8345,2018-12-20,2018-12-19,MEMPHIS_GRIZZLIES,PORTLAND_TRAIL_BLAZERS,92,99,8346,7
8346,2018-12-20,2018-12-19,OKLAHOMA_CITY_THUNDER,SACRAMENTO_KINGS,132,113,8347,19
8347,2018-12-21,2018-12-20,HOUSTON_ROCKETS,MIAMI_HEAT,99,101,8348,2
8348,2018-12-21,2018-12-20,DALLAS_MAVERICKS,LOS_ANGELES_CLIPPERS,121,125,8349,4
8349,2018-12-22,2018-12-21,DETROIT_PISTONS,CHARLOTTE_HORNETS,86,98,8350,12
8350,2018-12-22,2018-12-21,CLEVELAND_CAVALIERS,TORONTO_RAPTORS,110,126,8351,16
8351,2018-12-22,2018-12-21,INDIANA_PACERS,BROOKLYN_NETS,114,106,8352,8
8352,2018-12-22,2018-12-21,ATLANTA_HAWKS,NEW_YORK_KNICKS,114,107,8353,7
8353,2018-12-22,2018-12-21,MILWAUKEE_BUCKS,BOSTON_CELTICS,120,107,8354,13
8354,2018-12-22,2018-12-21,ORLANDO_MAGIC,CHICAGO_BULLS,80,90,8355,10
8355,2018-12-22,2018-12-21,MINNESOTA_TIMBERWOLVES,SAN_ANTONIO_SPURS,98,124,8356,26
8356,2018-12-22,2018-12-21,UTAH_JAZZ,PORTLAND_TRAIL_BLAZERS,120,90,8357,30
8357,2018-12-22,2018-12-21,MEMPHIS_GRIZZLIES,SACRAMENTO_KINGS,99,102,8358,3
8358,2018-12-22,2018-12-21,NEW_ORLEANS_PELICANS,LOS_ANGELES_LAKERS,104,112,8359,8
8359,2018-12-22,2018-12-21,DENVER_NUGGETS,LOS_ANGELES_CLIPPERS,111,132,8360,21
8360,2018-12-23,2018-12-22,PHOENIX_SUNS,WASHINGTON_WIZARDS,146,149,8361,3
8361,2018-12-23,2018-12-22,TORONTO_RAPTORS,PHILADELPHIA_76ERS,101,126,8362,25
8362,2018-12-23,2018-12-22,SAN_ANTONIO_SPURS,HOUSTON_ROCKETS,101,108,8363,7
8363,2018-12-23,2018-12-22,MILWAUKEE_BUCKS,MIAMI_HEAT,87,94,8364,7
8364,2018-12-23,2018-12-22,DALLAS_MAVERICKS,GOLDEN_STATE_WARRIORS,116,120,8365,4
8365,2018-12-23,2018-12-22,OKLAHOMA_CITY_THUNDER,UTAH_JAZZ,107,106,8366,1
8366,2018-12-23,2018-12-22,ATLANTA_HAWKS,DETROIT_PISTONS,98,95,8367,3
8367,2018-12-23,2018-12-22,WASHINGTON_WIZARDS,INDIANA_PACERS,89,105,8368,16
8368,2018-12-23,2018-12-22,CHARLOTTE_HORNETS,BOSTON_CELTICS,103,119,8369,16
8369,2018-12-23,2018-12-22,PHOENIX_SUNS,BROOKLYN_NETS,103,111,8370,8
8370,2018-12-23,2018-12-22,CHICAGO_BULLS,CLEVELAND_CAVALIERS,112,92,8371,20
8371,2018-12-23,2018-12-22,MIAMI_HEAT,ORLANDO_MAGIC,115,91,8372,24
8372,2018-12-23,2018-12-22,NEW_ORLEANS_PELICANS,SACRAMENTO_KINGS,117,122,8373,5
8373,2018-12-24,2018-12-23,MINNESOTA_TIMBERWOLVES,OKLAHOMA_CITY_THUNDER,114,112,8374,2
8374,2018-12-24,2018-12-23,LOS_ANGELES_CLIPPERS,GOLDEN_STATE_WARRIORS,127,129,8375,2
8375,2018-12-24,2018-12-23,DALLAS_MAVERICKS,PORTLAND_TRAIL_BLAZERS,118,121,8376,3
8376,2018-12-24,2018-12-23,MEMPHIS_GRIZZLIES,LOS_ANGELES_LAKERS,107,99,8377,8
8377,2018-12-25,2018-12-24,MILWAUKEE_BUCKS,NEW_YORK_KNICKS,109,95,8378,14
8378,2018-12-25,2018-12-24,OKLAHOMA_CITY_THUNDER,HOUSTON_ROCKETS,109,113,8379,4
8379,2018-12-25,2018-12-24,PHILADELPHIA_76ERS,BOSTON_CELTICS,114,121,8380,7
8380,2018-12-26,2018-12-25,LOS_ANGELES_LAKERS,GOLDEN_STATE_WARRIORS,127,101,8381,26
8381,2018-12-26,2018-12-25,PORTLAND_TRAIL_BLAZERS,UTAH_JAZZ,96,117,8382,21
8382,2018-12-27,2018-12-26,WASHINGTON_WIZARDS,DETROIT_PISTONS,95,106,8383,11
8383,2018-12-27,2018-12-26,PHOENIX_SUNS,ORLANDO_MAGIC,122,120,8384,2
8384,2018-12-27,2018-12-26,INDIANA_PACERS,ATLANTA_HAWKS,129,121,8385,8
8385,2018-12-27,2018-12-26,CHARLOTTE_HORNETS,BROOKLYN_NETS,132,134,8386,2
8386,2018-12-27,2018-12-26,TORONTO_RAPTORS,MIAMI_HEAT,106,104,8387,2
8387,2018-12-27,2018-12-26,MINNESOTA_TIMBERWOLVES,CHICAGO_BULLS,119,94,8388,25
8388,2018-12-27,2018-12-26,CLEVELAND_CAVALIERS,MEMPHIS_GRIZZLIES,87,95,8389,8
8389,2018-12-27,2018-12-26,NEW_ORLEANS_PELICANS,DALLAS_MAVERICKS,119,122,8390,3
8390,2018-12-27,2018-12-26,DENVER_NUGGETS,SAN_ANTONIO_SPURS,103,111,8391,8
8391,2018-12-27,2018-12-26,SACRAMENTO_KINGS,LOS_ANGELES_CLIPPERS,118,127,8392,9
8392,2018-12-28,2018-12-27,BOSTON_CELTICS,HOUSTON_ROCKETS,113,127,8393,14
8393,2018-12-28,2018-12-27,NEW_YORK_KNICKS,MILWAUKEE_BUCKS,96,112,8394,16
8394,2018-12-28,2018-12-27,LOS_ANGELES_LAKERS,SACRAMENTO_KINGS,116,117,8395,1
8395,2018-12-28,2018-12-27,PORTLAND_TRAIL_BLAZERS,GOLDEN_STATE_WARRIORS,110,109,8396,1
8396,2018-12-28,2018-12-27,PHILADELPHIA_76ERS,UTAH_JAZZ,114,97,8397,17
8397,2018-12-29,2018-12-28,BROOKLYN_NETS,CHARLOTTE_HORNETS,87,100,8398,13
8398,2018-12-29,2018-12-28,DETROIT_PISTONS,INDIANA_PACERS,88,125,8399,37
8399,2018-12-29,2018-12-28,TORONTO_RAPTORS,ORLANDO_MAGIC,87,116,8400,29
8400,2018-12-29,2018-12-28,CHICAGO_BULLS,WASHINGTON_WIZARDS,101,92,8401,9
8401,2018-12-29,2018-12-28,CLEVELAND_CAVALIERS,MIAMI_HEAT,94,118,8402,24
8402,2018-12-29,2018-12-28,ATLANTA_HAWKS,MINNESOTA_TIMBERWOLVES,123,120,8403,3
8403,2018-12-29,2018-12-28,DALLAS_MAVERICKS,NEW_ORLEANS_PELICANS,112,114,8404,2
8404,2018-12-29,2018-12-28,SAN_ANTONIO_SPURS,DENVER_NUGGETS,99,102,8405,3
8405,2018-12-29,2018-12-28,OKLAHOMA_CITY_THUNDER,PHOENIX_SUNS,118,102,8406,16
8406,2018-12-29,2018-12-28,LOS_ANGELES_CLIPPERS,LOS_ANGELES_LAKERS,118,107,8407,11
8407,2018-12-29,2018-12-28,BROOKLYN_NETS,MILWAUKEE_BUCKS,115,129,8408,14
8408,2018-12-30,2018-12-29,HOUSTON_ROCKETS,NEW_ORLEANS_PELICANS,108,104,8409,4
8409,2018-12-30,2018-12-29,CHARLOTTE_HORNETS,WASHINGTON_WIZARDS,126,130,8410,4
8410,2018-12-30,2018-12-29,CLEVELAND_CAVALIERS,ATLANTA_HAWKS,108,111,8411,3
8411,2018-12-30,2018-12-29,BOSTON_CELTICS,MEMPHIS_GRIZZLIES,112,103,8412,9
8412,2018-12-30,2018-12-29,NEW_YORK_KNICKS,UTAH_JAZZ,97,129,8413,32
8413,2018-12-30,2018-12-29,DENVER_NUGGETS,PHOENIX_SUNS,122,118,8414,4
8414,2018-12-30,2018-12-29,GOLDEN_STATE_WARRIORS,PORTLAND_TRAIL_BLAZERS,115,105,8415,10
8415,2018-12-30,2018-12-29,SAN_ANTONIO_SPURS,LOS_ANGELES_CLIPPERS,122,111,8416,11
8416,2018-12-30,2018-12-29,DETROIT_PISTONS,ORLANDO_MAGIC,107,109,8417,2
8417,2018-12-30,2018-12-29,MINNESOTA_TIMBERWOLVES,MIAMI_HEAT,113,104,8418,9
8418,2018-12-30,2018-12-29,CHICAGO_BULLS,TORONTO_RAPTORS,89,95,8419,6
8419,2018-12-31,2018-12-30,OKLAHOMA_CITY_THUNDER,DALLAS_MAVERICKS,103,105,8420,2
8420,2018-12-31,2018-12-30,PHILADELPHIA_76ERS,PORTLAND_TRAIL_BLAZERS,95,129,8421,34
8421,2018-12-31,2018-12-30,SACRAMENTO_KINGS,LOS_ANGELES_LAKERS,114,121,8422,7
8422,2018-12-31,2018-12-30,ATLANTA_HAWKS,INDIANA_PACERS,108,116,8423,8
8423,2018-12-31,2018-12-30,ORLANDO_MAGIC,CHARLOTTE_HORNETS,100,125,8424,25
8424,2019-01-01,2018-12-31,MEMPHIS_GRIZZLIES,HOUSTON_ROCKETS,101,113,8425,12
8425,2019-01-01,2018-12-31,BOSTON_CELTICS,SAN_ANTONIO_SPURS,111,120,8426,9
8426,2019-01-01,2018-12-31,MINNESOTA_TIMBERWOLVES,NEW_ORLEANS_PELICANS,114,123,8427,9
8427,2019-01-01,2018-12-31,DALLAS_MAVERICKS,OKLAHOMA_CITY_THUNDER,102,122,8428,20
8428,2019-01-01,2018-12-31,GOLDEN_STATE_WARRIORS,PHOENIX_SUNS,132,109,8429,23
8429,2019-01-02,2019-01-01,UTAH_JAZZ,TORONTO_RAPTORS,116,122,8430,6
8430,2019-01-02,2019-01-01,DETROIT_PISTONS,MILWAUKEE_BUCKS,98,121,8431,23
8431,2019-01-02,2019-01-01,NEW_YORK_KNICKS,DENVER_NUGGETS,108,115,8432,7
8432,2019-01-02,2019-01-01,PORTLAND_TRAIL_BLAZERS,SACRAMENTO_KINGS,113,108,8433,5
8433,2019-01-02,2019-01-01,PHILADELPHIA_76ERS,LOS_ANGELES_CLIPPERS,119,113,8434,6
8434,2019-01-03,2019-01-02,DALLAS_MAVERICKS,CHARLOTTE_HORNETS,122,84,8435,38
8435,2019-01-03,2019-01-02,MIAMI_HEAT,CLEVELAND_CAVALIERS,117,92,8436,25
8436,2019-01-03,2019-01-02,ATLANTA_HAWKS,WASHINGTON_WIZARDS,98,114,8437,16
8437,2019-01-03,2019-01-02,NEW_ORLEANS_PELICANS,BROOKLYN_NETS,121,126,8438,5
8438,2019-01-03,2019-01-02,MINNESOTA_TIMBERWOLVES,BOSTON_CELTICS,102,115,8439,13
8439,2019-01-03,2019-01-02,ORLANDO_MAGIC,CHICAGO_BULLS,112,84,8440,28
8440,2019-01-03,2019-01-02,DETROIT_PISTONS,MEMPHIS_GRIZZLIES,101,94,8441,7
8441,2019-01-03,2019-01-02,PHILADELPHIA_76ERS,PHOENIX_SUNS,132,127,8442,5
8442,2019-01-03,2019-01-02,OKLAHOMA_CITY_THUNDER,LOS_ANGELES_LAKERS,107,100,8443,7
8443,2019-01-04,2019-01-03,TORONTO_RAPTORS,SAN_ANTONIO_SPURS,107,125,8444,18
8444,2019-01-04,2019-01-03,DENVER_NUGGETS,SACRAMENTO_KINGS,117,113,8445,4
8445,2019-01-04,2019-01-03,HOUSTON_ROCKETS,GOLDEN_STATE_WARRIORS,135,134,8446,1
8446,2019-01-05,2019-01-04,UTAH_JAZZ,CLEVELAND_CAVALIERS,117,91,8447,26
8447,2019-01-05,2019-01-04,DALLAS_MAVERICKS,BOSTON_CELTICS,93,114,8448,21
8448,2019-01-05,2019-01-04,INDIANA_PACERS,CHICAGO_BULLS,119,116,8449,3
8449,2019-01-05,2019-01-04,BROOKLYN_NETS,MEMPHIS_GRIZZLIES,109,100,8450,9
8450,2019-01-05,2019-01-04,WASHINGTON_WIZARDS,MIAMI_HEAT,109,115,8451,6
8451,2019-01-05,2019-01-04,ORLANDO_MAGIC,MINNESOTA_TIMBERWOLVES,103,120,8452,17
8452,2019-01-05,2019-01-04,ATLANTA_HAWKS,MILWAUKEE_BUCKS,112,144,8453,32
8453,2019-01-05,2019-01-04,LOS_ANGELES_CLIPPERS,PHOENIX_SUNS,121,111,8454,10
8454,2019-01-05,2019-01-04,NEW_YORK_KNICKS,LOS_ANGELES_LAKERS,119,112,8455,7
8455,2019-01-05,2019-01-04,OKLAHOMA_CITY_THUNDER,PORTLAND_TRAIL_BLAZERS,111,109,8456,2
8456,2019-01-05,2019-01-04,CHARLOTTE_HORNETS,DENVER_NUGGETS,110,123,8457,13
8457,2019-01-06,2019-01-05,UTAH_JAZZ,DETROIT_PISTONS,110,105,8458,5
8458,2019-01-06,2019-01-05,DALLAS_MAVERICKS,PHILADELPHIA_76ERS,100,106,8459,6
8459,2019-01-06,2019-01-05,NEW_ORLEANS_PELICANS,CLEVELAND_CAVALIERS,133,98,8460,35
8460,2019-01-06,2019-01-05,TORONTO_RAPTORS,MILWAUKEE_BUCKS,123,116,8461,7
8461,2019-01-06,2019-01-05,MEMPHIS_GRIZZLIES,SAN_ANTONIO_SPURS,88,108,8462,20
8462,2019-01-06,2019-01-05,HOUSTON_ROCKETS,PORTLAND_TRAIL_BLAZERS,101,110,8463,9
8463,2019-01-06,2019-01-05,GOLDEN_STATE_WARRIORS,SACRAMENTO_KINGS,127,123,8464,4
8464,2019-01-06,2019-01-05,BROOKLYN_NETS,CHICAGO_BULLS,117,100,8465,17
8465,2019-01-06,2019-01-05,ORLANDO_MAGIC,LOS_ANGELES_CLIPPERS,96,106,8466,10
8466,2019-01-06,2019-01-05,LOS_ANGELES_LAKERS,MINNESOTA_TIMBERWOLVES,86,108,8467,22
8467,2019-01-06,2019-01-05,MIAMI_HEAT,ATLANTA_HAWKS,82,106,8468,24
8468,2019-01-07,2019-01-06,WASHINGTON_WIZARDS,OKLAHOMA_CITY_THUNDER,116,98,8469,18
8469,2019-01-07,2019-01-06,INDIANA_PACERS,TORONTO_RAPTORS,105,121,8470,16
8470,2019-01-07,2019-01-06,CHARLOTTE_HORNETS,PHOENIX_SUNS,119,113,8471,6
8471,2019-01-08,2019-01-07,SAN_ANTONIO_SPURS,DETROIT_PISTONS,119,107,8472,12
8472,2019-01-08,2019-01-07,BROOKLYN_NETS,BOSTON_CELTICS,95,116,8473,21
8473,2019-01-08,2019-01-07,DENVER_NUGGETS,HOUSTON_ROCKETS,113,125,8474,12
8474,2019-01-08,2019-01-07,UTAH_JAZZ,MILWAUKEE_BUCKS,102,114,8475,12
8475,2019-01-08,2019-01-07,MEMPHIS_GRIZZLIES,NEW_ORLEANS_PELICANS,95,114,8476,19
8476,2019-01-08,2019-01-07,LOS_ANGELES_LAKERS,DALLAS_MAVERICKS,107,97,8477,10
8477,2019-01-08,2019-01-07,NEW_YORK_KNICKS,PORTLAND_TRAIL_BLAZERS,101,111,8478,10
8478,2019-01-08,2019-01-07,ORLANDO_MAGIC,SACRAMENTO_KINGS,95,111,8479,16
8479,2019-01-09,2019-01-08,INDIANA_PACERS,CLEVELAND_CAVALIERS,123,115,8480,8
8480,2019-01-09,2019-01-08,WASHINGTON_WIZARDS,PHILADELPHIA_76ERS,115,132,8481,17
8481,2019-01-09,2019-01-08,DENVER_NUGGETS,MIAMI_HEAT,103,99,8482,4
8482,2019-01-09,2019-01-08,ATLANTA_HAWKS,TORONTO_RAPTORS,101,104,8483,3
8483,2019-01-09,2019-01-08,MINNESOTA_TIMBERWOLVES,OKLAHOMA_CITY_THUNDER,119,117,8484,2
8484,2019-01-09,2019-01-08,SACRAMENTO_KINGS,PHOENIX_SUNS,111,115,8485,4
8485,2019-01-09,2019-01-08,NEW_YORK_KNICKS,GOLDEN_STATE_WARRIORS,95,122,8486,27
8486,2019-01-09,2019-01-08,CHARLOTTE_HORNETS,LOS_ANGELES_CLIPPERS,109,128,8487,19
8487,2019-01-10,2019-01-09,INDIANA_PACERS,BOSTON_CELTICS,108,135,8488,27
8488,2019-01-10,2019-01-09,PHILADELPHIA_76ERS,WASHINGTON_WIZARDS,106,123,8489,17
8489,2019-01-10,2019-01-09,ATLANTA_HAWKS,BROOKLYN_NETS,100,116,8490,16
8490,2019-01-10,2019-01-09,MILWAUKEE_BUCKS,HOUSTON_ROCKETS,116,109,8491,7
8491,2019-01-10,2019-01-09,SAN_ANTONIO_SPURS,MEMPHIS_GRIZZLIES,86,96,8492,10
8492,2019-01-10,2019-01-09,CLEVELAND_CAVALIERS,NEW_ORLEANS_PELICANS,124,140,8493,16
8493,2019-01-10,2019-01-09,PHOENIX_SUNS,DALLAS_MAVERICKS,94,104,8494,10
8494,2019-01-10,2019-01-09,ORLANDO_MAGIC,UTAH_JAZZ,93,106,8495,13
8495,2019-01-10,2019-01-09,CHICAGO_BULLS,PORTLAND_TRAIL_BLAZERS,112,124,8496,12
8496,2019-01-10,2019-01-09,DETROIT_PISTONS,LOS_ANGELES_LAKERS,100,113,8497,13
8497,2019-01-11,2019-01-10,BOSTON_CELTICS,MIAMI_HEAT,99,115,8498,16
8498,2019-01-11,2019-01-10,LOS_ANGELES_CLIPPERS,DENVER_NUGGETS,100,121,8499,21
8499,2019-01-11,2019-01-10,OKLAHOMA_CITY_THUNDER,SAN_ANTONIO_SPURS,147,154,8500,7
8500,2019-01-11,2019-01-10,DETROIT_PISTONS,SACRAMENTO_KINGS,102,112,8501,10
8501,2019-01-12,2019-01-11,ATLANTA_HAWKS,PHILADELPHIA_76ERS,123,121,8502,2
8502,2019-01-12,2019-01-11,MILWAUKEE_BUCKS,WASHINGTON_WIZARDS,106,113,8503,7
8503,2019-01-12,2019-01-11,INDIANA_PACERS,NEW_YORK_KNICKS,121,106,8504,15
8504,2019-01-12,2019-01-11,BROOKLYN_NETS,TORONTO_RAPTORS,105,122,8505,17
8505,2019-01-12,2019-01-11,CLEVELAND_CAVALIERS,HOUSTON_ROCKETS,113,141,8506,28
8506,2019-01-12,2019-01-11,DALLAS_MAVERICKS,MINNESOTA_TIMBERWOLVES,119,115,8507,4
8507,2019-01-12,2019-01-11,CHARLOTTE_HORNETS,PORTLAND_TRAIL_BLAZERS,96,127,8508,31
8508,2019-01-12,2019-01-11,LOS_ANGELES_LAKERS,UTAH_JAZZ,95,113,8509,18
8509,2019-01-12,2019-01-11,CHICAGO_BULLS,GOLDEN_STATE_WARRIORS,109,146,8510,37
8510,2019-01-12,2019-01-11,DETROIT_PISTONS,LOS_ANGELES_CLIPPERS,109,104,8511,5
8511,2019-01-12,2019-01-11,MEMPHIS_GRIZZLIES,MIAMI_HEAT,108,112,8512,4
8512,2019-01-13,2019-01-12,BOSTON_CELTICS,ORLANDO_MAGIC,103,105,8513,2
8513,2019-01-13,2019-01-12,NEW_ORLEANS_PELICANS,MINNESOTA_TIMBERWOLVES,106,110,8514,4
8514,2019-01-13,2019-01-12,SAN_ANTONIO_SPURS,OKLAHOMA_CITY_THUNDER,112,122,8515,10
8515,2019-01-13,2019-01-12,DENVER_NUGGETS,PHOENIX_SUNS,93,102,8516,9
8516,2019-01-13,2019-01-12,CHARLOTTE_HORNETS,SACRAMENTO_KINGS,97,104,8517,7
8517,2019-01-13,2019-01-12,CHICAGO_BULLS,UTAH_JAZZ,102,110,8518,8
8518,2019-01-13,2019-01-12,PHILADELPHIA_76ERS,NEW_YORK_KNICKS,108,105,8519,3
8519,2019-01-13,2019-01-12,TORONTO_RAPTORS,WASHINGTON_WIZARDS,140,138,8520,2
8520,2019-01-13,2019-01-12,MILWAUKEE_BUCKS,ATLANTA_HAWKS,133,114,8521,19
8521,2019-01-13,2019-01-12,HOUSTON_ROCKETS,ORLANDO_MAGIC,109,116,8522,7
8522,2019-01-14,2019-01-13,GOLDEN_STATE_WARRIORS,DALLAS_MAVERICKS,119,114,8523,5
8523,2019-01-14,2019-01-13,PORTLAND_TRAIL_BLAZERS,DENVER_NUGGETS,113,116,8524,3
8524,2019-01-14,2019-01-13,CLEVELAND_CAVALIERS,LOS_ANGELES_LAKERS,101,95,8525,6
8525,2019-01-15,2019-01-14,BOSTON_CELTICS,BROOKLYN_NETS,102,109,8526,7
8526,2019-01-15,2019-01-14,MEMPHIS_GRIZZLIES,HOUSTON_ROCKETS,94,112,8527,18
8527,2019-01-15,2019-01-14,CHARLOTTE_HORNETS,SAN_ANTONIO_SPURS,108,93,8528,15
8528,2019-01-15,2019-01-14,DETROIT_PISTONS,UTAH_JAZZ,94,100,8529,6
8529,2019-01-15,2019-01-14,PORTLAND_TRAIL_BLAZERS,SACRAMENTO_KINGS,107,115,8530,8
8530,2019-01-15,2019-01-14,NEW_ORLEANS_PELICANS,LOS_ANGELES_CLIPPERS,121,117,8531,4
8531,2019-01-16,2019-01-15,PHOENIX_SUNS,INDIANA_PACERS,97,131,8532,34
8532,2019-01-16,2019-01-15,MINNESOTA_TIMBERWOLVES,PHILADELPHIA_76ERS,107,149,8533,42
8533,2019-01-16,2019-01-15,OKLAHOMA_CITY_THUNDER,ATLANTA_HAWKS,126,142,8534,16
8534,2019-01-16,2019-01-15,MIAMI_HEAT,MILWAUKEE_BUCKS,86,124,8535,38
8535,2019-01-16,2019-01-15,GOLDEN_STATE_WARRIORS,DENVER_NUGGETS,142,111,8536,31
8536,2019-01-16,2019-01-15,CHICAGO_BULLS,LOS_ANGELES_LAKERS,100,107,8537,7
8537,2019-01-17,2019-01-16,ORLANDO_MAGIC,DETROIT_PISTONS,115,120,8538,5
8538,2019-01-17,2019-01-16,TORONTO_RAPTORS,BOSTON_CELTICS,108,117,8539,9
8539,2019-01-17,2019-01-16,BROOKLYN_NETS,HOUSTON_ROCKETS,145,142,8540,3
8540,2019-01-17,2019-01-16,MILWAUKEE_BUCKS,MEMPHIS_GRIZZLIES,111,101,8541,10
8541,2019-01-17,2019-01-16,SAN_ANTONIO_SPURS,DALLAS_MAVERICKS,105,101,8542,4
8542,2019-01-17,2019-01-16,CLEVELAND_CAVALIERS,PORTLAND_TRAIL_BLAZERS,112,129,8543,17
8543,2019-01-17,2019-01-16,NEW_ORLEANS_PELICANS,GOLDEN_STATE_WARRIORS,140,147,8544,7
8544,2019-01-17,2019-01-16,UTAH_JAZZ,LOS_ANGELES_CLIPPERS,129,109,8545,20
8545,2019-01-17,2019-01-16,NEW_YORK_KNICKS,WASHINGTON_WIZARDS,100,101,8546,1
8546,2019-01-18,2019-01-17,SACRAMENTO_KINGS,CHARLOTTE_HORNETS,95,114,8547,19
8547,2019-01-18,2019-01-17,PHILADELPHIA_76ERS,INDIANA_PACERS,120,96,8548,24
8548,2019-01-18,2019-01-17,PHOENIX_SUNS,TORONTO_RAPTORS,109,111,8549,2
8549,2019-01-18,2019-01-17,CHICAGO_BULLS,DENVER_NUGGETS,105,135,8550,30
8550,2019-01-18,2019-01-17,LOS_ANGELES_LAKERS,OKLAHOMA_CITY_THUNDER,138,128,8551,10
8551,2019-01-19,2019-01-18,MEMPHIS_GRIZZLIES,BOSTON_CELTICS,116,122,8552,6
8552,2019-01-19,2019-01-18,MIAMI_HEAT,DETROIT_PISTONS,93,98,8553,5
8553,2019-01-19,2019-01-18,BROOKLYN_NETS,ORLANDO_MAGIC,117,115,8554,2
8554,2019-01-19,2019-01-18,SAN_ANTONIO_SPURS,MINNESOTA_TIMBERWOLVES,116,113,8555,3
8555,2019-01-19,2019-01-18,CLEVELAND_CAVALIERS,UTAH_JAZZ,99,115,8556,16
8556,2019-01-19,2019-01-18,GOLDEN_STATE_WARRIORS,LOS_ANGELES_CLIPPERS,112,94,8557,18
8557,2019-01-19,2019-01-18,NEW_ORLEANS_PELICANS,PORTLAND_TRAIL_BLAZERS,112,128,8558,16
8558,2019-01-19,2019-01-18,OKLAHOMA_CITY_THUNDER,PHILADELPHIA_76ERS,117,115,8559,2
8559,2019-01-19,2019-01-18,PHOENIX_SUNS,CHARLOTTE_HORNETS,115,135,8560,20
8560,2019-01-20,2019-01-19,SACRAMENTO_KINGS,DETROIT_PISTONS,103,101,8561,2
8561,2019-01-20,2019-01-19,DALLAS_MAVERICKS,INDIANA_PACERS,99,111,8562,12
8562,2019-01-20,2019-01-19,MILWAUKEE_BUCKS,ORLANDO_MAGIC,118,108,8563,10
8563,2019-01-20,2019-01-19,BOSTON_CELTICS,ATLANTA_HAWKS,113,105,8564,8
8564,2019-01-20,2019-01-19,MEMPHIS_GRIZZLIES,TORONTO_RAPTORS,90,119,8565,29
8565,2019-01-20,2019-01-19,MIAMI_HEAT,CHICAGO_BULLS,117,103,8566,14
8566,2019-01-20,2019-01-19,LOS_ANGELES_LAKERS,HOUSTON_ROCKETS,134,138,8567,4
8567,2019-01-20,2019-01-19,CLEVELAND_CAVALIERS,DENVER_NUGGETS,102,124,8568,22
8568,2019-01-20,2019-01-19,CHARLOTTE_HORNETS,INDIANA_PACERS,95,120,8569,25
8569,2019-01-21,2019-01-20,PHOENIX_SUNS,MINNESOTA_TIMBERWOLVES,114,116,8570,2
8570,2019-01-21,2019-01-20,LOS_ANGELES_CLIPPERS,SAN_ANTONIO_SPURS,103,95,8571,8
8571,2019-01-21,2019-01-20,OKLAHOMA_CITY_THUNDER,NEW_YORK_KNICKS,127,109,8572,18
8572,2019-01-21,2019-01-20,CHICAGO_BULLS,CLEVELAND_CAVALIERS,104,88,8573,16
8573,2019-01-21,2019-01-20,DALLAS_MAVERICKS,MILWAUKEE_BUCKS,106,116,8574,10
8574,2019-01-21,2019-01-20,DETROIT_PISTONS,WASHINGTON_WIZARDS,87,101,8575,14
8575,2019-01-21,2019-01-20,ORLANDO_MAGIC,ATLANTA_HAWKS,122,103,8576,19
8576,2019-01-21,2019-01-20,SACRAMENTO_KINGS,BROOKLYN_NETS,94,123,8577,29
8577,2019-01-21,2019-01-20,NEW_ORLEANS_PELICANS,MEMPHIS_GRIZZLIES,105,85,8578,20
8578,2019-01-21,2019-01-20,MIAMI_HEAT,BOSTON_CELTICS,99,107,8579,8
8579,2019-01-22,2019-01-21,HOUSTON_ROCKETS,PHILADELPHIA_76ERS,93,121,8580,28
8580,2019-01-22,2019-01-21,PORTLAND_TRAIL_BLAZERS,UTAH_JAZZ,109,104,8581,5
8581,2019-01-22,2019-01-21,GOLDEN_STATE_WARRIORS,LOS_ANGELES_LAKERS,130,111,8582,19
8582,2019-01-23,2019-01-22,SACRAMENTO_KINGS,TORONTO_RAPTORS,105,120,8583,15
8583,2019-01-23,2019-01-22,PORTLAND_TRAIL_BLAZERS,OKLAHOMA_CITY_THUNDER,114,123,8584,9
8584,2019-01-23,2019-01-22,LOS_ANGELES_CLIPPERS,DALLAS_MAVERICKS,98,106,8585,8
8585,2019-01-23,2019-01-22,MINNESOTA_TIMBERWOLVES,PHOENIX_SUNS,118,91,8586,27
8586,2019-01-24,2019-01-23,TORONTO_RAPTORS,INDIANA_PACERS,106,110,8587,4
8587,2019-01-24,2019-01-23,CLEVELAND_CAVALIERS,BOSTON_CELTICS,103,123,8588,20
8588,2019-01-24,2019-01-23,ORLANDO_MAGIC,BROOKLYN_NETS,110,114,8589,4
8589,2019-01-24,2019-01-23,LOS_ANGELES_CLIPPERS,MIAMI_HEAT,111,99,8590,12
8590,2019-01-24,2019-01-23,HOUSTON_ROCKETS,NEW_YORK_KNICKS,114,110,8591,4
8591,2019-01-24,2019-01-23,ATLANTA_HAWKS,CHICAGO_BULLS,121,101,8592,20
8592,2019-01-24,2019-01-23,CHARLOTTE_HORNETS,MEMPHIS_GRIZZLIES,118,107,8593,11
8593,2019-01-24,2019-01-23,DETROIT_PISTONS,NEW_ORLEANS_PELICANS,98,94,8594,4
8594,2019-01-24,2019-01-23,SAN_ANTONIO_SPURS,PHILADELPHIA_76ERS,120,122,8595,2
8595,2019-01-24,2019-01-23,DENVER_NUGGETS,UTAH_JAZZ,108,114,8596,6
8596,2019-01-25,2019-01-24,NEW_ORLEANS_PELICANS,OKLAHOMA_CITY_THUNDER,116,122,8597,6
8597,2019-01-25,2019-01-24,GOLDEN_STATE_WARRIORS,WASHINGTON_WIZARDS,126,118,8598,8
8598,2019-01-25,2019-01-24,PORTLAND_TRAIL_BLAZERS,PHOENIX_SUNS,120,106,8599,14
8599,2019-01-25,2019-01-24,MINNESOTA_TIMBERWOLVES,LOS_ANGELES_LAKERS,120,105,8600,15
8600,2019-01-26,2019-01-25,WASHINGTON_WIZARDS,ORLANDO_MAGIC,95,91,8601,4
8601,2019-01-26,2019-01-25,NEW_YORK_KNICKS,BROOKLYN_NETS,99,109,8602,10
8602,2019-01-26,2019-01-25,MIAMI_HEAT,CLEVELAND_CAVALIERS,100,94,8603,6
8603,2019-01-26,2019-01-25,LOS_ANGELES_CLIPPERS,CHICAGO_BULLS,106,101,8604,5
8604,2019-01-26,2019-01-25,TORONTO_RAPTORS,HOUSTON_ROCKETS,119,121,8605,2
8605,2019-01-26,2019-01-25,SACRAMENTO_KINGS,MEMPHIS_GRIZZLIES,99,96,8606,3
8606,2019-01-26,2019-01-25,DETROIT_PISTONS,DALLAS_MAVERICKS,101,106,8607,5
8607,2019-01-26,2019-01-25,CHARLOTTE_HORNETS,MILWAUKEE_BUCKS,99,108,8608,9
8608,2019-01-26,2019-01-25,PHOENIX_SUNS,DENVER_NUGGETS,95,132,8609,37
8609,2019-01-26,2019-01-25,MINNESOTA_TIMBERWOLVES,UTAH_JAZZ,102,106,8610,4
8610,2019-01-26,2019-01-25,SAN_ANTONIO_SPURS,NEW_ORLEANS_PELICANS,126,114,8611,12
8611,2019-01-27,2019-01-26,INDIANA_PACERS,MEMPHIS_GRIZZLIES,103,106,8612,3
8612,2019-01-27,2019-01-26,GOLDEN_STATE_WARRIORS,BOSTON_CELTICS,115,111,8613,4
8613,2019-01-27,2019-01-26,PHILADELPHIA_76ERS,DENVER_NUGGETS,110,126,8614,16
8614,2019-01-27,2019-01-26,ATLANTA_HAWKS,PORTLAND_TRAIL_BLAZERS,111,120,8615,9
8615,2019-01-27,2019-01-26,CLEVELAND_CAVALIERS,CHICAGO_BULLS,104,101,8616,3
8616,2019-01-27,2019-01-26,SACRAMENTO_KINGS,LOS_ANGELES_CLIPPERS,108,122,8617,14
8617,2019-01-27,2019-01-26,MILWAUKEE_BUCKS,OKLAHOMA_CITY_THUNDER,112,118,8618,6
8618,2019-01-28,2019-01-27,TORONTO_RAPTORS,DALLAS_MAVERICKS,123,120,8619,3
8619,2019-01-28,2019-01-27,ORLANDO_MAGIC,HOUSTON_ROCKETS,98,103,8620,5
8620,2019-01-28,2019-01-27,UTAH_JAZZ,MINNESOTA_TIMBERWOLVES,125,111,8621,14
8621,2019-01-28,2019-01-27,WASHINGTON_WIZARDS,SAN_ANTONIO_SPURS,119,132,8622,13
8622,2019-01-28,2019-01-27,MIAMI_HEAT,NEW_YORK_KNICKS,106,97,8623,9
8623,2019-01-28,2019-01-27,PHOENIX_SUNS,LOS_ANGELES_LAKERS,102,116,8624,14
8624,2019-01-29,2019-01-28,NEW_YORK_KNICKS,CHARLOTTE_HORNETS,92,101,8625,9
8625,2019-01-29,2019-01-28,GOLDEN_STATE_WARRIORS,INDIANA_PACERS,132,100,8626,32
8626,2019-01-29,2019-01-28,BROOKLYN_NETS,BOSTON_CELTICS,104,112,8627,8
8627,2019-01-29,2019-01-28,DENVER_NUGGETS,MEMPHIS_GRIZZLIES,95,92,8628,3
8628,2019-01-29,2019-01-28,ATLANTA_HAWKS,LOS_ANGELES_CLIPPERS,123,118,8629,5
8629,2019-01-30,2019-01-29,WASHINGTON_WIZARDS,CLEVELAND_CAVALIERS,113,116,8630,3
8630,2019-01-30,2019-01-29,MILWAUKEE_BUCKS,DETROIT_PISTONS,115,105,8631,10
8631,2019-01-30,2019-01-29,OKLAHOMA_CITY_THUNDER,ORLANDO_MAGIC,126,117,8632,9
8632,2019-01-30,2019-01-29,CHICAGO_BULLS,BROOKLYN_NETS,117,122,8633,5
8633,2019-01-30,2019-01-29,NEW_ORLEANS_PELICANS,HOUSTON_ROCKETS,121,116,8634,5
8634,2019-01-30,2019-01-29,PHOENIX_SUNS,SAN_ANTONIO_SPURS,124,126,8635,2
8635,2019-01-30,2019-01-29,PHILADELPHIA_76ERS,LOS_ANGELES_LAKERS,121,105,8636,16
8636,2019-01-31,2019-01-30,CHARLOTTE_HORNETS,BOSTON_CELTICS,94,126,8637,32
8637,2019-01-31,2019-01-30,CHICAGO_BULLS,MIAMI_HEAT,105,89,8638,16
8638,2019-01-31,2019-01-30,DALLAS_MAVERICKS,NEW_YORK_KNICKS,114,90,8639,24
8639,2019-01-31,2019-01-30,MEMPHIS_GRIZZLIES,MINNESOTA_TIMBERWOLVES,97,99,8640,2
8640,2019-01-31,2019-01-30,DENVER_NUGGETS,NEW_ORLEANS_PELICANS,105,99,8641,6
8641,2019-01-31,2019-01-30,INDIANA_PACERS,WASHINGTON_WIZARDS,89,107,8642,18
8642,2019-01-31,2019-01-30,ATLANTA_HAWKS,SACRAMENTO_KINGS,113,135,8643,22
8643,2019-01-31,2019-01-30,UTAH_JAZZ,PORTLAND_TRAIL_BLAZERS,105,132,8644,27
8644,2019-02-01,2019-01-31,DALLAS_MAVERICKS,DETROIT_PISTONS,89,93,8645,4
8645,2019-02-01,2019-01-31,INDIANA_PACERS,ORLANDO_MAGIC,100,107,8646,7
8646,2019-02-01,2019-01-31,MILWAUKEE_BUCKS,TORONTO_RAPTORS,105,92,8647,13
8647,2019-02-01,2019-01-31,BROOKLYN_NETS,SAN_ANTONIO_SPURS,114,117,8648,3
8648,2019-02-01,2019-01-31,PHILADELPHIA_76ERS,GOLDEN_STATE_WARRIORS,113,104,8649,9
8649,2019-02-01,2019-01-31,LOS_ANGELES_LAKERS,LOS_ANGELES_CLIPPERS,123,120,8650,3
8650,2019-02-02,2019-02-01,MEMPHIS_GRIZZLIES,CHARLOTTE_HORNETS,92,100,8651,8
8651,2019-02-02,2019-02-01,BOSTON_CELTICS,NEW_YORK_KNICKS,113,99,8652,14
8652,2019-02-02,2019-02-01,OKLAHOMA_CITY_THUNDER,MIAMI_HEAT,118,102,8653,16
8653,2019-02-02,2019-02-01,ATLANTA_HAWKS,UTAH_JAZZ,112,128,8654,16
8654,2019-02-02,2019-02-01,HOUSTON_ROCKETS,DENVER_NUGGETS,122,136,8655,14
8655,2019-02-02,2019-02-01,LOS_ANGELES_CLIPPERS,DETROIT_PISTONS,111,101,8656,10
8656,2019-02-03,2019-02-02,CHICAGO_BULLS,CHARLOTTE_HORNETS,118,125,8657,7
8657,2019-02-03,2019-02-02,BROOKLYN_NETS,ORLANDO_MAGIC,89,102,8658,13
8658,2019-02-03,2019-02-02,MILWAUKEE_BUCKS,WASHINGTON_WIZARDS,131,115,8659,16
8659,2019-02-03,2019-02-02,DALLAS_MAVERICKS,CLEVELAND_CAVALIERS,111,98,8660,13
8660,2019-02-03,2019-02-02,INDIANA_PACERS,MIAMI_HEAT,95,88,8661,7
8661,2019-02-03,2019-02-02,LOS_ANGELES_LAKERS,GOLDEN_STATE_WARRIORS,101,115,8662,14
8662,2019-02-03,2019-02-02,NEW_ORLEANS_PELICANS,SAN_ANTONIO_SPURS,108,113,8663,5
8663,2019-02-03,2019-02-02,DENVER_NUGGETS,MINNESOTA_TIMBERWOLVES,107,106,8664,1
8664,2019-02-03,2019-02-02,ATLANTA_HAWKS,PHOENIX_SUNS,118,112,8665,6
8665,2019-02-03,2019-02-02,HOUSTON_ROCKETS,UTAH_JAZZ,125,98,8666,27
8666,2019-02-03,2019-02-02,PHILADELPHIA_76ERS,SACRAMENTO_KINGS,108,115,8667,7
8667,2019-02-03,2019-02-02,MEMPHIS_GRIZZLIES,NEW_YORK_KNICKS,96,84,8668,12
8668,2019-02-03,2019-02-02,OKLAHOMA_CITY_THUNDER,BOSTON_CELTICS,129,134,8669,5
8669,2019-02-03,2019-02-02,LOS_ANGELES_CLIPPERS,TORONTO_RAPTORS,103,121,8670,18
8670,2019-02-05,2019-02-04,DENVER_NUGGETS,DETROIT_PISTONS,103,129,8671,26
8671,2019-02-05,2019-02-04,ATLANTA_HAWKS,WASHINGTON_WIZARDS,137,129,8672,8
8672,2019-02-05,2019-02-04,MILWAUKEE_BUCKS,BROOKLYN_NETS,113,94,8673,19
8673,2019-02-05,2019-02-04,INDIANA_PACERS,NEW_ORLEANS_PELICANS,109,107,8674,2
8674,2019-02-05,2019-02-04,HOUSTON_ROCKETS,PHOENIX_SUNS,118,110,8675,8
8675,2019-02-05,2019-02-04,SAN_ANTONIO_SPURS,SACRAMENTO_KINGS,112,127,8676,15
8676,2019-02-06,2019-02-05,LOS_ANGELES_CLIPPERS,CHARLOTTE_HORNETS,117,115,8677,2
8677,2019-02-06,2019-02-05,BOSTON_CELTICS,CLEVELAND_CAVALIERS,103,96,8678,7
8678,2019-02-06,2019-02-05,LOS_ANGELES_LAKERS,INDIANA_PACERS,94,136,8679,42
8679,2019-02-06,2019-02-05,DETROIT_PISTONS,NEW_YORK_KNICKS,105,92,8680,13
8680,2019-02-06,2019-02-05,MINNESOTA_TIMBERWOLVES,MEMPHIS_GRIZZLIES,106,108,8681,2
8681,2019-02-06,2019-02-05,ORLANDO_MAGIC,OKLAHOMA_CITY_THUNDER,122,132,8682,10
8682,2019-02-06,2019-02-05,TORONTO_RAPTORS,PHILADELPHIA_76ERS,119,107,8683,12
8683,2019-02-06,2019-02-05,MIAMI_HEAT,PORTLAND_TRAIL_BLAZERS,118,108,8684,10
8684,2019-02-07,2019-02-06,DENVER_NUGGETS,BROOKLYN_NETS,130,135,8685,5
8685,2019-02-07,2019-02-06,NEW_ORLEANS_PELICANS,CHICAGO_BULLS,125,120,8686,5
8686,2019-02-07,2019-02-06,WASHINGTON_WIZARDS,MILWAUKEE_BUCKS,129,148,8687,19
8687,2019-02-07,2019-02-06,CHARLOTTE_HORNETS,DALLAS_MAVERICKS,93,99,8688,6
8688,2019-02-07,2019-02-06,PHOENIX_SUNS,UTAH_JAZZ,88,116,8689,28
8689,2019-02-07,2019-02-06,HOUSTON_ROCKETS,SACRAMENTO_KINGS,127,101,8690,26
8690,2019-02-07,2019-02-06,SAN_ANTONIO_SPURS,GOLDEN_STATE_WARRIORS,102,141,8691,39
8691,2019-02-08,2019-02-07,LOS_ANGELES_CLIPPERS,INDIANA_PACERS,92,116,8692,24
8692,2019-02-08,2019-02-07,MINNESOTA_TIMBERWOLVES,ORLANDO_MAGIC,112,122,8693,10
8693,2019-02-08,2019-02-07,TORONTO_RAPTORS,ATLANTA_HAWKS,119,101,8694,18
8694,2019-02-08,2019-02-07,LOS_ANGELES_LAKERS,BOSTON_CELTICS,129,128,8695,1
8695,2019-02-08,2019-02-07,MEMPHIS_GRIZZLIES,OKLAHOMA_CITY_THUNDER,95,117,8696,22
8696,2019-02-08,2019-02-07,SAN_ANTONIO_SPURS,PORTLAND_TRAIL_BLAZERS,118,127,8697,9
8697,2019-02-09,2019-02-08,NEW_YORK_KNICKS,DETROIT_PISTONS,103,120,8698,17
8698,2019-02-09,2019-02-08,DENVER_NUGGETS,PHILADELPHIA_76ERS,110,117,8699,7
8699,2019-02-09,2019-02-08,CLEVELAND_CAVALIERS,WASHINGTON_WIZARDS,106,119,8700,13
8700,2019-02-09,2019-02-08,CHICAGO_BULLS,BROOKLYN_NETS,125,106,8701,19
8701,2019-02-09,2019-02-08,MILWAUKEE_BUCKS,DALLAS_MAVERICKS,122,107,8702,15
8702,2019-02-09,2019-02-08,GOLDEN_STATE_WARRIORS,PHOENIX_SUNS,117,107,8703,10
8703,2019-02-09,2019-02-08,MINNESOTA_TIMBERWOLVES,NEW_ORLEANS_PELICANS,117,122,8704,5
8704,2019-02-09,2019-02-08,MIAMI_HEAT,SACRAMENTO_KINGS,96,102,8705,6
8705,2019-02-09,2019-02-08,SAN_ANTONIO_SPURS,UTAH_JAZZ,105,125,8706,20
8706,2019-02-10,2019-02-09,CLEVELAND_CAVALIERS,INDIANA_PACERS,90,105,8707,15
8707,2019-02-10,2019-02-09,CHARLOTTE_HORNETS,ATLANTA_HAWKS,129,120,8708,9
8708,2019-02-10,2019-02-09,TORONTO_RAPTORS,NEW_YORK_KNICKS,104,99,8709,5
8709,2019-02-10,2019-02-09,LOS_ANGELES_CLIPPERS,BOSTON_CELTICS,123,112,8710,11
8710,2019-02-10,2019-02-09,WASHINGTON_WIZARDS,CHICAGO_BULLS,134,125,8711,9
8711,2019-02-10,2019-02-09,NEW_ORLEANS_PELICANS,MEMPHIS_GRIZZLIES,90,99,8712,9
8712,2019-02-10,2019-02-09,OKLAHOMA_CITY_THUNDER,HOUSTON_ROCKETS,117,112,8713,5
8713,2019-02-10,2019-02-09,ORLANDO_MAGIC,MILWAUKEE_BUCKS,103,83,8714,20
8714,2019-02-10,2019-02-09,PORTLAND_TRAIL_BLAZERS,DALLAS_MAVERICKS,101,102,8715,1
8715,2019-02-10,2019-02-09,LOS_ANGELES_LAKERS,PHILADELPHIA_76ERS,120,143,8716,23
8716,2019-02-10,2019-02-09,PHOENIX_SUNS,SACRAMENTO_KINGS,104,117,8717,13
8717,2019-02-11,2019-02-10,ORLANDO_MAGIC,ATLANTA_HAWKS,124,108,8718,16
8718,2019-02-11,2019-02-10,MIAMI_HEAT,GOLDEN_STATE_WARRIORS,118,120,8719,2
8719,2019-02-12,2019-02-11,NEW_YORK_KNICKS,CLEVELAND_CAVALIERS,104,107,8720,3
8720,2019-02-12,2019-02-11,WASHINGTON_WIZARDS,DETROIT_PISTONS,112,121,8721,9
8721,2019-02-12,2019-02-11,CHARLOTTE_HORNETS,INDIANA_PACERS,90,99,8722,9
8722,2019-02-12,2019-02-11,BROOKLYN_NETS,TORONTO_RAPTORS,125,127,8723,2
8723,2019-02-12,2019-02-11,MILWAUKEE_BUCKS,CHICAGO_BULLS,112,99,8724,13
8724,2019-02-12,2019-02-11,DALLAS_MAVERICKS,HOUSTON_ROCKETS,104,120,8725,16
8725,2019-02-12,2019-02-11,LOS_ANGELES_CLIPPERS,MINNESOTA_TIMBERWOLVES,120,130,8726,10
8726,2019-02-12,2019-02-11,PORTLAND_TRAIL_BLAZERS,OKLAHOMA_CITY_THUNDER,111,120,8727,9
8727,2019-02-12,2019-02-11,MIAMI_HEAT,DENVER_NUGGETS,87,103,8728,16
8728,2019-02-13,2019-02-12,LOS_ANGELES_LAKERS,ATLANTA_HAWKS,113,117,8729,4
8729,2019-02-13,2019-02-12,SAN_ANTONIO_SPURS,MEMPHIS_GRIZZLIES,108,107,8730,1
8730,2019-02-13,2019-02-12,ORLANDO_MAGIC,NEW_ORLEANS_PELICANS,118,88,8731,30
8731,2019-02-13,2019-02-12,BOSTON_CELTICS,PHILADELPHIA_76ERS,112,109,8732,3
8732,2019-02-13,2019-02-12,UTAH_JAZZ,GOLDEN_STATE_WARRIORS,108,115,8733,7
8733,2019-02-14,2019-02-13,BROOKLYN_NETS,CLEVELAND_CAVALIERS,148,139,8734,9
8734,2019-02-14,2019-02-13,MILWAUKEE_BUCKS,INDIANA_PACERS,106,97,8735,9
8735,2019-02-14,2019-02-13,DETROIT_PISTONS,BOSTON_CELTICS,110,118,8736,8
8736,2019-02-14,2019-02-13,PHILADELPHIA_76ERS,NEW_YORK_KNICKS,126,111,8737,15
8737,2019-02-14,2019-02-13,WASHINGTON_WIZARDS,TORONTO_RAPTORS,120,129,8738,9
8738,2019-02-14,2019-02-13,MEMPHIS_GRIZZLIES,CHICAGO_BULLS,110,122,8739,12
8739,2019-02-14,2019-02-13,HOUSTON_ROCKETS,MINNESOTA_TIMBERWOLVES,111,121,8740,10
8740,2019-02-14,2019-02-13,MIAMI_HEAT,DALLAS_MAVERICKS,112,101,8741,11
8741,2019-02-14,2019-02-13,SACRAMENTO_KINGS,DENVER_NUGGETS,118,120,8742,2
8742,2019-02-14,2019-02-13,PHOENIX_SUNS,LOS_ANGELES_CLIPPERS,107,134,8743,27
8743,2019-02-14,2019-02-13,GOLDEN_STATE_WARRIORS,PORTLAND_TRAIL_BLAZERS,107,129,8744,22
8744,2019-02-15,2019-02-14,CHARLOTTE_HORNETS,ORLANDO_MAGIC,89,127,8745,38
8745,2019-02-15,2019-02-14,NEW_YORK_KNICKS,ATLANTA_HAWKS,106,91,8746,15
8746,2019-02-15,2019-02-14,OKLAHOMA_CITY_THUNDER,NEW_ORLEANS_PELICANS,122,131,8747,9
8747,2019-02-22,2019-02-21,PHOENIX_SUNS,CLEVELAND_CAVALIERS,98,111,8748,13
8748,2019-02-22,2019-02-21,MIAMI_HEAT,PHILADELPHIA_76ERS,102,106,8749,4
8749,2019-02-22,2019-02-21,PORTLAND_TRAIL_BLAZERS,BROOKLYN_NETS,113,99,8750,14
8750,2019-02-22,2019-02-21,BOSTON_CELTICS,MILWAUKEE_BUCKS,97,98,8751,1
8751,2019-02-22,2019-02-21,SACRAMENTO_KINGS,GOLDEN_STATE_WARRIORS,123,125,8752,2
8752,2019-02-22,2019-02-21,HOUSTON_ROCKETS,LOS_ANGELES_LAKERS,106,111,8753,5
8753,2019-02-23,2019-02-22,WASHINGTON_WIZARDS,CHARLOTTE_HORNETS,110,123,8754,13
8754,2019-02-23,2019-02-22,NEW_ORLEANS_PELICANS,INDIANA_PACERS,111,126,8755,15
8755,2019-02-23,2019-02-22,CHICAGO_BULLS,ORLANDO_MAGIC,110,109,8756,1
8756,2019-02-23,2019-02-22,SAN_ANTONIO_SPURS,TORONTO_RAPTORS,117,120,8757,3
8757,2019-02-23,2019-02-22,DETROIT_PISTONS,ATLANTA_HAWKS,125,122,8758,3
8758,2019-02-23,2019-02-22,MINNESOTA_TIMBERWOLVES,NEW_YORK_KNICKS,115,104,8759,11
8759,2019-02-23,2019-02-22,LOS_ANGELES_CLIPPERS,MEMPHIS_GRIZZLIES,112,106,8760,6
8760,2019-02-23,2019-02-22,DENVER_NUGGETS,DALLAS_MAVERICKS,114,104,8761,10
8761,2019-02-23,2019-02-22,UTAH_JAZZ,OKLAHOMA_CITY_THUNDER,147,148,8762,1
8762,2019-02-23,2019-02-22,PORTLAND_TRAIL_BLAZERS,PHILADELPHIA_76ERS,130,115,8763,15
8763,2019-02-24,2019-02-23,PHOENIX_SUNS,ATLANTA_HAWKS,112,120,8764,8
8764,2019-02-24,2019-02-23,BROOKLYN_NETS,CHARLOTTE_HORNETS,117,115,8765,2
8765,2019-02-24,2019-02-23,MEMPHIS_GRIZZLIES,CLEVELAND_CAVALIERS,107,112,8766,5
8766,2019-02-24,2019-02-23,LOS_ANGELES_LAKERS,NEW_ORLEANS_PELICANS,115,128,8767,13
8767,2019-02-24,2019-02-23,INDIANA_PACERS,WASHINGTON_WIZARDS,119,112,8768,7
8768,2019-02-24,2019-02-23,DETROIT_PISTONS,MIAMI_HEAT,119,96,8769,23
8769,2019-02-24,2019-02-23,BOSTON_CELTICS,CHICAGO_BULLS,116,126,8770,10
8770,2019-02-24,2019-02-23,SACRAMENTO_KINGS,OKLAHOMA_CITY_THUNDER,119,116,8771,3
8771,2019-02-24,2019-02-23,HOUSTON_ROCKETS,GOLDEN_STATE_WARRIORS,118,112,8772,6
8772,2019-02-24,2019-02-23,MINNESOTA_TIMBERWOLVES,MILWAUKEE_BUCKS,128,140,8773,12
8773,2019-02-24,2019-02-23,DALLAS_MAVERICKS,UTAH_JAZZ,109,125,8774,16
8774,2019-02-24,2019-02-23,ORLANDO_MAGIC,TORONTO_RAPTORS,113,98,8775,15
8775,2019-02-24,2019-02-23,LOS_ANGELES_CLIPPERS,DENVER_NUGGETS,96,123,8776,27
8776,2019-02-25,2019-02-24,SAN_ANTONIO_SPURS,NEW_YORK_KNICKS,118,130,8777,12
8777,2019-02-26,2019-02-25,GOLDEN_STATE_WARRIORS,CHARLOTTE_HORNETS,121,110,8778,11
8778,2019-02-26,2019-02-25,PORTLAND_TRAIL_BLAZERS,CLEVELAND_CAVALIERS,123,110,8779,13
8779,2019-02-26,2019-02-25,INDIANA_PACERS,DETROIT_PISTONS,109,113,8780,4
8780,2019-02-26,2019-02-25,SAN_ANTONIO_SPURS,BROOKLYN_NETS,85,101,8781,16
8781,2019-02-26,2019-02-25,PHOENIX_SUNS,MIAMI_HEAT,124,121,8782,3
8782,2019-02-26,2019-02-25,MILWAUKEE_BUCKS,CHICAGO_BULLS,117,106,8783,11
8783,2019-02-26,2019-02-25,ATLANTA_HAWKS,HOUSTON_ROCKETS,111,119,8784,8
8784,2019-02-26,2019-02-25,LOS_ANGELES_LAKERS,MEMPHIS_GRIZZLIES,105,110,8785,5
8785,2019-02-26,2019-02-25,SACRAMENTO_KINGS,MINNESOTA_TIMBERWOLVES,105,112,8786,7
8786,2019-02-26,2019-02-25,PHILADELPHIA_76ERS,NEW_ORLEANS_PELICANS,111,110,8787,1
8787,2019-02-26,2019-02-25,DALLAS_MAVERICKS,LOS_ANGELES_CLIPPERS,112,121,8788,9
8788,2019-02-27,2019-02-26,ORLANDO_MAGIC,NEW_YORK_KNICKS,103,108,8789,5
8789,2019-02-27,2019-02-26,BOSTON_CELTICS,TORONTO_RAPTORS,95,118,8790,23
8790,2019-02-27,2019-02-26,OKLAHOMA_CITY_THUNDER,DENVER_NUGGETS,112,121,8791,9
8791,2019-02-28,2019-02-27,HOUSTON_ROCKETS,CHARLOTTE_HORNETS,118,113,8792,5
8792,2019-02-28,2019-02-27,MINNESOTA_TIMBERWOLVES,ATLANTA_HAWKS,123,131,8793,8
8793,2019-02-28,2019-02-27,WASHINGTON_WIZARDS,BROOKLYN_NETS,125,116,8794,9
8794,2019-02-28,2019-02-27,GOLDEN_STATE_WARRIORS,MIAMI_HEAT,125,126,8795,1
8795,2019-02-28,2019-02-27,PORTLAND_TRAIL_BLAZERS,BOSTON_CELTICS,97,92,8796,5
8796,2019-02-28,2019-02-27,CHICAGO_BULLS,MEMPHIS_GRIZZLIES,109,107,8797,2
8797,2019-02-28,2019-02-27,INDIANA_PACERS,DALLAS_MAVERICKS,101,110,8798,9
8798,2019-02-28,2019-02-27,DETROIT_PISTONS,SAN_ANTONIO_SPURS,93,105,8799,12
8799,2019-02-28,2019-02-27,LOS_ANGELES_CLIPPERS,UTAH_JAZZ,105,111,8800,6
8800,2019-02-28,2019-02-27,MILWAUKEE_BUCKS,SACRAMENTO_KINGS,141,140,8801,1
8801,2019-02-28,2019-02-27,NEW_ORLEANS_PELICANS,LOS_ANGELES_LAKERS,119,125,8802,6
8802,2019-03-01,2019-02-28,MINNESOTA_TIMBERWOLVES,INDIANA_PACERS,115,122,8803,7
8803,2019-03-01,2019-02-28,GOLDEN_STATE_WARRIORS,ORLANDO_MAGIC,96,103,8804,7
8804,2019-03-01,2019-02-28,CLEVELAND_CAVALIERS,NEW_YORK_KNICKS,125,118,8805,7
8805,2019-03-01,2019-02-28,MIAMI_HEAT,HOUSTON_ROCKETS,118,121,8806,3
8806,2019-03-01,2019-02-28,PHILADELPHIA_76ERS,OKLAHOMA_CITY_THUNDER,108,104,8807,4
8807,2019-03-01,2019-02-28,UTAH_JAZZ,DENVER_NUGGETS,111,104,8808,7
8808,2019-03-02,2019-03-01,CHICAGO_BULLS,ATLANTA_HAWKS,168,161,8809,7
8809,2019-03-02,2019-03-01,CHARLOTTE_HORNETS,BROOKLYN_NETS,123,112,8810,11
8810,2019-03-02,2019-03-01,WASHINGTON_WIZARDS,BOSTON_CELTICS,96,107,8811,11
8811,2019-03-02,2019-03-01,PORTLAND_TRAIL_BLAZERS,TORONTO_RAPTORS,117,119,8812,2
8812,2019-03-02,2019-03-01,NEW_ORLEANS_PELICANS,PHOENIX_SUNS,130,116,8813,14
8813,2019-03-02,2019-03-01,LOS_ANGELES_CLIPPERS,SACRAMENTO_KINGS,116,109,8814,7
8814,2019-03-02,2019-03-01,MILWAUKEE_BUCKS,LOS_ANGELES_LAKERS,131,120,8815,11
8815,2019-03-02,2019-03-01,DETROIT_PISTONS,CLEVELAND_CAVALIERS,129,93,8816,36
8816,2019-03-03,2019-03-02,ORLANDO_MAGIC,INDIANA_PACERS,117,112,8817,5
8817,2019-03-03,2019-03-02,BROOKLYN_NETS,MIAMI_HEAT,88,117,8818,29
8818,2019-03-03,2019-03-02,MEMPHIS_GRIZZLIES,DALLAS_MAVERICKS,111,81,8819,30
8819,2019-03-03,2019-03-02,GOLDEN_STATE_WARRIORS,PHILADELPHIA_76ERS,120,117,8820,3
8820,2019-03-03,2019-03-02,OKLAHOMA_CITY_THUNDER,SAN_ANTONIO_SPURS,102,116,8821,14
8821,2019-03-03,2019-03-02,NEW_ORLEANS_PELICANS,DENVER_NUGGETS,120,112,8822,8
8822,2019-03-03,2019-03-02,LOS_ANGELES_LAKERS,PHOENIX_SUNS,109,118,8823,9
8823,2019-03-03,2019-03-02,MILWAUKEE_BUCKS,UTAH_JAZZ,111,115,8824,4
8824,2019-03-03,2019-03-02,PORTLAND_TRAIL_BLAZERS,CHARLOTTE_HORNETS,118,108,8825,10
8825,2019-03-03,2019-03-02,HOUSTON_ROCKETS,BOSTON_CELTICS,115,104,8826,11
8826,2019-03-03,2019-03-02,ATLANTA_HAWKS,CHICAGO_BULLS,123,118,8827,5
8827,2019-03-03,2019-03-02,NEW_YORK_KNICKS,LOS_ANGELES_CLIPPERS,107,128,8828,21
8828,2019-03-03,2019-03-02,ORLANDO_MAGIC,CLEVELAND_CAVALIERS,93,107,8829,14
8829,2019-03-03,2019-03-02,TORONTO_RAPTORS,DETROIT_PISTONS,107,112,8830,5
8830,2019-03-03,2019-03-02,MINNESOTA_TIMBERWOLVES,WASHINGTON_WIZARDS,121,135,8831,14
8831,2019-03-04,2019-03-03,MEMPHIS_GRIZZLIES,OKLAHOMA_CITY_THUNDER,95,99,8832,4
8832,2019-03-05,2019-03-04,DALLAS_MAVERICKS,BROOKLYN_NETS,88,127,8833,39
8833,2019-03-05,2019-03-04,ATLANTA_HAWKS,MIAMI_HEAT,113,114,8834,1
8834,2019-03-05,2019-03-04,DENVER_NUGGETS,SAN_ANTONIO_SPURS,103,104,8835,1
8835,2019-03-05,2019-03-04,MILWAUKEE_BUCKS,PHOENIX_SUNS,105,114,8836,9
8836,2019-03-05,2019-03-04,NEW_ORLEANS_PELICANS,UTAH_JAZZ,115,112,8837,3
8837,2019-03-05,2019-03-04,NEW_YORK_KNICKS,SACRAMENTO_KINGS,108,115,8838,7
8838,2019-03-05,2019-03-04,LOS_ANGELES_CLIPPERS,LOS_ANGELES_LAKERS,113,105,8839,8
8839,2019-03-06,2019-03-05,CHICAGO_BULLS,INDIANA_PACERS,96,105,8840,9
8840,2019-03-06,2019-03-05,ORLANDO_MAGIC,PHILADELPHIA_76ERS,106,114,8841,8
8841,2019-03-06,2019-03-05,PORTLAND_TRAIL_BLAZERS,MEMPHIS_GRIZZLIES,111,120,8842,9
8842,2019-03-06,2019-03-05,OKLAHOMA_CITY_THUNDER,MINNESOTA_TIMBERWOLVES,120,131,8843,11
8843,2019-03-06,2019-03-05,HOUSTON_ROCKETS,TORONTO_RAPTORS,107,95,8844,12
8844,2019-03-06,2019-03-05,BOSTON_CELTICS,GOLDEN_STATE_WARRIORS,128,95,8845,33
8845,2019-03-07,2019-03-06,MIAMI_HEAT,CHARLOTTE_HORNETS,91,84,8846,7
8846,2019-03-07,2019-03-06,MINNESOTA_TIMBERWOLVES,DETROIT_PISTONS,114,131,8847,17
8847,2019-03-07,2019-03-06,DALLAS_MAVERICKS,WASHINGTON_WIZARDS,123,132,8848,9
8848,2019-03-07,2019-03-06,SAN_ANTONIO_SPURS,ATLANTA_HAWKS,111,104,8849,7
8849,2019-03-07,2019-03-06,CLEVELAND_CAVALIERS,BROOKLYN_NETS,107,113,8850,6
8850,2019-03-07,2019-03-06,PHILADELPHIA_76ERS,CHICAGO_BULLS,107,108,8851,1
8851,2019-03-07,2019-03-06,UTAH_JAZZ,NEW_ORLEANS_PELICANS,114,104,8852,10
8852,2019-03-07,2019-03-06,NEW_YORK_KNICKS,PHOENIX_SUNS,96,107,8853,11
8853,2019-03-07,2019-03-06,BOSTON_CELTICS,SACRAMENTO_KINGS,111,109,8854,2
8854,2019-03-07,2019-03-06,DENVER_NUGGETS,LOS_ANGELES_LAKERS,115,99,8855,16
8855,2019-03-08,2019-03-07,INDIANA_PACERS,MILWAUKEE_BUCKS,98,117,8856,19
8856,2019-03-08,2019-03-07,OKLAHOMA_CITY_THUNDER,PORTLAND_TRAIL_BLAZERS,129,121,8857,8
8857,2019-03-09,2019-03-08,WASHINGTON_WIZARDS,CHARLOTTE_HORNETS,111,112,8858,1
8858,2019-03-09,2019-03-08,DALLAS_MAVERICKS,ORLANDO_MAGIC,106,111,8859,5
8859,2019-03-09,2019-03-08,DETROIT_PISTONS,CHICAGO_BULLS,112,104,8860,8
8860,2019-03-09,2019-03-08,PHILADELPHIA_76ERS,HOUSTON_ROCKETS,91,107,8861,16
8861,2019-03-09,2019-03-08,UTAH_JAZZ,MEMPHIS_GRIZZLIES,104,114,8862,10
8862,2019-03-09,2019-03-08,CLEVELAND_CAVALIERS,MIAMI_HEAT,110,126,8863,16
8863,2019-03-09,2019-03-08,TORONTO_RAPTORS,NEW_ORLEANS_PELICANS,127,104,8864,23
8864,2019-03-09,2019-03-08,DENVER_NUGGETS,GOLDEN_STATE_WARRIORS,105,122,8865,17
8865,2019-03-09,2019-03-08,OKLAHOMA_CITY_THUNDER,LOS_ANGELES_CLIPPERS,110,118,8866,8
8866,2019-03-09,2019-03-08,SACRAMENTO_KINGS,NEW_YORK_KNICKS,102,94,8867,8
8867,2019-03-10,2019-03-09,BROOKLYN_NETS,ATLANTA_HAWKS,114,112,8868,2
8868,2019-03-10,2019-03-09,WASHINGTON_WIZARDS,MINNESOTA_TIMBERWOLVES,130,135,8869,5
8869,2019-03-10,2019-03-09,BOSTON_CELTICS,LOS_ANGELES_LAKERS,120,107,8870,13
8870,2019-03-10,2019-03-09,CHARLOTTE_HORNETS,MILWAUKEE_BUCKS,114,131,8871,17
8871,2019-03-10,2019-03-09,PHOENIX_SUNS,PORTLAND_TRAIL_BLAZERS,120,127,8872,7
8872,2019-03-10,2019-03-09,CHICAGO_BULLS,DETROIT_PISTONS,108,131,8873,23
8873,2019-03-10,2019-03-09,TORONTO_RAPTORS,MIAMI_HEAT,125,104,8874,21
8874,2019-03-10,2019-03-09,INDIANA_PACERS,PHILADELPHIA_76ERS,89,106,8875,17
8875,2019-03-10,2019-03-09,NEW_ORLEANS_PELICANS,ATLANTA_HAWKS,116,128,8876,12
8876,2019-03-10,2019-03-09,ORLANDO_MAGIC,MEMPHIS_GRIZZLIES,97,105,8877,8
8877,2019-03-10,2019-03-09,HOUSTON_ROCKETS,DALLAS_MAVERICKS,94,93,8878,1
8878,2019-03-11,2019-03-10,NEW_YORK_KNICKS,MINNESOTA_TIMBERWOLVES,92,103,8879,11
8879,2019-03-11,2019-03-10,MILWAUKEE_BUCKS,SAN_ANTONIO_SPURS,114,121,8880,7
8880,2019-03-11,2019-03-10,PHOENIX_SUNS,GOLDEN_STATE_WARRIORS,115,111,8881,4
8881,2019-03-11,2019-03-10,TORONTO_RAPTORS,CLEVELAND_CAVALIERS,101,126,8882,25
8882,2019-03-11,2019-03-10,SACRAMENTO_KINGS,WASHINGTON_WIZARDS,115,121,8883,6
8883,2019-03-11,2019-03-10,DETROIT_PISTONS,BROOKLYN_NETS,75,103,8884,28
8884,2019-03-12,2019-03-11,CHARLOTTE_HORNETS,HOUSTON_ROCKETS,106,118,8885,12
8885,2019-03-12,2019-03-11,OKLAHOMA_CITY_THUNDER,UTAH_JAZZ,98,89,8886,9
8886,2019-03-12,2019-03-11,BOSTON_CELTICS,LOS_ANGELES_CLIPPERS,115,140,8887,25
8887,2019-03-12,2019-03-11,NEW_YORK_KNICKS,INDIANA_PACERS,98,103,8888,5
8888,2019-03-12,2019-03-11,CLEVELAND_CAVALIERS,PHILADELPHIA_76ERS,99,106,8889,7
8889,2019-03-13,2019-03-12,LOS_ANGELES_LAKERS,CHICAGO_BULLS,123,107,8890,16
8890,2019-03-13,2019-03-12,SAN_ANTONIO_SPURS,DALLAS_MAVERICKS,112,105,8891,7
8891,2019-03-13,2019-03-12,MILWAUKEE_BUCKS,NEW_ORLEANS_PELICANS,130,113,8892,17
8892,2019-03-13,2019-03-12,MINNESOTA_TIMBERWOLVES,DENVER_NUGGETS,107,133,8893,26
8893,2019-03-13,2019-03-12,PORTLAND_TRAIL_BLAZERS,LOS_ANGELES_CLIPPERS,125,104,8894,21
8894,2019-03-13,2019-03-12,BROOKLYN_NETS,OKLAHOMA_CITY_THUNDER,96,108,8895,12
8895,2019-03-13,2019-03-12,ORLANDO_MAGIC,WASHINGTON_WIZARDS,90,100,8896,10
8896,2019-03-13,2019-03-12,MEMPHIS_GRIZZLIES,ATLANTA_HAWKS,111,132,8897,21
8897,2019-03-13,2019-03-12,DETROIT_PISTONS,MIAMI_HEAT,74,108,8898,34
8898,2019-03-14,2019-03-13,GOLDEN_STATE_WARRIORS,HOUSTON_ROCKETS,106,104,8899,2
8899,2019-03-14,2019-03-13,UTAH_JAZZ,PHOENIX_SUNS,114,97,8900,17
8900,2019-03-14,2019-03-13,OKLAHOMA_CITY_THUNDER,INDIANA_PACERS,106,108,8901,2
8901,2019-03-14,2019-03-13,CLEVELAND_CAVALIERS,ORLANDO_MAGIC,91,120,8902,29
8902,2019-03-14,2019-03-13,SACRAMENTO_KINGS,BOSTON_CELTICS,120,126,8903,6
8903,2019-03-15,2019-03-14,LOS_ANGELES_LAKERS,TORONTO_RAPTORS,98,111,8904,13
8904,2019-03-15,2019-03-14,MINNESOTA_TIMBERWOLVES,UTAH_JAZZ,100,120,8905,20
8905,2019-03-15,2019-03-14,DALLAS_MAVERICKS,DENVER_NUGGETS,99,100,8906,1
8906,2019-03-15,2019-03-14,LOS_ANGELES_LAKERS,DETROIT_PISTONS,97,111,8907,14
8907,2019-03-15,2019-03-14,SACRAMENTO_KINGS,PHILADELPHIA_76ERS,114,123,8908,9
8908,2019-03-15,2019-03-14,CHARLOTTE_HORNETS,WASHINGTON_WIZARDS,116,110,8909,6
8909,2019-03-16,2019-03-15,PHOENIX_SUNS,HOUSTON_ROCKETS,102,108,8910,6
8910,2019-03-16,2019-03-15,MILWAUKEE_BUCKS,MIAMI_HEAT,113,98,8911,15
8911,2019-03-16,2019-03-15,PORTLAND_TRAIL_BLAZERS,NEW_ORLEANS_PELICANS,122,110,8912,12
8912,2019-03-16,2019-03-15,NEW_YORK_KNICKS,SAN_ANTONIO_SPURS,83,109,8913,26
8913,2019-03-16,2019-03-15,CHICAGO_BULLS,LOS_ANGELES_CLIPPERS,121,128,8914,7
8914,2019-03-16,2019-03-15,ATLANTA_HAWKS,BOSTON_CELTICS,120,129,8915,9
8915,2019-03-16,2019-03-15,PHOENIX_SUNS,NEW_ORLEANS_PELICANS,138,136,8916,2
8916,2019-03-16,2019-03-15,MEMPHIS_GRIZZLIES,WASHINGTON_WIZARDS,128,135,8917,7
8917,2019-03-17,2019-03-16,CLEVELAND_CAVALIERS,DALLAS_MAVERICKS,116,121,8918,5
8918,2019-03-17,2019-03-16,GOLDEN_STATE_WARRIORS,OKLAHOMA_CITY_THUNDER,110,88,8919,22
8919,2019-03-17,2019-03-16,PORTLAND_TRAIL_BLAZERS,SAN_ANTONIO_SPURS,103,108,8920,5
8920,2019-03-17,2019-03-16,INDIANA_PACERS,DENVER_NUGGETS,100,102,8921,2
8921,2019-03-17,2019-03-16,BROOKLYN_NETS,UTAH_JAZZ,98,114,8922,16
8922,2019-03-17,2019-03-16,LOS_ANGELES_LAKERS,NEW_YORK_KNICKS,123,124,8923,1
8923,2019-03-17,2019-03-16,CHARLOTTE_HORNETS,MIAMI_HEAT,75,93,8924,18
8924,2019-03-17,2019-03-16,PHILADELPHIA_76ERS,MILWAUKEE_BUCKS,130,125,8925,5
8925,2019-03-17,2019-03-16,TORONTO_RAPTORS,DETROIT_PISTONS,107,110,8926,3
8926,2019-03-17,2019-03-16,ATLANTA_HAWKS,ORLANDO_MAGIC,91,101,8927,10
8927,2019-03-17,2019-03-16,CHICAGO_BULLS,SACRAMENTO_KINGS,102,129,8928,27
8928,2019-03-18,2019-03-17,MINNESOTA_TIMBERWOLVES,HOUSTON_ROCKETS,102,117,8929,15
8929,2019-03-18,2019-03-17,BROOKLYN_NETS,LOS_ANGELES_CLIPPERS,116,119,8930,3
8930,2019-03-18,2019-03-17,DETROIT_PISTONS,CLEVELAND_CAVALIERS,119,126,8931,7
8931,2019-03-18,2019-03-17,UTAH_JAZZ,WASHINGTON_WIZARDS,116,95,8932,21
8932,2019-03-18,2019-03-17,DENVER_NUGGETS,BOSTON_CELTICS,114,105,8933,9
8933,2019-03-18,2019-03-17,NEW_YORK_KNICKS,TORONTO_RAPTORS,92,128,8934,36
8934,2019-03-19,2019-03-18,MIAMI_HEAT,OKLAHOMA_CITY_THUNDER,116,107,8935,9
8935,2019-03-19,2019-03-18,GOLDEN_STATE_WARRIORS,SAN_ANTONIO_SPURS,105,111,8936,6
8936,2019-03-19,2019-03-18,NEW_ORLEANS_PELICANS,DALLAS_MAVERICKS,129,125,8937,4
8937,2019-03-19,2019-03-18,CHICAGO_BULLS,PHOENIX_SUNS,116,101,8938,15
8938,2019-03-19,2019-03-18,INDIANA_PACERS,PORTLAND_TRAIL_BLAZERS,98,106,8939,8
8939,2019-03-19,2019-03-18,PHILADELPHIA_76ERS,CHARLOTTE_HORNETS,118,114,8940,4
8940,2019-03-19,2019-03-18,HOUSTON_ROCKETS,ATLANTA_HAWKS,121,105,8941,16
8941,2019-03-20,2019-03-19,LOS_ANGELES_LAKERS,MILWAUKEE_BUCKS,101,115,8942,14
8942,2019-03-20,2019-03-19,GOLDEN_STATE_WARRIORS,MINNESOTA_TIMBERWOLVES,117,107,8943,10
8943,2019-03-20,2019-03-19,BROOKLYN_NETS,SACRAMENTO_KINGS,123,121,8944,2
8944,2019-03-20,2019-03-19,INDIANA_PACERS,LOS_ANGELES_CLIPPERS,109,115,8945,6
8945,2019-03-20,2019-03-19,MILWAUKEE_BUCKS,CLEVELAND_CAVALIERS,102,107,8946,5
8946,2019-03-20,2019-03-19,NEW_ORLEANS_PELICANS,ORLANDO_MAGIC,96,119,8947,23
8947,2019-03-20,2019-03-19,BOSTON_CELTICS,PHILADELPHIA_76ERS,115,118,8948,3
8948,2019-03-20,2019-03-19,UTAH_JAZZ,NEW_YORK_KNICKS,137,116,8949,21
8949,2019-03-21,2019-03-20,WASHINGTON_WIZARDS,CHICAGO_BULLS,120,126,8950,6
8950,2019-03-21,2019-03-20,HOUSTON_ROCKETS,MEMPHIS_GRIZZLIES,125,126,8951,1
8951,2019-03-21,2019-03-20,MIAMI_HEAT,SAN_ANTONIO_SPURS,110,105,8952,5
8952,2019-03-21,2019-03-20,TORONTO_RAPTORS,OKLAHOMA_CITY_THUNDER,123,114,8953,9
8953,2019-03-21,2019-03-20,DALLAS_MAVERICKS,PORTLAND_TRAIL_BLAZERS,118,126,8954,8
8954,2019-03-21,2019-03-20,MINNESOTA_TIMBERWOLVES,CHARLOTTE_HORNETS,106,113,8955,7
8955,2019-03-21,2019-03-20,DENVER_NUGGETS,WASHINGTON_WIZARDS,113,108,8956,5
8956,2019-03-21,2019-03-20,UTAH_JAZZ,ATLANTA_HAWKS,114,117,8957,3
8957,2019-03-22,2019-03-21,DETROIT_PISTONS,PHOENIX_SUNS,118,98,8958,20
8958,2019-03-22,2019-03-21,DALLAS_MAVERICKS,SACRAMENTO_KINGS,100,116,8959,16
8959,2019-03-22,2019-03-21,INDIANA_PACERS,GOLDEN_STATE_WARRIORS,89,112,8960,23
8960,2019-03-22,2019-03-21,MEMPHIS_GRIZZLIES,ORLANDO_MAGIC,119,123,8961,4
8961,2019-03-22,2019-03-21,LOS_ANGELES_CLIPPERS,CLEVELAND_CAVALIERS,110,108,8962,2
8962,2019-03-22,2019-03-21,DENVER_NUGGETS,NEW_YORK_KNICKS,111,93,8963,18
8963,2019-03-22,2019-03-21,OKLAHOMA_CITY_THUNDER,TORONTO_RAPTORS,116,109,8964,7
8964,2019-03-23,2019-03-22,SAN_ANTONIO_SPURS,HOUSTON_ROCKETS,105,111,8965,6
8965,2019-03-23,2019-03-22,MIAMI_HEAT,MILWAUKEE_BUCKS,87,116,8966,29
8966,2019-03-23,2019-03-22,BROOKLYN_NETS,LOS_ANGELES_LAKERS,111,106,8967,5
8967,2019-03-23,2019-03-22,BOSTON_CELTICS,CHARLOTTE_HORNETS,117,124,8968,7
8968,2019-03-23,2019-03-22,MIAMI_HEAT,WASHINGTON_WIZARDS,113,108,8969,5
8969,2019-03-23,2019-03-22,PHILADELPHIA_76ERS,ATLANTA_HAWKS,127,129,8970,2
8970,2019-03-24,2019-03-23,UTAH_JAZZ,CHICAGO_BULLS,114,83,8971,31
8971,2019-03-24,2019-03-23,MINNESOTA_TIMBERWOLVES,MEMPHIS_GRIZZLIES,112,99,8972,13
8972,2019-03-24,2019-03-23,DALLAS_MAVERICKS,GOLDEN_STATE_WARRIORS,126,91,8973,35
8973,2019-03-24,2019-03-23,DETROIT_PISTONS,PORTLAND_TRAIL_BLAZERS,112,117,8974,5
8974,2019-03-24,2019-03-23,PHOENIX_SUNS,SACRAMENTO_KINGS,103,112,8975,9
8975,2019-03-24,2019-03-23,LOS_ANGELES_CLIPPERS,NEW_YORK_KNICKS,124,113,8976,11
8976,2019-03-24,2019-03-23,CLEVELAND_CAVALIERS,MILWAUKEE_BUCKS,105,127,8977,22
8977,2019-03-24,2019-03-23,DENVER_NUGGETS,INDIANA_PACERS,88,124,8978,36
8978,2019-03-24,2019-03-23,CHARLOTTE_HORNETS,TORONTO_RAPTORS,115,114,8979,1
8979,2019-03-24,2019-03-23,HOUSTON_ROCKETS,NEW_ORLEANS_PELICANS,113,90,8980,23
8980,2019-03-24,2019-03-23,SAN_ANTONIO_SPURS,BOSTON_CELTICS,115,96,8981,19
8981,2019-03-25,2019-03-24,DETROIT_PISTONS,GOLDEN_STATE_WARRIORS,114,121,8982,7
8982,2019-03-25,2019-03-24,SACRAMENTO_KINGS,LOS_ANGELES_LAKERS,106,111,8983,5
8983,2019-03-25,2019-03-24,PHILADELPHIA_76ERS,ORLANDO_MAGIC,98,119,8984,21
8984,2019-03-26,2019-03-25,OKLAHOMA_CITY_THUNDER,MEMPHIS_GRIZZLIES,103,115,8985,12
8985,2019-03-26,2019-03-25,PHOENIX_SUNS,UTAH_JAZZ,92,125,8986,33
8986,2019-03-26,2019-03-25,BROOKLYN_NETS,PORTLAND_TRAIL_BLAZERS,144,148,8987,4
8987,2019-03-26,2019-03-25,SAN_ANTONIO_SPURS,CHARLOTTE_HORNETS,116,125,8988,9
8988,2019-03-26,2019-03-25,BOSTON_CELTICS,CLEVELAND_CAVALIERS,116,106,8989,10
8989,2019-03-26,2019-03-25,ORLANDO_MAGIC,MIAMI_HEAT,104,99,8990,5
8990,2019-03-26,2019-03-25,CHICAGO_BULLS,TORONTO_RAPTORS,103,112,8991,9
8991,2019-03-27,2019-03-26,HOUSTON_ROCKETS,MILWAUKEE_BUCKS,94,108,8992,14
8992,2019-03-27,2019-03-26,LOS_ANGELES_CLIPPERS,MINNESOTA_TIMBERWOLVES,122,111,8993,11
8993,2019-03-27,2019-03-26,ATLANTA_HAWKS,NEW_ORLEANS_PELICANS,130,120,8994,10
8994,2019-03-27,2019-03-26,SACRAMENTO_KINGS,DALLAS_MAVERICKS,125,121,8995,4
8995,2019-03-27,2019-03-26,DETROIT_PISTONS,DENVER_NUGGETS,92,95,8996,3
8996,2019-03-27,2019-03-26,WASHINGTON_WIZARDS,LOS_ANGELES_LAKERS,106,124,8997,18
8997,2019-03-28,2019-03-27,PORTLAND_TRAIL_BLAZERS,CHICAGO_BULLS,118,98,8998,20
8998,2019-03-28,2019-03-27,GOLDEN_STATE_WARRIORS,MEMPHIS_GRIZZLIES,118,103,8999,15
8999,2019-03-28,2019-03-27,INDIANA_PACERS,OKLAHOMA_CITY_THUNDER,99,107,9000,8
9000,2019-03-28,2019-03-27,WASHINGTON_WIZARDS,PHOENIX_SUNS,124,121,9001,3
9001,2019-03-28,2019-03-27,LOS_ANGELES_LAKERS,UTAH_JAZZ,100,115,9002,15
9002,2019-03-28,2019-03-27,ORLANDO_MAGIC,DETROIT_PISTONS,98,115,9003,17
9003,2019-03-28,2019-03-27,BROOKLYN_NETS,PHILADELPHIA_76ERS,110,123,9004,13
9004,2019-03-28,2019-03-27,DALLAS_MAVERICKS,MIAMI_HEAT,99,105,9005,6
9005,2019-03-28,2019-03-27,TORONTO_RAPTORS,NEW_YORK_KNICKS,117,92,9006,25
9006,2019-03-29,2019-03-28,DENVER_NUGGETS,HOUSTON_ROCKETS,85,112,9007,27
9007,2019-03-29,2019-03-28,LOS_ANGELES_CLIPPERS,MILWAUKEE_BUCKS,118,128,9008,10
9008,2019-03-29,2019-03-28,SACRAMENTO_KINGS,NEW_ORLEANS_PELICANS,118,121,9009,3
9009,2019-03-29,2019-03-28,CLEVELAND_CAVALIERS,SAN_ANTONIO_SPURS,110,116,9010,6
9010,2019-03-29,2019-03-28,INDIANA_PACERS,BOSTON_CELTICS,112,114,9011,2
9011,2019-03-29,2019-03-28,PORTLAND_TRAIL_BLAZERS,ATLANTA_HAWKS,118,98,9012,20
9012,2019-03-30,2019-03-29,GOLDEN_STATE_WARRIORS,MINNESOTA_TIMBERWOLVES,130,131,9013,1
9013,2019-03-30,2019-03-29,DENVER_NUGGETS,OKLAHOMA_CITY_THUNDER,115,105,9014,10
9014,2019-03-30,2019-03-29,WASHINGTON_WIZARDS,UTAH_JAZZ,124,128,9015,4
9015,2019-03-30,2019-03-29,CHARLOTTE_HORNETS,LOS_ANGELES_LAKERS,115,129,9016,14
9016,2019-03-30,2019-03-29,CLEVELAND_CAVALIERS,LOS_ANGELES_CLIPPERS,108,132,9017,24
9017,2019-03-30,2019-03-29,BOSTON_CELTICS,BROOKLYN_NETS,96,110,9018,14
9018,2019-03-30,2019-03-29,SACRAMENTO_KINGS,HOUSTON_ROCKETS,108,119,9019,11
9019,2019-03-30,2019-03-29,PORTLAND_TRAIL_BLAZERS,DETROIT_PISTONS,90,99,9020,9
9020,2019-03-30,2019-03-29,ORLANDO_MAGIC,INDIANA_PACERS,121,116,9021,5
9021,2019-03-30,2019-03-29,MIAMI_HEAT,NEW_YORK_KNICKS,100,92,9022,8
9022,2019-03-31,2019-03-30,TORONTO_RAPTORS,CHICAGO_BULLS,124,101,9023,23
9023,2019-03-31,2019-03-30,PHILADELPHIA_76ERS,MINNESOTA_TIMBERWOLVES,118,109,9024,9
9024,2019-03-31,2019-03-30,MEMPHIS_GRIZZLIES,PHOENIX_SUNS,120,115,9025,5
9025,2019-03-31,2019-03-30,MILWAUKEE_BUCKS,ATLANTA_HAWKS,135,136,9026,1
9026,2019-03-31,2019-03-30,DALLAS_MAVERICKS,OKLAHOMA_CITY_THUNDER,106,103,9027,3
9027,2019-03-31,2019-03-30,LOS_ANGELES_LAKERS,NEW_ORLEANS_PELICANS,130,102,9028,28
9028,2019-03-31,2019-03-30,SACRAMENTO_KINGS,SAN_ANTONIO_SPURS,113,106,9029,7
9029,2019-04-01,2019-03-31,WASHINGTON_WIZARDS,DENVER_NUGGETS,95,90,9030,5
9030,2019-04-01,2019-03-31,CHARLOTTE_HORNETS,GOLDEN_STATE_WARRIORS,90,137,9031,47
9031,2019-04-01,2019-03-31,MEMPHIS_GRIZZLIES,LOS_ANGELES_CLIPPERS,96,113,9032,17
9032,2019-04-01,2019-03-31,DETROIT_PISTONS,INDIANA_PACERS,102,111,9033,9
9033,2019-04-01,2019-03-31,MIAMI_HEAT,BOSTON_CELTICS,105,110,9034,5
9034,2019-04-01,2019-03-31,MILWAUKEE_BUCKS,BROOKLYN_NETS,131,121,9035,10
9035,2019-04-01,2019-03-31,CHICAGO_BULLS,NEW_YORK_KNICKS,105,113,9036,8
9036,2019-04-01,2019-03-31,ORLANDO_MAGIC,TORONTO_RAPTORS,109,121,9037,12
9037,2019-04-02,2019-04-01,PORTLAND_TRAIL_BLAZERS,MINNESOTA_TIMBERWOLVES,132,122,9038,10
9038,2019-04-02,2019-04-01,PHILADELPHIA_76ERS,DALLAS_MAVERICKS,102,122,9039,20
9039,2019-04-02,2019-04-01,CHARLOTTE_HORNETS,UTAH_JAZZ,102,111,9040,9
9040,2019-04-02,2019-04-01,CLEVELAND_CAVALIERS,PHOENIX_SUNS,113,122,9041,9
9041,2019-04-03,2019-04-02,LOS_ANGELES_LAKERS,OKLAHOMA_CITY_THUNDER,103,119,9042,16
9042,2019-04-03,2019-04-02,ATLANTA_HAWKS,SAN_ANTONIO_SPURS,111,117,9043,6
9043,2019-04-03,2019-04-02,HOUSTON_ROCKETS,SACRAMENTO_KINGS,130,105,9044,25
9044,2019-04-03,2019-04-02,DENVER_NUGGETS,GOLDEN_STATE_WARRIORS,102,116,9045,14
9045,2019-04-03,2019-04-02,INDIANA_PACERS,DETROIT_PISTONS,108,89,9046,19
9046,2019-04-03,2019-04-02,NEW_YORK_KNICKS,ORLANDO_MAGIC,100,114,9047,14
9047,2019-04-03,2019-04-02,CHICAGO_BULLS,WASHINGTON_WIZARDS,115,114,9048,1
9048,2019-04-03,2019-04-02,PHILADELPHIA_76ERS,ATLANTA_HAWKS,122,130,9049,8
9049,2019-04-03,2019-04-02,TORONTO_RAPTORS,BROOKLYN_NETS,115,105,9050,10
9050,2019-04-03,2019-04-02,BOSTON_CELTICS,MIAMI_HEAT,112,102,9051,10
9051,2019-04-04,2019-04-03,CHARLOTTE_HORNETS,NEW_ORLEANS_PELICANS,115,109,9052,6
9052,2019-04-04,2019-04-03,MINNESOTA_TIMBERWOLVES,DALLAS_MAVERICKS,110,108,9053,2
9053,2019-04-04,2019-04-03,SAN_ANTONIO_SPURS,DENVER_NUGGETS,85,113,9054,28
9054,2019-04-04,2019-04-03,UTAH_JAZZ,PHOENIX_SUNS,118,97,9055,21
9055,2019-04-04,2019-04-03,MEMPHIS_GRIZZLIES,PORTLAND_TRAIL_BLAZERS,89,116,9056,27
9056,2019-04-04,2019-04-03,HOUSTON_ROCKETS,LOS_ANGELES_CLIPPERS,135,103,9057,32
9057,2019-04-05,2019-04-04,MILWAUKEE_BUCKS,PHILADELPHIA_76ERS,128,122,9058,6
9058,2019-04-05,2019-04-04,CLEVELAND_CAVALIERS,SACRAMENTO_KINGS,104,117,9059,13
9059,2019-04-05,2019-04-04,GOLDEN_STATE_WARRIORS,LOS_ANGELES_LAKERS,108,90,9060,18
9060,2019-04-05,2019-04-04,TORONTO_RAPTORS,CHARLOTTE_HORNETS,111,113,9061,2
9061,2019-04-05,2019-04-04,ATLANTA_HAWKS,ORLANDO_MAGIC,113,149,9062,36
9062,2019-04-05,2019-04-04,SAN_ANTONIO_SPURS,WASHINGTON_WIZARDS,129,112,9063,17
9063,2019-04-06,2019-04-05,NEW_YORK_KNICKS,HOUSTON_ROCKETS,96,120,9064,24
9064,2019-04-06,2019-04-05,BOSTON_CELTICS,INDIANA_PACERS,117,97,9065,20
9065,2019-04-06,2019-04-05,MIAMI_HEAT,MINNESOTA_TIMBERWOLVES,109,111,9066,2
9066,2019-04-06,2019-04-05,DETROIT_PISTONS,OKLAHOMA_CITY_THUNDER,110,123,9067,13
9067,2019-04-06,2019-04-05,MEMPHIS_GRIZZLIES,DALLAS_MAVERICKS,122,112,9068,10
9068,2019-04-06,2019-04-05,SACRAMENTO_KINGS,UTAH_JAZZ,98,119,9069,21
9069,2019-04-06,2019-04-05,NEW_ORLEANS_PELICANS,PHOENIX_SUNS,126,133,9070,7
9070,2019-04-06,2019-04-05,PORTLAND_TRAIL_BLAZERS,DENVER_NUGGETS,110,119,9071,9
9071,2019-04-06,2019-04-05,CLEVELAND_CAVALIERS,GOLDEN_STATE_WARRIORS,114,120,9072,6
9072,2019-04-06,2019-04-05,LOS_ANGELES_LAKERS,LOS_ANGELES_CLIPPERS,122,117,9073,5
9073,2019-04-06,2019-04-05,BROOKLYN_NETS,MILWAUKEE_BUCKS,133,128,9074,5
9074,2019-04-07,2019-04-06,PHILADELPHIA_76ERS,CHICAGO_BULLS,116,96,9075,20
9075,2019-04-07,2019-04-06,MIAMI_HEAT,TORONTO_RAPTORS,109,117,9076,8
9076,2019-04-07,2019-04-06,SAN_ANTONIO_SPURS,CLEVELAND_CAVALIERS,112,90,9077,22
9077,2019-04-07,2019-04-06,OKLAHOMA_CITY_THUNDER,MINNESOTA_TIMBERWOLVES,132,126,9078,6
9078,2019-04-07,2019-04-06,CHARLOTTE_HORNETS,DETROIT_PISTONS,104,91,9079,13
9079,2019-04-07,2019-04-06,BROOKLYN_NETS,INDIANA_PACERS,108,96,9080,12
9080,2019-04-07,2019-04-06,DALLAS_MAVERICKS,MEMPHIS_GRIZZLIES,129,127,9081,2
9081,2019-04-07,2019-04-06,PHOENIX_SUNS,HOUSTON_ROCKETS,113,149,9082,36
9082,2019-04-07,2019-04-06,ATLANTA_HAWKS,MILWAUKEE_BUCKS,107,115,9083,8
9083,2019-04-07,2019-04-06,ORLANDO_MAGIC,BOSTON_CELTICS,116,108,9084,8
9084,2019-04-07,2019-04-06,WASHINGTON_WIZARDS,NEW_YORK_KNICKS,110,113,9085,3
9085,2019-04-08,2019-04-07,LOS_ANGELES_CLIPPERS,GOLDEN_STATE_WARRIORS,104,131,9086,27
9086,2019-04-08,2019-04-07,DENVER_NUGGETS,PORTLAND_TRAIL_BLAZERS,108,115,9087,7
9087,2019-04-08,2019-04-07,NEW_ORLEANS_PELICANS,SACRAMENTO_KINGS,133,129,9088,4
9088,2019-04-08,2019-04-07,UTAH_JAZZ,LOS_ANGELES_LAKERS,109,113,9089,4
9089,2019-04-09,2019-04-08,CHARLOTTE_HORNETS,CLEVELAND_CAVALIERS,124,97,9090,27
9090,2019-04-09,2019-04-08,MEMPHIS_GRIZZLIES,DETROIT_PISTONS,93,100,9091,7
9091,2019-04-09,2019-04-08,BOSTON_CELTICS,WASHINGTON_WIZARDS,116,110,9092,6
9092,2019-04-09,2019-04-08,PHILADELPHIA_76ERS,MIAMI_HEAT,99,122,9093,23
9093,2019-04-10,2019-04-09,NEW_YORK_KNICKS,CHICAGO_BULLS,96,86,9094,10
9094,2019-04-10,2019-04-09,TORONTO_RAPTORS,MINNESOTA_TIMBERWOLVES,120,100,9095,20
9095,2019-04-10,2019-04-09,GOLDEN_STATE_WARRIORS,NEW_ORLEANS_PELICANS,112,103,9096,9
9096,2019-04-10,2019-04-09,PHOENIX_SUNS,DALLAS_MAVERICKS,109,120,9097,11
9097,2019-04-10,2019-04-09,DENVER_NUGGETS,UTAH_JAZZ,108,118,9098,10
9098,2019-04-10,2019-04-09,HOUSTON_ROCKETS,OKLAHOMA_CITY_THUNDER,111,112,9099,1
9099,2019-04-10,2019-04-09,PORTLAND_TRAIL_BLAZERS,LOS_ANGELES_LAKERS,104,101,9100,3
9100,2019-04-11,2019-04-10,INDIANA_PACERS,ATLANTA_HAWKS,135,134,9101,1
9101,2019-04-11,2019-04-10,MIAMI_HEAT,BROOKLYN_NETS,94,113,9102,19
9102,2019-04-11,2019-04-10,ORLANDO_MAGIC,CHARLOTTE_HORNETS,122,114,9103,8
9103,2019-04-11,2019-04-10,GOLDEN_STATE_WARRIORS,MEMPHIS_GRIZZLIES,117,132,9104,15
9104,2019-04-11,2019-04-10,OKLAHOMA_CITY_THUNDER,MILWAUKEE_BUCKS,127,116,9105,11
9105,2019-04-11,2019-04-10,DETROIT_PISTONS,NEW_YORK_KNICKS,115,89,9106,26
9106,2019-04-11,2019-04-10,CHICAGO_BULLS,PHILADELPHIA_76ERS,109,125,9107,16
9107,2019-04-11,2019-04-10,DALLAS_MAVERICKS,SAN_ANTONIO_SPURS,94,105,9108,11
9108,2019-04-11,2019-04-10,MINNESOTA_TIMBERWOLVES,DENVER_NUGGETS,95,99,9109,4
9109,2019-04-11,2019-04-10,UTAH_JAZZ,LOS_ANGELES_CLIPPERS,137,143,9110,6
9110,2019-04-11,2019-04-10,SACRAMENTO_KINGS,PORTLAND_TRAIL_BLAZERS,131,136,9111,5
9111,2019-04-13,2019-04-12,BROOKLYN_NETS,PHILADELPHIA_76ERS,111,102,9112,9
9112,2019-04-13,2019-04-12,ORLANDO_MAGIC,TORONTO_RAPTORS,104,101,9113,3
9113,2019-04-14,2019-04-13,LOS_ANGELES_CLIPPERS,GOLDEN_STATE_WARRIORS,104,121,9114,17
9114,2019-04-14,2019-04-13,SAN_ANTONIO_SPURS,DENVER_NUGGETS,101,96,9115,5
9115,2019-04-14,2019-04-13,INDIANA_PACERS,BOSTON_CELTICS,74,84,9116,10
9116,2019-04-14,2019-04-13,OKLAHOMA_CITY_THUNDER,PORTLAND_TRAIL_BLAZERS,99,104,9117,5
9117,2019-04-14,2019-04-13,DETROIT_PISTONS,MILWAUKEE_BUCKS,86,121,9118,35
9118,2019-04-15,2019-04-14,UTAH_JAZZ,HOUSTON_ROCKETS,90,122,9119,32
9119,2019-04-16,2019-04-15,BROOKLYN_NETS,PHILADELPHIA_76ERS,123,145,9120,22
9120,2019-04-16,2019-04-15,LOS_ANGELES_CLIPPERS,GOLDEN_STATE_WARRIORS,135,131,9121,4
9121,2019-04-17,2019-04-16,ORLANDO_MAGIC,TORONTO_RAPTORS,82,111,9122,29
9122,2019-04-17,2019-04-16,SAN_ANTONIO_SPURS,DENVER_NUGGETS,105,114,9123,9
9123,2019-04-17,2019-04-16,OKLAHOMA_CITY_THUNDER,PORTLAND_TRAIL_BLAZERS,94,114,9124,20
9124,2019-04-17,2019-04-16,INDIANA_PACERS,BOSTON_CELTICS,91,99,9125,8
9125,2019-04-18,2019-04-17,DETROIT_PISTONS,MILWAUKEE_BUCKS,99,120,9126,21
9126,2019-04-18,2019-04-17,UTAH_JAZZ,HOUSTON_ROCKETS,98,118,9127,20
9127,2019-04-19,2019-04-18,PHILADELPHIA_76ERS,BROOKLYN_NETS,131,115,9128,16
9128,2019-04-19,2019-04-18,DENVER_NUGGETS,SAN_ANTONIO_SPURS,108,118,9129,10
9129,2019-04-19,2019-04-18,GOLDEN_STATE_WARRIORS,LOS_ANGELES_CLIPPERS,132,105,9130,27
9130,2019-04-19,2019-04-18,TORONTO_RAPTORS,ORLANDO_MAGIC,98,93,9131,5
9131,2019-04-20,2019-04-19,BOSTON_CELTICS,INDIANA_PACERS,104,96,9132,8
9132,2019-04-20,2019-04-19,PORTLAND_TRAIL_BLAZERS,OKLAHOMA_CITY_THUNDER,108,120,9133,12
9133,2019-04-20,2019-04-19,PHILADELPHIA_76ERS,BROOKLYN_NETS,112,108,9134,4
9134,2019-04-20,2019-04-19,DENVER_NUGGETS,SAN_ANTONIO_SPURS,117,103,9135,14
9135,2019-04-21,2019-04-20,MILWAUKEE_BUCKS,DETROIT_PISTONS,119,103,9136,16
9136,2019-04-21,2019-04-20,HOUSTON_ROCKETS,UTAH_JAZZ,104,101,9137,3
9137,2019-04-21,2019-04-20,BOSTON_CELTICS,INDIANA_PACERS,110,106,9138,4
9138,2019-04-21,2019-04-20,GOLDEN_STATE_WARRIORS,LOS_ANGELES_CLIPPERS,113,105,9139,8
9139,2019-04-21,2019-04-20,TORONTO_RAPTORS,ORLANDO_MAGIC,107,85,9140,22
9140,2019-04-22,2019-04-21,PORTLAND_TRAIL_BLAZERS,OKLAHOMA_CITY_THUNDER,111,98,9141,13
9141,2019-04-23,2019-04-22,MILWAUKEE_BUCKS,DETROIT_PISTONS,127,104,9142,23
9142,2019-04-23,2019-04-22,HOUSTON_ROCKETS,UTAH_JAZZ,91,107,9143,16
9143,2019-04-23,2019-04-22,ORLANDO_MAGIC,TORONTO_RAPTORS,96,115,9144,19
9144,2019-04-24,2019-04-23,BROOKLYN_NETS,PHILADELPHIA_76ERS,100,122,9145,22
9145,2019-04-24,2019-04-23,SAN_ANTONIO_SPURS,DENVER_NUGGETS,90,108,9146,18
9146,2019-04-24,2019-04-23,OKLAHOMA_CITY_THUNDER,PORTLAND_TRAIL_BLAZERS,115,118,9147,3
9147,2019-04-25,2019-04-24,UTAH_JAZZ,HOUSTON_ROCKETS,93,100,9148,7
9148,2019-04-25,2019-04-24,LOS_ANGELES_CLIPPERS,GOLDEN_STATE_WARRIORS,129,121,9149,8
9149,2019-04-26,2019-04-25,DENVER_NUGGETS,SAN_ANTONIO_SPURS,103,120,9150,17
9150,2019-04-27,2019-04-26,GOLDEN_STATE_WARRIORS,LOS_ANGELES_CLIPPERS,129,110,9151,19
9151,2019-04-27,2019-04-26,PHILADELPHIA_76ERS,TORONTO_RAPTORS,95,108,9152,13
9152,2019-04-28,2019-04-27,SAN_ANTONIO_SPURS,DENVER_NUGGETS,86,90,9153,4
9153,2019-04-28,2019-04-27,BOSTON_CELTICS,MILWAUKEE_BUCKS,112,90,9154,22
9154,2019-04-28,2019-04-27,HOUSTON_ROCKETS,GOLDEN_STATE_WARRIORS,100,104,9155,4
9155,2019-04-30,2019-04-29,PHILADELPHIA_76ERS,TORONTO_RAPTORS,94,89,9156,5
9156,2019-04-30,2019-04-29,PORTLAND_TRAIL_BLAZERS,DENVER_NUGGETS,113,121,9157,8
9157,2019-05-01,2019-04-30,BOSTON_CELTICS,MILWAUKEE_BUCKS,102,123,9158,21
9158,2019-05-01,2019-04-30,HOUSTON_ROCKETS,GOLDEN_STATE_WARRIORS,109,115,9159,6
9159,2019-05-02,2019-05-01,PORTLAND_TRAIL_BLAZERS,DENVER_NUGGETS,97,90,9160,7
9160,2019-05-03,2019-05-02,TORONTO_RAPTORS,PHILADELPHIA_76ERS,95,116,9161,21
9161,2019-05-04,2019-05-03,MILWAUKEE_BUCKS,BOSTON_CELTICS,123,116,9162,7
9162,2019-05-04,2019-05-03,DENVER_NUGGETS,PORTLAND_TRAIL_BLAZERS,137,140,9163,3
9163,2019-05-05,2019-05-04,GOLDEN_STATE_WARRIORS,HOUSTON_ROCKETS,121,126,9164,5
9164,2019-05-05,2019-05-04,TORONTO_RAPTORS,PHILADELPHIA_76ERS,101,96,9165,5
9165,2019-05-05,2019-05-04,DENVER_NUGGETS,PORTLAND_TRAIL_BLAZERS,116,112,9166,4
9166,2019-05-06,2019-05-05,MILWAUKEE_BUCKS,BOSTON_CELTICS,113,101,9167,12
9167,2019-05-07,2019-05-06,GOLDEN_STATE_WARRIORS,HOUSTON_ROCKETS,108,112,9168,4
9168,2019-05-08,2019-05-07,PHILADELPHIA_76ERS,TORONTO_RAPTORS,89,125,9169,36
9169,2019-05-08,2019-05-07,PORTLAND_TRAIL_BLAZERS,DENVER_NUGGETS,98,124,9170,26
9170,2019-05-09,2019-05-08,BOSTON_CELTICS,MILWAUKEE_BUCKS,91,116,9171,25
9171,2019-05-09,2019-05-08,HOUSTON_ROCKETS,GOLDEN_STATE_WARRIORS,99,104,9172,5
9172,2019-05-10,2019-05-09,TORONTO_RAPTORS,PHILADELPHIA_76ERS,101,112,9173,11
9173,2019-05-10,2019-05-09,DENVER_NUGGETS,PORTLAND_TRAIL_BLAZERS,108,119,9174,11
9174,2019-05-11,2019-05-10,GOLDEN_STATE_WARRIORS,HOUSTON_ROCKETS,118,113,9175,5
9175,2019-05-12,2019-05-11,PORTLAND_TRAIL_BLAZERS,DENVER_NUGGETS,100,96,9176,4
9176,2019-05-12,2019-05-11,PHILADELPHIA_76ERS,TORONTO_RAPTORS,90,92,9177,2
9177,2019-05-15,2019-05-14,PORTLAND_TRAIL_BLAZERS,GOLDEN_STATE_WARRIORS,94,116,9178,22
9178,2019-05-16,2019-05-15,TORONTO_RAPTORS,MILWAUKEE_BUCKS,100,108,9179,8
9179,2019-05-17,2019-05-16,PORTLAND_TRAIL_BLAZERS,GOLDEN_STATE_WARRIORS,111,114,9180,3
9180,2019-05-18,2019-05-17,TORONTO_RAPTORS,MILWAUKEE_BUCKS,103,125,9181,22
9181,2019-05-19,2019-05-18,GOLDEN_STATE_WARRIORS,PORTLAND_TRAIL_BLAZERS,110,99,9182,11
9182,2019-05-19,2019-05-18,MILWAUKEE_BUCKS,TORONTO_RAPTORS,112,118,9183,6
9183,2019-05-21,2019-05-20,GOLDEN_STATE_WARRIORS,PORTLAND_TRAIL_BLAZERS,119,117,9184,2
9184,2019-05-22,2019-05-21,MILWAUKEE_BUCKS,TORONTO_RAPTORS,102,120,9185,18
9185,2019-05-24,2019-05-23,TORONTO_RAPTORS,MILWAUKEE_BUCKS,105,99,9186,6
9186,2019-05-26,2019-05-25,MILWAUKEE_BUCKS,TORONTO_RAPTORS,94,100,9187,6
9187,2019-05-31,2019-05-30,GOLDEN_STATE_WARRIORS,TORONTO_RAPTORS,109,118,9188,9
9188,2019-06-03,2019-06-02,GOLDEN_STATE_WARRIORS,TORONTO_RAPTORS,109,104,9189,5
9189,2019-06-06,2019-06-05,TORONTO_RAPTORS,GOLDEN_STATE_WARRIORS,123,109,9190,14
9190,2019-06-08,2019-06-07,TORONTO_RAPTORS,GOLDEN_STATE_WARRIORS,105,92,9191,13
9191,2019-06-11,2019-06-10,GOLDEN_STATE_WARRIORS,TORONTO_RAPTORS,106,105,9192,1
9192,2019-06-14,2019-06-13,TORONTO_RAPTORS,GOLDEN_STATE_WARRIORS,114,110,9193,4
9193,2019-10-23,2019-10-22,NEW_ORLEANS_PELICANS,TORONTO_RAPTORS,122,130,9194,8
9194,2019-10-23,2019-10-22,LOS_ANGELES_LAKERS,LOS_ANGELES_CLIPPERS,102,112,9195,10
9195,2019-10-23,2019-10-22,CHICAGO_BULLS,CHARLOTTE_HORNETS,125,126,9196,1
9196,2019-10-23,2019-10-22,DETROIT_PISTONS,INDIANA_PACERS,119,110,9197,9
9197,2019-10-23,2019-10-22,CLEVELAND_CAVALIERS,ORLANDO_MAGIC,85,94,9198,9
9198,2019-10-23,2019-10-22,MINNESOTA_TIMBERWOLVES,BROOKLYN_NETS,127,126,9199,1
9199,2019-10-23,2019-10-22,MEMPHIS_GRIZZLIES,MIAMI_HEAT,101,120,9200,19
9200,2019-10-23,2019-10-22,BOSTON_CELTICS,PHILADELPHIA_76ERS,93,107,9201,14
9201,2019-10-24,2019-10-23,WASHINGTON_WIZARDS,DALLAS_MAVERICKS,100,108,9202,8
9202,2019-10-24,2019-10-23,NEW_YORK_KNICKS,SAN_ANTONIO_SPURS,111,120,9203,9
9203,2019-10-24,2019-10-23,OKLAHOMA_CITY_THUNDER,UTAH_JAZZ,95,100,9204,5
9204,2019-10-24,2019-10-23,SACRAMENTO_KINGS,PHOENIX_SUNS,95,124,9205,29
9205,2019-10-24,2019-10-23,DENVER_NUGGETS,PORTLAND_TRAIL_BLAZERS,108,100,9206,8
9206,2019-10-24,2019-10-23,ATLANTA_HAWKS,DETROIT_PISTONS,117,100,9207,17
9207,2019-10-25,2019-10-24,MILWAUKEE_BUCKS,HOUSTON_ROCKETS,117,111,9208,6
9208,2019-10-25,2019-10-24,LOS_ANGELES_CLIPPERS,GOLDEN_STATE_WARRIORS,141,122,9209,19
9209,2019-10-25,2019-10-24,TORONTO_RAPTORS,BOSTON_CELTICS,106,112,9210,6
9210,2019-10-25,2019-10-24,MINNESOTA_TIMBERWOLVES,CHARLOTTE_HORNETS,121,99,9211,22
9211,2019-10-25,2019-10-24,NEW_YORK_KNICKS,BROOKLYN_NETS,109,113,9212,4
9212,2019-10-26,2019-10-25,CHICAGO_BULLS,MEMPHIS_GRIZZLIES,110,102,9213,8
9213,2019-10-26,2019-10-25,DALLAS_MAVERICKS,NEW_ORLEANS_PELICANS,123,116,9214,7
9214,2019-10-26,2019-10-25,WASHINGTON_WIZARDS,OKLAHOMA_CITY_THUNDER,97,85,9215,12
9215,2019-10-26,2019-10-25,PHOENIX_SUNS,DENVER_NUGGETS,107,108,9216,1
9216,2019-10-26,2019-10-25,PORTLAND_TRAIL_BLAZERS,SACRAMENTO_KINGS,122,112,9217,10
9217,2019-10-26,2019-10-25,UTAH_JAZZ,LOS_ANGELES_LAKERS,86,95,9218,9
9218,2019-10-26,2019-10-25,MIAMI_HEAT,MILWAUKEE_BUCKS,131,126,9219,5
9219,2019-10-26,2019-10-25,PHILADELPHIA_76ERS,DETROIT_PISTONS,117,111,9220,6
9220,2019-10-26,2019-10-25,ORLANDO_MAGIC,ATLANTA_HAWKS,99,103,9221,4
9221,2019-10-26,2019-10-25,BOSTON_CELTICS,NEW_YORK_KNICKS,118,95,9222,23
9222,2019-10-27,2019-10-26,TORONTO_RAPTORS,CHICAGO_BULLS,108,84,9223,24
9223,2019-10-27,2019-10-26,INDIANA_PACERS,CLEVELAND_CAVALIERS,99,110,9224,11
9224,2019-10-27,2019-10-26,NEW_ORLEANS_PELICANS,HOUSTON_ROCKETS,123,126,9225,3
9225,2019-10-27,2019-10-26,WASHINGTON_WIZARDS,SAN_ANTONIO_SPURS,122,124,9226,2
9226,2019-10-27,2019-10-26,SACRAMENTO_KINGS,UTAH_JAZZ,81,113,9227,32
9227,2019-10-27,2019-10-26,LOS_ANGELES_CLIPPERS,PHOENIX_SUNS,122,130,9228,8
9228,2019-10-27,2019-10-26,GOLDEN_STATE_WARRIORS,OKLAHOMA_CITY_THUNDER,92,120,9229,28
9229,2019-10-27,2019-10-26,BROOKLYN_NETS,MEMPHIS_GRIZZLIES,133,134,9230,1
9230,2019-10-27,2019-10-26,PORTLAND_TRAIL_BLAZERS,DALLAS_MAVERICKS,121,119,9231,2
9231,2019-10-27,2019-10-26,MIAMI_HEAT,MINNESOTA_TIMBERWOLVES,109,116,9232,7
9232,2019-10-28,2019-10-27,CHARLOTTE_HORNETS,LOS_ANGELES_LAKERS,101,120,9233,19
9233,2019-10-28,2019-10-27,CHICAGO_BULLS,NEW_YORK_KNICKS,98,105,9234,7
9234,2019-10-28,2019-10-27,INDIANA_PACERS,DETROIT_PISTONS,94,96,9235,2
9235,2019-10-28,2019-10-27,ORLANDO_MAGIC,TORONTO_RAPTORS,95,104,9236,9
9236,2019-10-28,2019-10-27,PHILADELPHIA_76ERS,ATLANTA_HAWKS,105,103,9237,2
9237,2019-10-29,2019-10-28,OKLAHOMA_CITY_THUNDER,HOUSTON_ROCKETS,112,116,9238,4
9238,2019-10-29,2019-10-28,CLEVELAND_CAVALIERS,MILWAUKEE_BUCKS,112,129,9239,17
9239,2019-10-29,2019-10-28,GOLDEN_STATE_WARRIORS,NEW_ORLEANS_PELICANS,134,123,9240,11
9240,2019-10-29,2019-10-28,PORTLAND_TRAIL_BLAZERS,SAN_ANTONIO_SPURS,110,113,9241,3
9241,2019-10-29,2019-10-28,UTAH_JAZZ,PHOENIX_SUNS,96,95,9242,1
9242,2019-10-29,2019-10-28,DENVER_NUGGETS,SACRAMENTO_KINGS,101,94,9243,7
9243,2019-10-29,2019-10-28,CHARLOTTE_HORNETS,LOS_ANGELES_CLIPPERS,96,111,9244,15
9244,2019-10-29,2019-10-28,ATLANTA_HAWKS,MIAMI_HEAT,97,112,9245,15
9245,2019-10-30,2019-10-29,DALLAS_MAVERICKS,DENVER_NUGGETS,109,106,9246,3
9246,2019-10-30,2019-10-29,MEMPHIS_GRIZZLIES,LOS_ANGELES_LAKERS,91,120,9247,29
9247,2019-10-30,2019-10-29,CHICAGO_BULLS,CLEVELAND_CAVALIERS,111,117,9248,6
9248,2019-10-30,2019-10-29,NEW_YORK_KNICKS,ORLANDO_MAGIC,83,95,9249,12
9249,2019-10-30,2019-10-29,MINNESOTA_TIMBERWOLVES,PHILADELPHIA_76ERS,95,117,9250,22
9250,2019-10-30,2019-10-29,MILWAUKEE_BUCKS,BOSTON_CELTICS,105,116,9251,11
9251,2019-10-30,2019-10-29,INDIANA_PACERS,BROOKLYN_NETS,118,108,9252,10
9252,2019-10-30,2019-10-29,DETROIT_PISTONS,TORONTO_RAPTORS,113,125,9253,12
9253,2019-10-31,2019-10-30,PORTLAND_TRAIL_BLAZERS,OKLAHOMA_CITY_THUNDER,102,99,9254,3
9254,2019-10-31,2019-10-30,HOUSTON_ROCKETS,WASHINGTON_WIZARDS,159,158,9255,1
9255,2019-10-31,2019-10-30,CHARLOTTE_HORNETS,SACRAMENTO_KINGS,118,111,9256,7
9256,2019-10-31,2019-10-30,LOS_ANGELES_CLIPPERS,UTAH_JAZZ,96,110,9257,14
9257,2019-10-31,2019-10-30,PHOENIX_SUNS,GOLDEN_STATE_WARRIORS,121,110,9258,11
9258,2019-10-31,2019-10-30,MIAMI_HEAT,ATLANTA_HAWKS,106,97,9259,9
9259,2019-11-01,2019-10-31,DENVER_NUGGETS,NEW_ORLEANS_PELICANS,107,122,9260,15
9260,2019-11-01,2019-10-31,SAN_ANTONIO_SPURS,LOS_ANGELES_CLIPPERS,97,103,9261,6
9261,2019-11-01,2019-10-31,HOUSTON_ROCKETS,BROOKLYN_NETS,116,123,9262,7
9262,2019-11-01,2019-10-31,CLEVELAND_CAVALIERS,INDIANA_PACERS,95,102,9263,7
9263,2019-11-01,2019-10-31,MILWAUKEE_BUCKS,ORLANDO_MAGIC,123,91,9264,32
9264,2019-11-01,2019-10-31,NEW_YORK_KNICKS,BOSTON_CELTICS,102,104,9265,2
9265,2019-11-02,2019-11-01,DETROIT_PISTONS,CHICAGO_BULLS,106,112,9266,6
9266,2019-11-02,2019-11-01,LOS_ANGELES_LAKERS,DALLAS_MAVERICKS,119,110,9267,9
9267,2019-11-02,2019-11-01,UTAH_JAZZ,SACRAMENTO_KINGS,101,102,9268,1
9268,2019-11-02,2019-11-01,SAN_ANTONIO_SPURS,GOLDEN_STATE_WARRIORS,127,110,9269,17
9269,2019-11-02,2019-11-01,NEW_ORLEANS_PELICANS,OKLAHOMA_CITY_THUNDER,104,115,9270,11
9270,2019-11-02,2019-11-01,BROOKLYN_NETS,DETROIT_PISTONS,109,113,9271,4
9271,2019-11-02,2019-11-01,DENVER_NUGGETS,ORLANDO_MAGIC,91,87,9272,4
9272,2019-11-03,2019-11-02,PHOENIX_SUNS,MEMPHIS_GRIZZLIES,114,105,9273,9
9273,2019-11-03,2019-11-02,TORONTO_RAPTORS,MILWAUKEE_BUCKS,105,115,9274,10
9274,2019-11-03,2019-11-02,MINNESOTA_TIMBERWOLVES,WASHINGTON_WIZARDS,131,109,9275,22
9275,2019-11-03,2019-11-02,CHARLOTTE_HORNETS,GOLDEN_STATE_WARRIORS,93,87,9276,6
9276,2019-11-03,2019-11-02,PHILADELPHIA_76ERS,PORTLAND_TRAIL_BLAZERS,129,128,9277,1
9277,2019-11-03,2019-11-02,CHICAGO_BULLS,INDIANA_PACERS,95,108,9278,13
9278,2019-11-03,2019-11-02,HOUSTON_ROCKETS,MIAMI_HEAT,100,129,9279,29
9279,2019-11-03,2019-11-02,SACRAMENTO_KINGS,NEW_YORK_KNICKS,113,92,9280,21
9280,2019-11-04,2019-11-03,LOS_ANGELES_LAKERS,SAN_ANTONIO_SPURS,103,96,9281,7
9281,2019-11-04,2019-11-03,DALLAS_MAVERICKS,CLEVELAND_CAVALIERS,131,111,9282,20
9282,2019-11-04,2019-11-03,UTAH_JAZZ,LOS_ANGELES_CLIPPERS,94,105,9283,11
9283,2019-11-05,2019-11-04,DETROIT_PISTONS,WASHINGTON_WIZARDS,99,115,9284,16
9284,2019-11-05,2019-11-04,NEW_ORLEANS_PELICANS,BROOKLYN_NETS,125,135,9285,10
9285,2019-11-05,2019-11-04,HOUSTON_ROCKETS,MEMPHIS_GRIZZLIES,107,100,9286,7
9286,2019-11-05,2019-11-04,MILWAUKEE_BUCKS,MINNESOTA_TIMBERWOLVES,134,106,9287,28
9287,2019-11-05,2019-11-04,PHILADELPHIA_76ERS,PHOENIX_SUNS,109,114,9288,5
9288,2019-11-05,2019-11-04,PORTLAND_TRAIL_BLAZERS,GOLDEN_STATE_WARRIORS,118,127,9289,9
9289,2019-11-06,2019-11-05,INDIANA_PACERS,CHARLOTTE_HORNETS,120,122,9290,2
9290,2019-11-06,2019-11-05,BOSTON_CELTICS,CLEVELAND_CAVALIERS,119,113,9291,6
9291,2019-11-06,2019-11-05,SAN_ANTONIO_SPURS,ATLANTA_HAWKS,100,108,9292,8
9292,2019-11-06,2019-11-05,LOS_ANGELES_LAKERS,CHICAGO_BULLS,118,112,9293,6
9293,2019-11-06,2019-11-05,ORLANDO_MAGIC,OKLAHOMA_CITY_THUNDER,94,102,9294,8
9294,2019-11-06,2019-11-05,MIAMI_HEAT,DENVER_NUGGETS,89,109,9295,20
9295,2019-11-07,2019-11-06,NEW_YORK_KNICKS,DETROIT_PISTONS,102,122,9296,20
9296,2019-11-07,2019-11-06,WASHINGTON_WIZARDS,INDIANA_PACERS,106,121,9297,15
9297,2019-11-07,2019-11-06,CHICAGO_BULLS,ATLANTA_HAWKS,113,93,9298,20
9298,2019-11-07,2019-11-06,GOLDEN_STATE_WARRIORS,HOUSTON_ROCKETS,112,129,9299,17
9299,2019-11-07,2019-11-06,SACRAMENTO_KINGS,TORONTO_RAPTORS,120,124,9300,4
9300,2019-11-07,2019-11-06,MINNESOTA_TIMBERWOLVES,MEMPHIS_GRIZZLIES,121,137,9301,16
9301,2019-11-07,2019-11-06,ORLANDO_MAGIC,DALLAS_MAVERICKS,106,107,9302,1
9302,2019-11-07,2019-11-06,PHILADELPHIA_76ERS,UTAH_JAZZ,104,106,9303,2
9303,2019-11-07,2019-11-06,MILWAUKEE_BUCKS,LOS_ANGELES_CLIPPERS,129,124,9304,5
9304,2019-11-08,2019-11-07,BOSTON_CELTICS,CHARLOTTE_HORNETS,108,87,9305,21
9305,2019-11-08,2019-11-07,OKLAHOMA_CITY_THUNDER,SAN_ANTONIO_SPURS,112,121,9306,9
9306,2019-11-08,2019-11-07,MIAMI_HEAT,PHOENIX_SUNS,124,108,9307,16
9307,2019-11-08,2019-11-07,PORTLAND_TRAIL_BLAZERS,LOS_ANGELES_CLIPPERS,101,107,9308,6
9308,2019-11-09,2019-11-08,DETROIT_PISTONS,INDIANA_PACERS,106,112,9309,6
9309,2019-11-09,2019-11-08,MEMPHIS_GRIZZLIES,ORLANDO_MAGIC,86,118,9310,32
9310,2019-11-09,2019-11-08,CLEVELAND_CAVALIERS,WASHINGTON_WIZARDS,113,100,9311,13
9311,2019-11-09,2019-11-08,SACRAMENTO_KINGS,ATLANTA_HAWKS,121,109,9312,12
9312,2019-11-09,2019-11-08,GOLDEN_STATE_WARRIORS,MINNESOTA_TIMBERWOLVES,119,125,9313,6
9313,2019-11-09,2019-11-08,TORONTO_RAPTORS,NEW_ORLEANS_PELICANS,122,104,9314,18
9314,2019-11-09,2019-11-08,NEW_YORK_KNICKS,DALLAS_MAVERICKS,106,102,9315,4
9315,2019-11-09,2019-11-08,PHILADELPHIA_76ERS,DENVER_NUGGETS,97,100,9316,3
9316,2019-11-09,2019-11-08,MILWAUKEE_BUCKS,UTAH_JAZZ,100,103,9317,3
9317,2019-11-09,2019-11-08,BROOKLYN_NETS,PORTLAND_TRAIL_BLAZERS,119,115,9318,4
9318,2019-11-09,2019-11-08,MIAMI_HEAT,LOS_ANGELES_LAKERS,80,95,9319,15
9319,2019-11-09,2019-11-08,BOSTON_CELTICS,SAN_ANTONIO_SPURS,135,115,9320,20
9320,2019-11-10,2019-11-09,NEW_ORLEANS_PELICANS,CHARLOTTE_HORNETS,115,110,9321,5
9321,2019-11-10,2019-11-09,HOUSTON_ROCKETS,CHICAGO_BULLS,117,94,9322,23
9322,2019-11-10,2019-11-09,DALLAS_MAVERICKS,MEMPHIS_GRIZZLIES,138,122,9323,16
9323,2019-11-10,2019-11-09,GOLDEN_STATE_WARRIORS,OKLAHOMA_CITY_THUNDER,108,114,9324,6
9324,2019-11-10,2019-11-09,DENVER_NUGGETS,MINNESOTA_TIMBERWOLVES,100,98,9325,2
9325,2019-11-10,2019-11-09,INDIANA_PACERS,ORLANDO_MAGIC,109,102,9326,7
9326,2019-11-10,2019-11-09,CHARLOTTE_HORNETS,PHILADELPHIA_76ERS,106,114,9327,8
9327,2019-11-11,2019-11-10,MILWAUKEE_BUCKS,OKLAHOMA_CITY_THUNDER,121,119,9328,2
9328,2019-11-11,2019-11-10,CLEVELAND_CAVALIERS,NEW_YORK_KNICKS,108,87,9329,21
9329,2019-11-11,2019-11-10,BROOKLYN_NETS,PHOENIX_SUNS,112,138,9330,26
9330,2019-11-11,2019-11-10,ATLANTA_HAWKS,PORTLAND_TRAIL_BLAZERS,113,124,9331,11
9331,2019-11-11,2019-11-10,TORONTO_RAPTORS,LOS_ANGELES_LAKERS,113,104,9332,9
9332,2019-11-12,2019-11-11,MINNESOTA_TIMBERWOLVES,DETROIT_PISTONS,120,114,9333,6
9333,2019-11-12,2019-11-11,DALLAS_MAVERICKS,BOSTON_CELTICS,106,116,9334,10
9334,2019-11-12,2019-11-11,MEMPHIS_GRIZZLIES,SAN_ANTONIO_SPURS,113,109,9335,4
9335,2019-11-12,2019-11-11,HOUSTON_ROCKETS,NEW_ORLEANS_PELICANS,122,116,9336,6
9336,2019-11-12,2019-11-11,UTAH_JAZZ,GOLDEN_STATE_WARRIORS,122,108,9337,14
9337,2019-11-12,2019-11-11,TORONTO_RAPTORS,LOS_ANGELES_CLIPPERS,88,98,9338,10
9338,2019-11-13,2019-11-12,OKLAHOMA_CITY_THUNDER,INDIANA_PACERS,85,111,9339,26
9339,2019-11-13,2019-11-12,CLEVELAND_CAVALIERS,PHILADELPHIA_76ERS,97,98,9340,1
9340,2019-11-13,2019-11-12,DETROIT_PISTONS,MIAMI_HEAT,108,117,9341,9
9341,2019-11-13,2019-11-12,NEW_YORK_KNICKS,CHICAGO_BULLS,102,120,9342,18
9342,2019-11-13,2019-11-12,ATLANTA_HAWKS,DENVER_NUGGETS,125,121,9343,4
9343,2019-11-13,2019-11-12,LOS_ANGELES_LAKERS,PHOENIX_SUNS,123,115,9344,8
9344,2019-11-13,2019-11-12,BROOKLYN_NETS,UTAH_JAZZ,114,119,9345,5
9345,2019-11-13,2019-11-12,PORTLAND_TRAIL_BLAZERS,SACRAMENTO_KINGS,99,107,9346,8
9346,2019-11-14,2019-11-13,MEMPHIS_GRIZZLIES,CHARLOTTE_HORNETS,119,117,9347,2
9347,2019-11-14,2019-11-13,PHILADELPHIA_76ERS,ORLANDO_MAGIC,97,112,9348,15
9348,2019-11-14,2019-11-13,WASHINGTON_WIZARDS,BOSTON_CELTICS,133,140,9349,7
9349,2019-11-14,2019-11-13,LOS_ANGELES_CLIPPERS,HOUSTON_ROCKETS,93,102,9350,9
9350,2019-11-14,2019-11-13,SAN_ANTONIO_SPURS,MINNESOTA_TIMBERWOLVES,114,129,9351,15
9351,2019-11-14,2019-11-13,GOLDEN_STATE_WARRIORS,LOS_ANGELES_LAKERS,94,120,9352,26
9352,2019-11-14,2019-11-13,TORONTO_RAPTORS,PORTLAND_TRAIL_BLAZERS,114,106,9353,8
9353,2019-11-14,2019-11-13,MIAMI_HEAT,CLEVELAND_CAVALIERS,108,97,9354,11
9354,2019-11-15,2019-11-14,CHICAGO_BULLS,MILWAUKEE_BUCKS,115,124,9355,9
9355,2019-11-15,2019-11-14,LOS_ANGELES_CLIPPERS,NEW_ORLEANS_PELICANS,127,132,9356,5
9356,2019-11-15,2019-11-14,DALLAS_MAVERICKS,NEW_YORK_KNICKS,103,106,9357,3
9357,2019-11-15,2019-11-14,ATLANTA_HAWKS,PHOENIX_SUNS,112,128,9358,16
9358,2019-11-15,2019-11-14,BROOKLYN_NETS,DENVER_NUGGETS,93,101,9359,8
9359,2019-11-16,2019-11-15,DETROIT_PISTONS,CHARLOTTE_HORNETS,106,109,9360,3
9360,2019-11-16,2019-11-15,SAN_ANTONIO_SPURS,ORLANDO_MAGIC,109,111,9361,2
9361,2019-11-16,2019-11-15,INDIANA_PACERS,HOUSTON_ROCKETS,102,111,9362,9
9362,2019-11-16,2019-11-15,UTAH_JAZZ,MEMPHIS_GRIZZLIES,106,107,9363,1
9363,2019-11-16,2019-11-15,WASHINGTON_WIZARDS,MINNESOTA_TIMBERWOLVES,137,116,9364,21
9364,2019-11-16,2019-11-15,PHILADELPHIA_76ERS,OKLAHOMA_CITY_THUNDER,119,127,9365,8
9365,2019-11-16,2019-11-15,BOSTON_CELTICS,GOLDEN_STATE_WARRIORS,105,100,9366,5
9366,2019-11-16,2019-11-15,SACRAMENTO_KINGS,LOS_ANGELES_LAKERS,97,99,9367,2
9367,2019-11-16,2019-11-15,BROOKLYN_NETS,CHICAGO_BULLS,117,111,9368,6
9368,2019-11-17,2019-11-16,MILWAUKEE_BUCKS,INDIANA_PACERS,102,83,9369,19
9369,2019-11-17,2019-11-16,CHARLOTTE_HORNETS,NEW_YORK_KNICKS,103,102,9370,1
9370,2019-11-17,2019-11-16,NEW_ORLEANS_PELICANS,MIAMI_HEAT,94,109,9371,15
9371,2019-11-17,2019-11-16,HOUSTON_ROCKETS,MINNESOTA_TIMBERWOLVES,125,105,9372,20
9372,2019-11-17,2019-11-16,TORONTO_RAPTORS,DALLAS_MAVERICKS,102,110,9373,8
9373,2019-11-17,2019-11-16,PORTLAND_TRAIL_BLAZERS,SAN_ANTONIO_SPURS,121,116,9374,5
9374,2019-11-17,2019-11-16,ATLANTA_HAWKS,LOS_ANGELES_CLIPPERS,101,150,9375,49
9375,2019-11-17,2019-11-16,PHILADELPHIA_76ERS,CLEVELAND_CAVALIERS,114,95,9376,19
9376,2019-11-17,2019-11-16,BOSTON_CELTICS,SACRAMENTO_KINGS,99,100,9377,1
9377,2019-11-17,2019-11-16,DENVER_NUGGETS,MEMPHIS_GRIZZLIES,131,114,9378,17
9378,2019-11-17,2019-11-16,WASHINGTON_WIZARDS,ORLANDO_MAGIC,121,125,9379,4
9379,2019-11-18,2019-11-17,GOLDEN_STATE_WARRIORS,NEW_ORLEANS_PELICANS,100,108,9380,8
9380,2019-11-18,2019-11-17,ATLANTA_HAWKS,LOS_ANGELES_LAKERS,101,122,9381,21
9381,2019-11-19,2019-11-18,CLEVELAND_CAVALIERS,NEW_YORK_KNICKS,105,123,9382,18
9382,2019-11-19,2019-11-18,INDIANA_PACERS,BROOKLYN_NETS,115,86,9383,29
9383,2019-11-19,2019-11-18,CHARLOTTE_HORNETS,TORONTO_RAPTORS,96,132,9384,36
9384,2019-11-19,2019-11-18,MILWAUKEE_BUCKS,CHICAGO_BULLS,115,101,9385,14
9385,2019-11-19,2019-11-18,PORTLAND_TRAIL_BLAZERS,HOUSTON_ROCKETS,108,132,9386,24
9386,2019-11-19,2019-11-18,SAN_ANTONIO_SPURS,DALLAS_MAVERICKS,110,117,9387,7
9387,2019-11-19,2019-11-18,BOSTON_CELTICS,PHOENIX_SUNS,99,85,9388,14
9388,2019-11-19,2019-11-18,MINNESOTA_TIMBERWOLVES,UTAH_JAZZ,112,102,9389,10
9389,2019-11-19,2019-11-18,OKLAHOMA_CITY_THUNDER,LOS_ANGELES_CLIPPERS,88,90,9390,2
9390,2019-11-20,2019-11-19,GOLDEN_STATE_WARRIORS,MEMPHIS_GRIZZLIES,114,95,9391,19
9391,2019-11-20,2019-11-19,PORTLAND_TRAIL_BLAZERS,NEW_ORLEANS_PELICANS,104,115,9392,11
9392,2019-11-20,2019-11-19,PHOENIX_SUNS,SACRAMENTO_KINGS,116,120,9393,4
9393,2019-11-20,2019-11-19,OKLAHOMA_CITY_THUNDER,LOS_ANGELES_LAKERS,107,112,9394,5
9394,2019-11-21,2019-11-20,NEW_YORK_KNICKS,PHILADELPHIA_76ERS,104,109,9395,5
9395,2019-11-21,2019-11-20,SAN_ANTONIO_SPURS,WASHINGTON_WIZARDS,132,138,9396,6
9396,2019-11-21,2019-11-20,MILWAUKEE_BUCKS,ATLANTA_HAWKS,135,127,9397,8
9397,2019-11-21,2019-11-20,CHARLOTTE_HORNETS,BROOKLYN_NETS,91,101,9398,10
9398,2019-11-21,2019-11-20,GOLDEN_STATE_WARRIORS,DALLAS_MAVERICKS,94,142,9399,48
9399,2019-11-21,2019-11-20,CLEVELAND_CAVALIERS,MIAMI_HEAT,100,124,9400,24
9400,2019-11-21,2019-11-20,ORLANDO_MAGIC,TORONTO_RAPTORS,97,113,9401,16
9401,2019-11-21,2019-11-20,DETROIT_PISTONS,CHICAGO_BULLS,89,109,9402,20
9402,2019-11-21,2019-11-20,UTAH_JAZZ,MINNESOTA_TIMBERWOLVES,103,95,9403,8
9403,2019-11-21,2019-11-20,HOUSTON_ROCKETS,DENVER_NUGGETS,95,105,9404,10
9404,2019-11-21,2019-11-20,BOSTON_CELTICS,LOS_ANGELES_CLIPPERS,104,107,9405,3
9405,2019-11-22,2019-11-21,PORTLAND_TRAIL_BLAZERS,MILWAUKEE_BUCKS,129,137,9406,8
9406,2019-11-22,2019-11-21,NEW_ORLEANS_PELICANS,PHOENIX_SUNS,124,121,9407,3
9407,2019-11-23,2019-11-22,ATLANTA_HAWKS,DETROIT_PISTONS,103,128,9408,25
9408,2019-11-23,2019-11-22,CHARLOTTE_HORNETS,WASHINGTON_WIZARDS,118,125,9409,7
9409,2019-11-23,2019-11-22,SACRAMENTO_KINGS,BROOKLYN_NETS,97,116,9410,19
9410,2019-11-23,2019-11-22,MIAMI_HEAT,CHICAGO_BULLS,116,108,9411,8
9411,2019-11-23,2019-11-22,LOS_ANGELES_LAKERS,OKLAHOMA_CITY_THUNDER,130,127,9412,3
9412,2019-11-23,2019-11-22,SAN_ANTONIO_SPURS,PHILADELPHIA_76ERS,104,115,9413,11
9413,2019-11-23,2019-11-22,CLEVELAND_CAVALIERS,DALLAS_MAVERICKS,101,143,9414,42
9414,2019-11-23,2019-11-22,BOSTON_CELTICS,DENVER_NUGGETS,92,96,9415,4
9415,2019-11-23,2019-11-22,GOLDEN_STATE_WARRIORS,UTAH_JAZZ,109,113,9416,4
9416,2019-11-23,2019-11-22,HOUSTON_ROCKETS,LOS_ANGELES_CLIPPERS,119,122,9417,3
9417,2019-11-23,2019-11-22,PHOENIX_SUNS,MINNESOTA_TIMBERWOLVES,100,98,9418,2
9418,2019-11-24,2019-11-23,CHICAGO_BULLS,CHARLOTTE_HORNETS,116,115,9419,1
9419,2019-11-24,2019-11-23,ORLANDO_MAGIC,INDIANA_PACERS,106,111,9420,5
9420,2019-11-24,2019-11-23,TORONTO_RAPTORS,ATLANTA_HAWKS,119,116,9421,3
9421,2019-11-24,2019-11-23,SAN_ANTONIO_SPURS,NEW_YORK_KNICKS,111,104,9422,7
9422,2019-11-24,2019-11-23,MIAMI_HEAT,PHILADELPHIA_76ERS,86,113,9423,27
9423,2019-11-24,2019-11-23,PORTLAND_TRAIL_BLAZERS,CLEVELAND_CAVALIERS,104,110,9424,6
9424,2019-11-24,2019-11-23,LOS_ANGELES_LAKERS,MEMPHIS_GRIZZLIES,109,108,9425,1
9425,2019-11-24,2019-11-23,DETROIT_PISTONS,MILWAUKEE_BUCKS,90,104,9426,14
9426,2019-11-24,2019-11-23,NEW_ORLEANS_PELICANS,UTAH_JAZZ,120,128,9427,8
9427,2019-11-24,2019-11-23,DALLAS_MAVERICKS,HOUSTON_ROCKETS,137,123,9428,14
9428,2019-11-24,2019-11-23,BROOKLYN_NETS,NEW_YORK_KNICKS,103,101,9429,2
9429,2019-11-24,2019-11-23,SACRAMENTO_KINGS,WASHINGTON_WIZARDS,113,106,9430,7
9430,2019-11-25,2019-11-24,PHOENIX_SUNS,DENVER_NUGGETS,104,116,9431,12
9431,2019-11-25,2019-11-24,NEW_ORLEANS_PELICANS,LOS_ANGELES_CLIPPERS,109,134,9432,25
9432,2019-11-26,2019-11-25,BROOKLYN_NETS,CLEVELAND_CAVALIERS,108,106,9433,2
9433,2019-11-26,2019-11-25,ORLANDO_MAGIC,DETROIT_PISTONS,88,103,9434,15
9434,2019-11-26,2019-11-25,MEMPHIS_GRIZZLIES,INDIANA_PACERS,114,126,9435,12
9435,2019-11-26,2019-11-25,MINNESOTA_TIMBERWOLVES,ATLANTA_HAWKS,125,113,9436,12
9436,2019-11-26,2019-11-25,SACRAMENTO_KINGS,BOSTON_CELTICS,102,103,9437,1
9437,2019-11-26,2019-11-25,CHARLOTTE_HORNETS,MIAMI_HEAT,100,117,9438,17
9438,2019-11-26,2019-11-25,PHILADELPHIA_76ERS,TORONTO_RAPTORS,96,101,9439,5
9439,2019-11-26,2019-11-25,PORTLAND_TRAIL_BLAZERS,CHICAGO_BULLS,117,94,9440,23
9440,2019-11-26,2019-11-25,UTAH_JAZZ,MILWAUKEE_BUCKS,118,122,9441,4
9441,2019-11-26,2019-11-25,LOS_ANGELES_LAKERS,SAN_ANTONIO_SPURS,114,104,9442,10
9442,2019-11-26,2019-11-25,OKLAHOMA_CITY_THUNDER,GOLDEN_STATE_WARRIORS,100,97,9443,3
9443,2019-11-27,2019-11-26,LOS_ANGELES_CLIPPERS,DALLAS_MAVERICKS,114,99,9444,15
9444,2019-11-27,2019-11-26,WASHINGTON_WIZARDS,DENVER_NUGGETS,104,117,9445,13
9445,2019-11-28,2019-11-27,BROOKLYN_NETS,BOSTON_CELTICS,110,121,9446,11
9446,2019-11-28,2019-11-27,DETROIT_PISTONS,CHARLOTTE_HORNETS,101,102,9447,1
9447,2019-11-28,2019-11-27,ORLANDO_MAGIC,CLEVELAND_CAVALIERS,116,104,9448,12
9448,2019-11-28,2019-11-27,UTAH_JAZZ,INDIANA_PACERS,102,121,9449,19
9449,2019-11-28,2019-11-27,SACRAMENTO_KINGS,PHILADELPHIA_76ERS,91,97,9450,6
9450,2019-11-28,2019-11-27,NEW_YORK_KNICKS,TORONTO_RAPTORS,98,126,9451,28
9451,2019-11-28,2019-11-27,MIAMI_HEAT,HOUSTON_ROCKETS,108,117,9452,9
9452,2019-11-28,2019-11-27,LOS_ANGELES_CLIPPERS,MEMPHIS_GRIZZLIES,121,119,9453,2
9453,2019-11-28,2019-11-27,ATLANTA_HAWKS,MILWAUKEE_BUCKS,102,111,9454,9
9454,2019-11-28,2019-11-27,MINNESOTA_TIMBERWOLVES,SAN_ANTONIO_SPURS,113,101,9455,12
9455,2019-11-28,2019-11-27,WASHINGTON_WIZARDS,PHOENIX_SUNS,140,132,9456,8
9456,2019-11-28,2019-11-27,LOS_ANGELES_LAKERS,NEW_ORLEANS_PELICANS,114,110,9457,4
9457,2019-11-28,2019-11-27,OKLAHOMA_CITY_THUNDER,PORTLAND_TRAIL_BLAZERS,119,136,9458,17
9458,2019-11-28,2019-11-27,CHICAGO_BULLS,GOLDEN_STATE_WARRIORS,90,104,9459,14
9459,2019-11-29,2019-11-28,BOSTON_CELTICS,BROOKLYN_NETS,107,112,9460,5
9460,2019-11-30,2019-11-29,CHARLOTTE_HORNETS,DETROIT_PISTONS,110,107,9461,3
9461,2019-11-30,2019-11-29,TORONTO_RAPTORS,ORLANDO_MAGIC,90,83,9462,7
9462,2019-11-30,2019-11-29,MILWAUKEE_BUCKS,CLEVELAND_CAVALIERS,119,110,9463,9
9463,2019-11-30,2019-11-29,PHILADELPHIA_76ERS,NEW_YORK_KNICKS,101,95,9464,6
9464,2019-11-30,2019-11-29,ATLANTA_HAWKS,INDIANA_PACERS,104,105,9465,1
9465,2019-11-30,2019-11-29,UTAH_JAZZ,MEMPHIS_GRIZZLIES,103,94,9466,9
9466,2019-11-30,2019-11-29,GOLDEN_STATE_WARRIORS,MIAMI_HEAT,105,122,9467,17
9467,2019-11-30,2019-11-29,NEW_ORLEANS_PELICANS,OKLAHOMA_CITY_THUNDER,104,109,9468,5
9468,2019-11-30,2019-11-29,LOS_ANGELES_CLIPPERS,SAN_ANTONIO_SPURS,97,107,9469,10
9469,2019-11-30,2019-11-29,DALLAS_MAVERICKS,PHOENIX_SUNS,120,113,9470,7
9470,2019-11-30,2019-11-29,CHICAGO_BULLS,PORTLAND_TRAIL_BLAZERS,103,107,9471,4
9471,2019-11-30,2019-11-29,WASHINGTON_WIZARDS,LOS_ANGELES_LAKERS,103,125,9472,22
9472,2019-11-30,2019-11-29,DENVER_NUGGETS,SACRAMENTO_KINGS,97,100,9473,3
9473,2019-12-01,2019-11-30,INDIANA_PACERS,PHILADELPHIA_76ERS,116,119,9474,3
9474,2019-12-01,2019-11-30,ATLANTA_HAWKS,HOUSTON_ROCKETS,111,158,9475,47
9475,2019-12-01,2019-11-30,CHARLOTTE_HORNETS,MILWAUKEE_BUCKS,96,137,9476,41
9476,2019-12-01,2019-11-30,MIAMI_HEAT,BROOKLYN_NETS,109,106,9477,3
9477,2019-12-01,2019-11-30,MEMPHIS_GRIZZLIES,MINNESOTA_TIMBERWOLVES,115,107,9478,8
9478,2019-12-01,2019-11-30,BOSTON_CELTICS,NEW_YORK_KNICKS,113,104,9479,9
9479,2019-12-01,2019-11-30,DALLAS_MAVERICKS,LOS_ANGELES_LAKERS,114,100,9480,14
9480,2019-12-01,2019-11-30,SAN_ANTONIO_SPURS,DETROIT_PISTONS,98,132,9481,34
9481,2019-12-01,2019-11-30,OKLAHOMA_CITY_THUNDER,NEW_ORLEANS_PELICANS,107,104,9482,3
9482,2019-12-01,2019-11-30,GOLDEN_STATE_WARRIORS,ORLANDO_MAGIC,96,100,9483,4
9483,2019-12-01,2019-11-30,UTAH_JAZZ,TORONTO_RAPTORS,110,130,9484,20
9484,2019-12-02,2019-12-01,WASHINGTON_WIZARDS,LOS_ANGELES_CLIPPERS,125,150,9485,25
9485,2019-12-03,2019-12-02,PHOENIX_SUNS,CHARLOTTE_HORNETS,109,104,9486,5
9486,2019-12-03,2019-12-02,UTAH_JAZZ,PHILADELPHIA_76ERS,94,103,9487,9
9487,2019-12-03,2019-12-02,GOLDEN_STATE_WARRIORS,ATLANTA_HAWKS,79,104,9488,25
9488,2019-12-03,2019-12-02,INDIANA_PACERS,MEMPHIS_GRIZZLIES,117,104,9489,13
9489,2019-12-03,2019-12-02,NEW_YORK_KNICKS,MILWAUKEE_BUCKS,88,132,9490,44
9490,2019-12-03,2019-12-02,CHICAGO_BULLS,SACRAMENTO_KINGS,113,106,9491,7
9491,2019-12-04,2019-12-03,DETROIT_PISTONS,CLEVELAND_CAVALIERS,127,94,9492,33
9492,2019-12-04,2019-12-03,ORLANDO_MAGIC,WASHINGTON_WIZARDS,127,120,9493,7
9493,2019-12-04,2019-12-03,DALLAS_MAVERICKS,NEW_ORLEANS_PELICANS,118,97,9494,21
9494,2019-12-04,2019-12-03,MIAMI_HEAT,TORONTO_RAPTORS,121,110,9495,11
9495,2019-12-04,2019-12-03,HOUSTON_ROCKETS,SAN_ANTONIO_SPURS,133,135,9496,2
9496,2019-12-04,2019-12-03,LOS_ANGELES_LAKERS,DENVER_NUGGETS,105,96,9497,9
9497,2019-12-04,2019-12-03,PORTLAND_TRAIL_BLAZERS,LOS_ANGELES_CLIPPERS,97,117,9498,20
9498,2019-12-05,2019-12-04,GOLDEN_STATE_WARRIORS,CHARLOTTE_HORNETS,91,106,9499,15
9499,2019-12-05,2019-12-04,MILWAUKEE_BUCKS,DETROIT_PISTONS,127,103,9500,24
9500,2019-12-05,2019-12-04,PHOENIX_SUNS,ORLANDO_MAGIC,114,128,9501,14
9501,2019-12-05,2019-12-04,BROOKLYN_NETS,ATLANTA_HAWKS,130,118,9502,12
9502,2019-12-05,2019-12-04,MIAMI_HEAT,BOSTON_CELTICS,93,112,9503,19
9503,2019-12-05,2019-12-04,MEMPHIS_GRIZZLIES,CHICAGO_BULLS,99,106,9504,7
9504,2019-12-05,2019-12-04,INDIANA_PACERS,OKLAHOMA_CITY_THUNDER,107,100,9505,7
9505,2019-12-05,2019-12-04,MINNESOTA_TIMBERWOLVES,DALLAS_MAVERICKS,114,121,9506,7
9506,2019-12-05,2019-12-04,LOS_ANGELES_LAKERS,UTAH_JAZZ,121,96,9507,25
9507,2019-12-05,2019-12-04,SACRAMENTO_KINGS,PORTLAND_TRAIL_BLAZERS,116,127,9508,11
9508,2019-12-06,2019-12-05,PHILADELPHIA_76ERS,WASHINGTON_WIZARDS,113,119,9509,6
9509,2019-12-06,2019-12-05,DENVER_NUGGETS,NEW_YORK_KNICKS,129,92,9510,37
9510,2019-12-06,2019-12-05,HOUSTON_ROCKETS,TORONTO_RAPTORS,119,109,9511,10
9511,2019-12-06,2019-12-05,PHOENIX_SUNS,NEW_ORLEANS_PELICANS,139,132,9512,7
9512,2019-12-07,2019-12-06,BROOKLYN_NETS,CHARLOTTE_HORNETS,111,104,9513,7
9513,2019-12-07,2019-12-06,ORLANDO_MAGIC,CLEVELAND_CAVALIERS,93,87,9514,6
9514,2019-12-07,2019-12-06,INDIANA_PACERS,DETROIT_PISTONS,101,108,9515,7
9515,2019-12-07,2019-12-06,DENVER_NUGGETS,BOSTON_CELTICS,95,108,9516,13
9516,2019-12-07,2019-12-06,GOLDEN_STATE_WARRIORS,CHICAGO_BULLS,100,98,9517,2
9517,2019-12-07,2019-12-06,WASHINGTON_WIZARDS,MIAMI_HEAT,103,112,9518,9
9518,2019-12-07,2019-12-06,MINNESOTA_TIMBERWOLVES,OKLAHOMA_CITY_THUNDER,127,139,9519,12
9519,2019-12-07,2019-12-06,LOS_ANGELES_CLIPPERS,MILWAUKEE_BUCKS,91,119,9520,28
9520,2019-12-07,2019-12-06,SACRAMENTO_KINGS,SAN_ANTONIO_SPURS,104,105,9521,1
9521,2019-12-07,2019-12-06,LOS_ANGELES_LAKERS,PORTLAND_TRAIL_BLAZERS,136,113,9522,23
9522,2019-12-07,2019-12-06,NEW_ORLEANS_PELICANS,DALLAS_MAVERICKS,84,130,9523,46
9523,2019-12-08,2019-12-07,INDIANA_PACERS,NEW_YORK_KNICKS,104,103,9524,1
9524,2019-12-08,2019-12-07,CLEVELAND_CAVALIERS,PHILADELPHIA_76ERS,94,141,9525,47
9525,2019-12-08,2019-12-07,PHOENIX_SUNS,HOUSTON_ROCKETS,109,115,9526,6
9526,2019-12-08,2019-12-07,MEMPHIS_GRIZZLIES,UTAH_JAZZ,112,126,9527,14
9527,2019-12-08,2019-12-07,DENVER_NUGGETS,BROOKLYN_NETS,102,105,9528,3
9528,2019-12-08,2019-12-07,ATLANTA_HAWKS,CHARLOTTE_HORNETS,122,107,9529,15
9529,2019-12-08,2019-12-07,CHICAGO_BULLS,MIAMI_HEAT,105,110,9530,5
9530,2019-12-08,2019-12-07,TORONTO_RAPTORS,PHILADELPHIA_76ERS,104,110,9531,6
9531,2019-12-08,2019-12-07,LOS_ANGELES_CLIPPERS,WASHINGTON_WIZARDS,135,119,9532,16
9532,2019-12-09,2019-12-08,SACRAMENTO_KINGS,DALLAS_MAVERICKS,110,106,9533,4
9533,2019-12-09,2019-12-08,OKLAHOMA_CITY_THUNDER,PORTLAND_TRAIL_BLAZERS,108,96,9534,12
9534,2019-12-09,2019-12-08,MINNESOTA_TIMBERWOLVES,LOS_ANGELES_LAKERS,125,142,9535,17
9535,2019-12-10,2019-12-09,LOS_ANGELES_CLIPPERS,INDIANA_PACERS,110,99,9536,11
9536,2019-12-10,2019-12-09,CLEVELAND_CAVALIERS,BOSTON_CELTICS,88,110,9537,22
9537,2019-12-10,2019-12-09,TORONTO_RAPTORS,CHICAGO_BULLS,93,92,9538,1
9538,2019-12-10,2019-12-09,SACRAMENTO_KINGS,HOUSTON_ROCKETS,119,118,9539,1
9539,2019-12-10,2019-12-09,ORLANDO_MAGIC,MILWAUKEE_BUCKS,101,110,9540,9
9540,2019-12-10,2019-12-09,DETROIT_PISTONS,NEW_ORLEANS_PELICANS,105,103,9541,2
9541,2019-12-10,2019-12-09,MINNESOTA_TIMBERWOLVES,PHOENIX_SUNS,109,125,9542,16
9542,2019-12-10,2019-12-09,OKLAHOMA_CITY_THUNDER,UTAH_JAZZ,104,90,9543,14
9543,2019-12-10,2019-12-09,MEMPHIS_GRIZZLIES,GOLDEN_STATE_WARRIORS,110,102,9544,8
9544,2019-12-11,2019-12-10,WASHINGTON_WIZARDS,CHARLOTTE_HORNETS,107,114,9545,7
9545,2019-12-11,2019-12-10,ATLANTA_HAWKS,MIAMI_HEAT,121,135,9546,14
9546,2019-12-11,2019-12-10,DENVER_NUGGETS,PHILADELPHIA_76ERS,92,97,9547,5
9547,2019-12-11,2019-12-10,NEW_YORK_KNICKS,PORTLAND_TRAIL_BLAZERS,87,115,9548,28
9548,2019-12-12,2019-12-11,HOUSTON_ROCKETS,CLEVELAND_CAVALIERS,116,110,9549,6
9549,2019-12-12,2019-12-11,BOSTON_CELTICS,INDIANA_PACERS,117,122,9550,5
9550,2019-12-12,2019-12-11,LOS_ANGELES_LAKERS,ORLANDO_MAGIC,96,87,9551,9
9551,2019-12-12,2019-12-11,LOS_ANGELES_CLIPPERS,TORONTO_RAPTORS,112,92,9552,20
9552,2019-12-12,2019-12-11,CHARLOTTE_HORNETS,BROOKLYN_NETS,113,108,9553,5
9553,2019-12-12,2019-12-11,ATLANTA_HAWKS,CHICAGO_BULLS,102,136,9554,34
9554,2019-12-12,2019-12-11,UTAH_JAZZ,MINNESOTA_TIMBERWOLVES,127,116,9555,11
9555,2019-12-12,2019-12-11,MEMPHIS_GRIZZLIES,PHOENIX_SUNS,115,108,9556,7
9556,2019-12-12,2019-12-11,NEW_ORLEANS_PELICANS,MILWAUKEE_BUCKS,112,127,9557,15
9557,2019-12-12,2019-12-11,OKLAHOMA_CITY_THUNDER,SACRAMENTO_KINGS,93,94,9558,1
9558,2019-12-12,2019-12-11,NEW_YORK_KNICKS,GOLDEN_STATE_WARRIORS,124,122,9559,2
9559,2019-12-13,2019-12-12,PHILADELPHIA_76ERS,BOSTON_CELTICS,115,109,9560,6
9560,2019-12-13,2019-12-12,CLEVELAND_CAVALIERS,SAN_ANTONIO_SPURS,117,109,9561,8
9561,2019-12-13,2019-12-12,DALLAS_MAVERICKS,DETROIT_PISTONS,122,111,9562,11
9562,2019-12-13,2019-12-12,PORTLAND_TRAIL_BLAZERS,DENVER_NUGGETS,99,114,9563,15
9563,2019-12-14,2019-12-13,LOS_ANGELES_LAKERS,MIAMI_HEAT,113,110,9564,3
9564,2019-12-14,2019-12-13,HOUSTON_ROCKETS,ORLANDO_MAGIC,130,107,9565,23
9565,2019-12-14,2019-12-13,NEW_ORLEANS_PELICANS,PHILADELPHIA_76ERS,109,116,9566,7
9566,2019-12-14,2019-12-13,INDIANA_PACERS,ATLANTA_HAWKS,110,100,9567,10
9567,2019-12-14,2019-12-13,CHARLOTTE_HORNETS,CHICAGO_BULLS,83,73,9568,10
9568,2019-12-14,2019-12-13,MILWAUKEE_BUCKS,MEMPHIS_GRIZZLIES,127,114,9569,13
9569,2019-12-14,2019-12-13,GOLDEN_STATE_WARRIORS,UTAH_JAZZ,106,114,9570,8
9570,2019-12-14,2019-12-13,LOS_ANGELES_CLIPPERS,MINNESOTA_TIMBERWOLVES,124,117,9571,7
9571,2019-12-14,2019-12-13,NEW_YORK_KNICKS,SACRAMENTO_KINGS,103,101,9572,2
9572,2019-12-14,2019-12-13,SAN_ANTONIO_SPURS,PHOENIX_SUNS,121,119,9573,2
9573,2019-12-15,2019-12-14,BROOKLYN_NETS,TORONTO_RAPTORS,102,110,9574,8
9574,2019-12-15,2019-12-14,LOS_ANGELES_CLIPPERS,CHICAGO_BULLS,106,109,9575,3
9575,2019-12-15,2019-12-14,WASHINGTON_WIZARDS,MEMPHIS_GRIZZLIES,111,128,9576,17
9576,2019-12-15,2019-12-14,MIAMI_HEAT,DALLAS_MAVERICKS,122,118,9577,4
9577,2019-12-15,2019-12-14,CLEVELAND_CAVALIERS,MILWAUKEE_BUCKS,108,125,9578,17
9578,2019-12-15,2019-12-14,OKLAHOMA_CITY_THUNDER,DENVER_NUGGETS,102,110,9579,8
9579,2019-12-15,2019-12-14,DETROIT_PISTONS,HOUSTON_ROCKETS,115,107,9580,8
9580,2019-12-15,2019-12-14,ORLANDO_MAGIC,NEW_ORLEANS_PELICANS,130,119,9581,11
9581,2019-12-15,2019-12-14,CHARLOTTE_HORNETS,INDIANA_PACERS,85,107,9582,22
9582,2019-12-15,2019-12-14,LOS_ANGELES_LAKERS,ATLANTA_HAWKS,101,96,9583,5
9583,2019-12-15,2019-12-14,PHILADELPHIA_76ERS,BROOKLYN_NETS,89,109,9584,20
9584,2019-12-16,2019-12-15,NEW_YORK_KNICKS,DENVER_NUGGETS,105,111,9585,6
9585,2019-12-16,2019-12-15,SACRAMENTO_KINGS,GOLDEN_STATE_WARRIORS,100,79,9586,21
9586,2019-12-17,2019-12-16,WASHINGTON_WIZARDS,DETROIT_PISTONS,133,119,9587,14
9587,2019-12-17,2019-12-16,CLEVELAND_CAVALIERS,TORONTO_RAPTORS,113,133,9588,20
9588,2019-12-17,2019-12-16,SAN_ANTONIO_SPURS,HOUSTON_ROCKETS,107,109,9589,2
9589,2019-12-17,2019-12-16,MIAMI_HEAT,MEMPHIS_GRIZZLIES,111,118,9590,7
9590,2019-12-17,2019-12-16,DALLAS_MAVERICKS,MILWAUKEE_BUCKS,120,116,9591,4
9591,2019-12-17,2019-12-16,CHICAGO_BULLS,OKLAHOMA_CITY_THUNDER,106,109,9592,3
9592,2019-12-17,2019-12-16,PORTLAND_TRAIL_BLAZERS,PHOENIX_SUNS,111,110,9593,1
9593,2019-12-18,2019-12-17,SACRAMENTO_KINGS,CHARLOTTE_HORNETS,102,110,9594,8
9594,2019-12-18,2019-12-17,LOS_ANGELES_LAKERS,INDIANA_PACERS,102,105,9595,3
9595,2019-12-18,2019-12-17,ATLANTA_HAWKS,NEW_YORK_KNICKS,120,143,9596,23
9596,2019-12-18,2019-12-17,BROOKLYN_NETS,NEW_ORLEANS_PELICANS,108,101,9597,7
9597,2019-12-18,2019-12-17,ORLANDO_MAGIC,UTAH_JAZZ,102,109,9598,7
9598,2019-12-18,2019-12-17,PHOENIX_SUNS,LOS_ANGELES_CLIPPERS,99,120,9599,21
9599,2019-12-19,2019-12-18,CHARLOTTE_HORNETS,CLEVELAND_CAVALIERS,98,100,9600,2
9600,2019-12-19,2019-12-18,TORONTO_RAPTORS,DETROIT_PISTONS,112,99,9601,13
9601,2019-12-19,2019-12-18,MIAMI_HEAT,PHILADELPHIA_76ERS,108,104,9602,4
9602,2019-12-19,2019-12-18,CHICAGO_BULLS,WASHINGTON_WIZARDS,110,109,9603,1
9603,2019-12-19,2019-12-18,NEW_ORLEANS_PELICANS,MINNESOTA_TIMBERWOLVES,107,99,9604,8
9604,2019-12-19,2019-12-18,MEMPHIS_GRIZZLIES,OKLAHOMA_CITY_THUNDER,122,126,9605,4
9605,2019-12-19,2019-12-18,ORLANDO_MAGIC,DENVER_NUGGETS,104,113,9606,9
9606,2019-12-19,2019-12-18,BOSTON_CELTICS,DALLAS_MAVERICKS,109,103,9607,6
9607,2019-12-19,2019-12-18,GOLDEN_STATE_WARRIORS,PORTLAND_TRAIL_BLAZERS,112,122,9608,10
9608,2019-12-20,2019-12-19,UTAH_JAZZ,ATLANTA_HAWKS,111,106,9609,5
9609,2019-12-20,2019-12-19,LOS_ANGELES_LAKERS,MILWAUKEE_BUCKS,104,111,9610,7
9610,2019-12-20,2019-12-19,BROOKLYN_NETS,SAN_ANTONIO_SPURS,105,118,9611,13
9611,2019-12-20,2019-12-19,HOUSTON_ROCKETS,LOS_ANGELES_CLIPPERS,122,117,9612,5
9612,2019-12-21,2019-12-20,MEMPHIS_GRIZZLIES,CLEVELAND_CAVALIERS,107,114,9613,7
9613,2019-12-21,2019-12-20,SACRAMENTO_KINGS,INDIANA_PACERS,105,119,9614,14
9614,2019-12-21,2019-12-20,DETROIT_PISTONS,BOSTON_CELTICS,93,114,9615,21
9615,2019-12-21,2019-12-20,WASHINGTON_WIZARDS,TORONTO_RAPTORS,118,122,9616,4
9616,2019-12-21,2019-12-20,NEW_YORK_KNICKS,MIAMI_HEAT,114,129,9617,15
9617,2019-12-21,2019-12-20,PHOENIX_SUNS,OKLAHOMA_CITY_THUNDER,108,126,9618,18
9618,2019-12-21,2019-12-20,DALLAS_MAVERICKS,PHILADELPHIA_76ERS,117,98,9619,19
9619,2019-12-21,2019-12-20,MINNESOTA_TIMBERWOLVES,DENVER_NUGGETS,100,109,9620,9
9620,2019-12-21,2019-12-20,ORLANDO_MAGIC,PORTLAND_TRAIL_BLAZERS,103,118,9621,15
9621,2019-12-21,2019-12-20,NEW_ORLEANS_PELICANS,GOLDEN_STATE_WARRIORS,102,106,9622,4
9622,2019-12-21,2019-12-20,UTAH_JAZZ,CHARLOTTE_HORNETS,114,107,9623,7
9623,2019-12-21,2019-12-20,ATLANTA_HAWKS,BROOKLYN_NETS,112,122,9624,10
9624,2019-12-22,2019-12-21,CHICAGO_BULLS,DETROIT_PISTONS,119,107,9625,12
9625,2019-12-22,2019-12-21,WASHINGTON_WIZARDS,PHILADELPHIA_76ERS,108,125,9626,17
9626,2019-12-22,2019-12-21,MILWAUKEE_BUCKS,NEW_YORK_KNICKS,123,102,9627,21
9627,2019-12-22,2019-12-21,SACRAMENTO_KINGS,MEMPHIS_GRIZZLIES,115,119,9628,4
9628,2019-12-22,2019-12-21,LOS_ANGELES_CLIPPERS,SAN_ANTONIO_SPURS,134,109,9629,25
9629,2019-12-22,2019-12-21,HOUSTON_ROCKETS,PHOENIX_SUNS,139,125,9630,14
9630,2019-12-22,2019-12-21,MINNESOTA_TIMBERWOLVES,PORTLAND_TRAIL_BLAZERS,106,113,9631,7
9631,2019-12-22,2019-12-21,DALLAS_MAVERICKS,TORONTO_RAPTORS,107,110,9632,3
9632,2019-12-22,2019-12-21,CHARLOTTE_HORNETS,BOSTON_CELTICS,93,119,9633,26
9633,2019-12-23,2019-12-22,INDIANA_PACERS,MILWAUKEE_BUCKS,89,117,9634,28
9634,2019-12-23,2019-12-22,LOS_ANGELES_CLIPPERS,OKLAHOMA_CITY_THUNDER,112,118,9635,6
9635,2019-12-23,2019-12-22,DENVER_NUGGETS,LOS_ANGELES_LAKERS,128,104,9636,24
9636,2019-12-24,2019-12-23,ATLANTA_HAWKS,CLEVELAND_CAVALIERS,118,121,9637,3
9637,2019-12-24,2019-12-23,PHILADELPHIA_76ERS,DETROIT_PISTONS,125,109,9638,16
9638,2019-12-24,2019-12-23,TORONTO_RAPTORS,INDIANA_PACERS,115,120,9639,5
9639,2019-12-24,2019-12-23,WASHINGTON_WIZARDS,NEW_YORK_KNICKS,121,115,9640,6
9640,2019-12-24,2019-12-23,CHICAGO_BULLS,ORLANDO_MAGIC,95,103,9641,8
9641,2019-12-24,2019-12-23,UTAH_JAZZ,MIAMI_HEAT,104,107,9642,3
9642,2019-12-24,2019-12-23,SAN_ANTONIO_SPURS,MEMPHIS_GRIZZLIES,145,115,9643,30
9643,2019-12-24,2019-12-23,DENVER_NUGGETS,PHOENIX_SUNS,113,111,9644,2
9644,2019-12-24,2019-12-23,NEW_ORLEANS_PELICANS,PORTLAND_TRAIL_BLAZERS,102,94,9645,8
9645,2019-12-24,2019-12-23,HOUSTON_ROCKETS,SACRAMENTO_KINGS,113,104,9646,9
9646,2019-12-24,2019-12-23,MINNESOTA_TIMBERWOLVES,GOLDEN_STATE_WARRIORS,104,113,9647,9
9647,2019-12-25,2019-12-24,BOSTON_CELTICS,TORONTO_RAPTORS,118,102,9648,16
9648,2019-12-25,2019-12-24,MILWAUKEE_BUCKS,PHILADELPHIA_76ERS,109,121,9649,12
9649,2019-12-25,2019-12-24,HOUSTON_ROCKETS,GOLDEN_STATE_WARRIORS,104,116,9650,12
9650,2019-12-26,2019-12-25,LOS_ANGELES_CLIPPERS,LOS_ANGELES_LAKERS,111,106,9651,5
9651,2019-12-26,2019-12-25,NEW_ORLEANS_PELICANS,DENVER_NUGGETS,112,100,9652,12
9652,2019-12-27,2019-12-26,WASHINGTON_WIZARDS,DETROIT_PISTONS,102,132,9653,30
9653,2019-12-27,2019-12-26,NEW_YORK_KNICKS,BROOKLYN_NETS,94,82,9654,12
9654,2019-12-27,2019-12-26,SAN_ANTONIO_SPURS,DALLAS_MAVERICKS,98,102,9655,4
9655,2019-12-27,2019-12-26,MEMPHIS_GRIZZLIES,OKLAHOMA_CITY_THUNDER,110,97,9656,13
9656,2019-12-27,2019-12-26,MINNESOTA_TIMBERWOLVES,SACRAMENTO_KINGS,105,104,9657,1
9657,2019-12-27,2019-12-26,PORTLAND_TRAIL_BLAZERS,UTAH_JAZZ,115,121,9658,6
9658,2019-12-27,2019-12-26,CLEVELAND_CAVALIERS,BOSTON_CELTICS,117,129,9659,12
9659,2019-12-28,2019-12-27,OKLAHOMA_CITY_THUNDER,CHARLOTTE_HORNETS,104,102,9660,2
9660,2019-12-28,2019-12-27,PHILADELPHIA_76ERS,ORLANDO_MAGIC,97,98,9661,1
9661,2019-12-28,2019-12-27,MILWAUKEE_BUCKS,ATLANTA_HAWKS,112,86,9662,26
9662,2019-12-28,2019-12-27,INDIANA_PACERS,MIAMI_HEAT,112,113,9663,1
9663,2019-12-28,2019-12-27,PHOENIX_SUNS,GOLDEN_STATE_WARRIORS,96,105,9664,9
9664,2019-12-28,2019-12-27,MEMPHIS_GRIZZLIES,DENVER_NUGGETS,110,119,9665,9
9665,2019-12-29,2019-12-28,TORONTO_RAPTORS,BOSTON_CELTICS,113,97,9666,16
9666,2019-12-29,2019-12-28,INDIANA_PACERS,NEW_ORLEANS_PELICANS,98,120,9667,22
9667,2019-12-29,2019-12-28,ATLANTA_HAWKS,CHICAGO_BULLS,81,116,9668,35
9668,2019-12-29,2019-12-28,BROOKLYN_NETS,HOUSTON_ROCKETS,98,108,9669,10
9669,2019-12-29,2019-12-28,PHILADELPHIA_76ERS,MIAMI_HEAT,116,117,9670,1
9670,2019-12-29,2019-12-28,CLEVELAND_CAVALIERS,MINNESOTA_TIMBERWOLVES,94,88,9671,6
9671,2019-12-29,2019-12-28,NEW_YORK_KNICKS,WASHINGTON_WIZARDS,107,100,9672,7
9672,2019-12-29,2019-12-28,DALLAS_MAVERICKS,GOLDEN_STATE_WARRIORS,141,121,9673,20
9673,2019-12-29,2019-12-28,ORLANDO_MAGIC,MILWAUKEE_BUCKS,100,111,9674,11
9674,2019-12-29,2019-12-28,DETROIT_PISTONS,SAN_ANTONIO_SPURS,109,136,9675,27
9675,2019-12-29,2019-12-28,PHOENIX_SUNS,SACRAMENTO_KINGS,112,110,9676,2
9676,2019-12-29,2019-12-28,LOS_ANGELES_LAKERS,PORTLAND_TRAIL_BLAZERS,128,120,9677,8
9677,2019-12-29,2019-12-28,UTAH_JAZZ,LOS_ANGELES_CLIPPERS,120,107,9678,13
9678,2019-12-29,2019-12-28,OKLAHOMA_CITY_THUNDER,TORONTO_RAPTORS,98,97,9679,1
9679,2019-12-30,2019-12-29,SACRAMENTO_KINGS,DENVER_NUGGETS,115,120,9680,5
9680,2019-12-30,2019-12-29,CHARLOTTE_HORNETS,MEMPHIS_GRIZZLIES,104,117,9681,13
9681,2019-12-30,2019-12-29,HOUSTON_ROCKETS,NEW_ORLEANS_PELICANS,112,127,9682,15
9682,2019-12-30,2019-12-29,DALLAS_MAVERICKS,LOS_ANGELES_LAKERS,95,108,9683,13
9683,2019-12-31,2019-12-30,ATLANTA_HAWKS,ORLANDO_MAGIC,101,93,9684,8
9684,2019-12-31,2019-12-30,MIAMI_HEAT,WASHINGTON_WIZARDS,105,123,9685,18
9685,2019-12-31,2019-12-30,MILWAUKEE_BUCKS,CHICAGO_BULLS,123,102,9686,21
9686,2019-12-31,2019-12-30,BROOKLYN_NETS,MINNESOTA_TIMBERWOLVES,115,122,9687,7
9687,2019-12-31,2019-12-30,DETROIT_PISTONS,UTAH_JAZZ,81,104,9688,23
9688,2019-12-31,2019-12-30,PHOENIX_SUNS,PORTLAND_TRAIL_BLAZERS,122,116,9689,6
9689,2019-12-31,2019-12-30,BOSTON_CELTICS,CHARLOTTE_HORNETS,109,92,9690,17
9690,2019-12-31,2019-12-30,PHILADELPHIA_76ERS,INDIANA_PACERS,97,115,9691,18
9691,2019-12-31,2019-12-30,LOS_ANGELES_CLIPPERS,SACRAMENTO_KINGS,105,87,9692,18
9692,2020-01-01,2019-12-31,DENVER_NUGGETS,HOUSTON_ROCKETS,104,130,9693,26
9693,2020-01-01,2019-12-31,GOLDEN_STATE_WARRIORS,SAN_ANTONIO_SPURS,113,117,9694,4
9694,2020-01-01,2019-12-31,CLEVELAND_CAVALIERS,TORONTO_RAPTORS,97,117,9695,20
9695,2020-01-01,2019-12-31,DALLAS_MAVERICKS,OKLAHOMA_CITY_THUNDER,101,106,9696,5
9696,2020-01-01,2019-12-31,ORLANDO_MAGIC,WASHINGTON_WIZARDS,122,101,9697,21
9697,2020-01-02,2020-01-01,PORTLAND_TRAIL_BLAZERS,NEW_YORK_KNICKS,93,117,9698,24
9698,2020-01-02,2020-01-01,MINNESOTA_TIMBERWOLVES,MILWAUKEE_BUCKS,104,106,9699,2
9699,2020-01-02,2020-01-01,PHOENIX_SUNS,LOS_ANGELES_LAKERS,107,117,9700,10
9700,2020-01-03,2020-01-02,CHARLOTTE_HORNETS,CLEVELAND_CAVALIERS,109,106,9701,3
9701,2020-01-03,2020-01-02,DENVER_NUGGETS,INDIANA_PACERS,124,116,9702,8
9702,2020-01-03,2020-01-02,TORONTO_RAPTORS,MIAMI_HEAT,76,84,9703,8
9703,2020-01-03,2020-01-02,UTAH_JAZZ,CHICAGO_BULLS,102,98,9704,4
9704,2020-01-03,2020-01-02,GOLDEN_STATE_WARRIORS,MINNESOTA_TIMBERWOLVES,84,99,9705,15
9705,2020-01-03,2020-01-02,BROOKLYN_NETS,DALLAS_MAVERICKS,111,123,9706,12
9706,2020-01-03,2020-01-02,OKLAHOMA_CITY_THUNDER,SAN_ANTONIO_SPURS,109,103,9707,6
9707,2020-01-03,2020-01-02,MEMPHIS_GRIZZLIES,SACRAMENTO_KINGS,123,128,9708,5
9708,2020-01-03,2020-01-02,DETROIT_PISTONS,LOS_ANGELES_CLIPPERS,112,126,9709,14
9709,2020-01-04,2020-01-03,ATLANTA_HAWKS,BOSTON_CELTICS,106,109,9710,3
9710,2020-01-04,2020-01-03,MIAMI_HEAT,ORLANDO_MAGIC,85,105,9711,20
9711,2020-01-04,2020-01-03,PORTLAND_TRAIL_BLAZERS,WASHINGTON_WIZARDS,122,103,9712,19
9712,2020-01-04,2020-01-03,PHILADELPHIA_76ERS,HOUSTON_ROCKETS,108,118,9713,10
9713,2020-01-04,2020-01-03,NEW_YORK_KNICKS,PHOENIX_SUNS,112,120,9714,8
9714,2020-01-04,2020-01-03,NEW_ORLEANS_PELICANS,LOS_ANGELES_LAKERS,113,123,9715,10
9715,2020-01-04,2020-01-03,MEMPHIS_GRIZZLIES,LOS_ANGELES_CLIPPERS,140,114,9716,26
9716,2020-01-04,2020-01-03,TORONTO_RAPTORS,BROOKLYN_NETS,121,102,9717,19
9717,2020-01-05,2020-01-04,UTAH_JAZZ,ORLANDO_MAGIC,109,96,9718,13
9718,2020-01-05,2020-01-04,INDIANA_PACERS,ATLANTA_HAWKS,111,116,9719,5
9719,2020-01-05,2020-01-04,OKLAHOMA_CITY_THUNDER,CLEVELAND_CAVALIERS,121,106,9720,15
9720,2020-01-05,2020-01-04,BOSTON_CELTICS,CHICAGO_BULLS,111,104,9721,7
9721,2020-01-05,2020-01-04,DENVER_NUGGETS,WASHINGTON_WIZARDS,114,128,9722,14
9722,2020-01-05,2020-01-04,CHARLOTTE_HORNETS,DALLAS_MAVERICKS,123,120,9723,3
9723,2020-01-05,2020-01-04,DETROIT_PISTONS,GOLDEN_STATE_WARRIORS,111,104,9724,7
9724,2020-01-05,2020-01-04,SAN_ANTONIO_SPURS,MILWAUKEE_BUCKS,118,127,9725,9
9725,2020-01-05,2020-01-04,NEW_ORLEANS_PELICANS,SACRAMENTO_KINGS,117,115,9726,2
9726,2020-01-05,2020-01-04,NEW_YORK_KNICKS,LOS_ANGELES_CLIPPERS,132,135,9727,3
9727,2020-01-05,2020-01-04,PORTLAND_TRAIL_BLAZERS,MIAMI_HEAT,111,122,9728,11
9728,2020-01-06,2020-01-05,MINNESOTA_TIMBERWOLVES,CLEVELAND_CAVALIERS,118,103,9729,15
9729,2020-01-06,2020-01-05,MEMPHIS_GRIZZLIES,PHOENIX_SUNS,121,114,9730,7
9730,2020-01-06,2020-01-05,DETROIT_PISTONS,LOS_ANGELES_LAKERS,99,106,9731,7
9731,2020-01-07,2020-01-06,INDIANA_PACERS,CHARLOTTE_HORNETS,115,104,9732,11
9732,2020-01-07,2020-01-06,BROOKLYN_NETS,ORLANDO_MAGIC,89,101,9733,12
9733,2020-01-07,2020-01-06,OKLAHOMA_CITY_THUNDER,PHILADELPHIA_76ERS,113,120,9734,7
9734,2020-01-07,2020-01-06,BOSTON_CELTICS,WASHINGTON_WIZARDS,94,99,9735,5
9735,2020-01-07,2020-01-06,DENVER_NUGGETS,ATLANTA_HAWKS,123,115,9736,8
9736,2020-01-07,2020-01-06,UTAH_JAZZ,NEW_ORLEANS_PELICANS,128,126,9737,2
9737,2020-01-07,2020-01-06,CHICAGO_BULLS,DALLAS_MAVERICKS,110,118,9738,8
9738,2020-01-07,2020-01-06,MILWAUKEE_BUCKS,SAN_ANTONIO_SPURS,104,126,9739,22
9739,2020-01-07,2020-01-06,GOLDEN_STATE_WARRIORS,SACRAMENTO_KINGS,98,111,9740,13
9740,2020-01-08,2020-01-07,DETROIT_PISTONS,CLEVELAND_CAVALIERS,115,113,9741,2
9741,2020-01-08,2020-01-07,PORTLAND_TRAIL_BLAZERS,TORONTO_RAPTORS,101,99,9742,2
9742,2020-01-08,2020-01-07,OKLAHOMA_CITY_THUNDER,BROOKLYN_NETS,111,103,9743,8
9743,2020-01-08,2020-01-07,MINNESOTA_TIMBERWOLVES,MEMPHIS_GRIZZLIES,112,119,9744,7
9744,2020-01-08,2020-01-07,SACRAMENTO_KINGS,PHOENIX_SUNS,114,103,9745,11
9745,2020-01-08,2020-01-07,NEW_YORK_KNICKS,LOS_ANGELES_LAKERS,87,117,9746,30
9746,2020-01-09,2020-01-08,SAN_ANTONIO_SPURS,BOSTON_CELTICS,129,114,9747,15
9747,2020-01-09,2020-01-08,TORONTO_RAPTORS,CHARLOTTE_HORNETS,112,110,9748,2
9748,2020-01-09,2020-01-08,MIAMI_HEAT,INDIANA_PACERS,122,108,9749,14
9749,2020-01-09,2020-01-08,WASHINGTON_WIZARDS,ORLANDO_MAGIC,89,123,9750,34
9750,2020-01-09,2020-01-08,HOUSTON_ROCKETS,ATLANTA_HAWKS,122,115,9751,7
9751,2020-01-09,2020-01-08,DENVER_NUGGETS,DALLAS_MAVERICKS,107,106,9752,1
9752,2020-01-09,2020-01-08,CHICAGO_BULLS,NEW_ORLEANS_PELICANS,108,123,9753,15
9753,2020-01-09,2020-01-08,NEW_YORK_KNICKS,UTAH_JAZZ,104,128,9754,24
9754,2020-01-09,2020-01-08,MILWAUKEE_BUCKS,GOLDEN_STATE_WARRIORS,107,98,9755,9
9755,2020-01-10,2020-01-09,CLEVELAND_CAVALIERS,DETROIT_PISTONS,115,112,9756,3
9756,2020-01-10,2020-01-09,BOSTON_CELTICS,PHILADELPHIA_76ERS,98,109,9757,11
9757,2020-01-10,2020-01-09,PORTLAND_TRAIL_BLAZERS,MINNESOTA_TIMBERWOLVES,102,116,9758,14
9758,2020-01-10,2020-01-09,HOUSTON_ROCKETS,OKLAHOMA_CITY_THUNDER,92,113,9759,21
9759,2020-01-11,2020-01-10,ATLANTA_HAWKS,WASHINGTON_WIZARDS,101,111,9760,10
9760,2020-01-11,2020-01-10,NEW_ORLEANS_PELICANS,NEW_YORK_KNICKS,123,111,9761,12
9761,2020-01-11,2020-01-10,MIAMI_HEAT,BROOKLYN_NETS,113,117,9762,4
9762,2020-01-11,2020-01-10,INDIANA_PACERS,CHICAGO_BULLS,116,105,9763,11
9763,2020-01-11,2020-01-10,SAN_ANTONIO_SPURS,MEMPHIS_GRIZZLIES,121,134,9764,13
9764,2020-01-11,2020-01-10,ORLANDO_MAGIC,PHOENIX_SUNS,94,98,9765,4
9765,2020-01-11,2020-01-10,CHARLOTTE_HORNETS,UTAH_JAZZ,92,109,9766,17
9766,2020-01-11,2020-01-10,LOS_ANGELES_LAKERS,DALLAS_MAVERICKS,129,114,9767,15
9767,2020-01-11,2020-01-10,MILWAUKEE_BUCKS,SACRAMENTO_KINGS,127,106,9768,21
9768,2020-01-11,2020-01-10,GOLDEN_STATE_WARRIORS,LOS_ANGELES_CLIPPERS,100,109,9769,9
9769,2020-01-11,2020-01-10,MINNESOTA_TIMBERWOLVES,HOUSTON_ROCKETS,109,139,9770,30
9770,2020-01-12,2020-01-11,NEW_ORLEANS_PELICANS,BOSTON_CELTICS,105,140,9771,35
9771,2020-01-12,2020-01-11,CHICAGO_BULLS,DETROIT_PISTONS,108,99,9772,9
9772,2020-01-12,2020-01-11,LOS_ANGELES_LAKERS,OKLAHOMA_CITY_THUNDER,125,110,9773,15
9773,2020-01-12,2020-01-11,PHILADELPHIA_76ERS,DALLAS_MAVERICKS,91,109,9774,18
9774,2020-01-12,2020-01-11,CLEVELAND_CAVALIERS,DENVER_NUGGETS,111,103,9775,8
9775,2020-01-12,2020-01-11,MILWAUKEE_BUCKS,PORTLAND_TRAIL_BLAZERS,122,101,9776,21
9776,2020-01-12,2020-01-11,MIAMI_HEAT,NEW_YORK_KNICKS,121,124,9777,3
9777,2020-01-12,2020-01-11,UTAH_JAZZ,WASHINGTON_WIZARDS,127,116,9778,11
9778,2020-01-12,2020-01-11,ATLANTA_HAWKS,BROOKLYN_NETS,86,108,9779,22
9779,2020-01-12,2020-01-11,GOLDEN_STATE_WARRIORS,MEMPHIS_GRIZZLIES,102,122,9780,20
9780,2020-01-12,2020-01-11,SAN_ANTONIO_SPURS,TORONTO_RAPTORS,105,104,9781,1
9781,2020-01-13,2020-01-12,LOS_ANGELES_CLIPPERS,DENVER_NUGGETS,104,114,9782,10
9782,2020-01-13,2020-01-12,CHARLOTTE_HORNETS,PHOENIX_SUNS,92,100,9783,8
9783,2020-01-14,2020-01-13,NEW_ORLEANS_PELICANS,DETROIT_PISTONS,117,110,9784,7
9784,2020-01-14,2020-01-13,PHILADELPHIA_76ERS,INDIANA_PACERS,95,101,9785,6
9785,2020-01-14,2020-01-13,CHICAGO_BULLS,BOSTON_CELTICS,101,113,9786,12
9786,2020-01-14,2020-01-13,OKLAHOMA_CITY_THUNDER,MINNESOTA_TIMBERWOLVES,117,104,9787,13
9787,2020-01-14,2020-01-13,CHARLOTTE_HORNETS,PORTLAND_TRAIL_BLAZERS,112,115,9788,3
9788,2020-01-14,2020-01-13,ORLANDO_MAGIC,SACRAMENTO_KINGS,114,112,9789,2
9789,2020-01-14,2020-01-13,CLEVELAND_CAVALIERS,LOS_ANGELES_LAKERS,99,128,9790,29
9790,2020-01-15,2020-01-14,PHOENIX_SUNS,ATLANTA_HAWKS,110,123,9791,13
9791,2020-01-15,2020-01-14,UTAH_JAZZ,BROOKLYN_NETS,118,107,9792,11
9792,2020-01-15,2020-01-14,HOUSTON_ROCKETS,MEMPHIS_GRIZZLIES,110,121,9793,11
9793,2020-01-15,2020-01-14,NEW_YORK_KNICKS,MILWAUKEE_BUCKS,102,128,9794,26
9794,2020-01-15,2020-01-14,DALLAS_MAVERICKS,GOLDEN_STATE_WARRIORS,124,97,9795,27
9795,2020-01-15,2020-01-14,CLEVELAND_CAVALIERS,LOS_ANGELES_CLIPPERS,103,128,9796,25
9796,2020-01-16,2020-01-15,DETROIT_PISTONS,BOSTON_CELTICS,116,103,9797,13
9797,2020-01-16,2020-01-15,BROOKLYN_NETS,PHILADELPHIA_76ERS,106,117,9798,11
9798,2020-01-16,2020-01-15,SAN_ANTONIO_SPURS,MIAMI_HEAT,100,106,9799,6
9799,2020-01-16,2020-01-15,WASHINGTON_WIZARDS,CHICAGO_BULLS,106,115,9800,9
9800,2020-01-16,2020-01-15,INDIANA_PACERS,MINNESOTA_TIMBERWOLVES,104,99,9801,5
9801,2020-01-16,2020-01-15,TORONTO_RAPTORS,OKLAHOMA_CITY_THUNDER,130,121,9802,9
9802,2020-01-16,2020-01-15,CHARLOTTE_HORNETS,DENVER_NUGGETS,86,100,9803,14
9803,2020-01-16,2020-01-15,PORTLAND_TRAIL_BLAZERS,HOUSTON_ROCKETS,117,107,9804,10
9804,2020-01-16,2020-01-15,DALLAS_MAVERICKS,SACRAMENTO_KINGS,127,123,9805,4
9805,2020-01-16,2020-01-15,ORLANDO_MAGIC,LOS_ANGELES_LAKERS,119,118,9806,1
9806,2020-01-17,2020-01-16,PHOENIX_SUNS,NEW_YORK_KNICKS,121,98,9807,23
9807,2020-01-17,2020-01-16,BOSTON_CELTICS,MILWAUKEE_BUCKS,123,128,9808,5
9808,2020-01-17,2020-01-16,UTAH_JAZZ,NEW_ORLEANS_PELICANS,132,138,9809,6
9809,2020-01-17,2020-01-16,DENVER_NUGGETS,GOLDEN_STATE_WARRIORS,134,131,9810,3
9810,2020-01-17,2020-01-16,ORLANDO_MAGIC,LOS_ANGELES_CLIPPERS,95,122,9811,27
9811,2020-01-18,2020-01-17,MINNESOTA_TIMBERWOLVES,INDIANA_PACERS,114,116,9812,2
9812,2020-01-18,2020-01-17,CHICAGO_BULLS,PHILADELPHIA_76ERS,89,100,9813,11
9813,2020-01-18,2020-01-17,WASHINGTON_WIZARDS,TORONTO_RAPTORS,111,140,9814,29
9814,2020-01-18,2020-01-17,CLEVELAND_CAVALIERS,MEMPHIS_GRIZZLIES,109,113,9815,4
9815,2020-01-18,2020-01-17,MIAMI_HEAT,OKLAHOMA_CITY_THUNDER,115,108,9816,7
9816,2020-01-18,2020-01-17,ATLANTA_HAWKS,SAN_ANTONIO_SPURS,121,120,9817,1
9817,2020-01-18,2020-01-17,PORTLAND_TRAIL_BLAZERS,DALLAS_MAVERICKS,112,120,9818,8
9818,2020-01-18,2020-01-17,LOS_ANGELES_CLIPPERS,NEW_ORLEANS_PELICANS,133,130,9819,3
9819,2020-01-18,2020-01-17,MILWAUKEE_BUCKS,BROOKLYN_NETS,117,97,9820,20
9820,2020-01-19,2020-01-18,PHOENIX_SUNS,BOSTON_CELTICS,123,119,9821,4
9821,2020-01-19,2020-01-18,DETROIT_PISTONS,ATLANTA_HAWKS,136,103,9822,33
9822,2020-01-19,2020-01-18,PHILADELPHIA_76ERS,NEW_YORK_KNICKS,90,87,9823,3
9823,2020-01-19,2020-01-18,CLEVELAND_CAVALIERS,CHICAGO_BULLS,116,118,9824,2
9824,2020-01-19,2020-01-18,TORONTO_RAPTORS,MINNESOTA_TIMBERWOLVES,122,112,9825,10
9825,2020-01-19,2020-01-18,ORLANDO_MAGIC,GOLDEN_STATE_WARRIORS,95,109,9826,14
9826,2020-01-19,2020-01-18,LOS_ANGELES_LAKERS,HOUSTON_ROCKETS,124,115,9827,9
9827,2020-01-19,2020-01-18,PORTLAND_TRAIL_BLAZERS,OKLAHOMA_CITY_THUNDER,106,119,9828,13
9828,2020-01-19,2020-01-18,SACRAMENTO_KINGS,UTAH_JAZZ,101,123,9829,22
9829,2020-01-19,2020-01-18,MIAMI_HEAT,SAN_ANTONIO_SPURS,102,107,9830,5
9830,2020-01-20,2020-01-19,INDIANA_PACERS,DENVER_NUGGETS,115,107,9831,8
9831,2020-01-20,2020-01-19,DETROIT_PISTONS,WASHINGTON_WIZARDS,100,106,9832,6
9832,2020-01-20,2020-01-19,TORONTO_RAPTORS,ATLANTA_HAWKS,122,117,9833,5
9833,2020-01-20,2020-01-19,PHILADELPHIA_76ERS,BROOKLYN_NETS,117,111,9834,6
9834,2020-01-20,2020-01-19,ORLANDO_MAGIC,CHARLOTTE_HORNETS,106,83,9835,23
9835,2020-01-20,2020-01-19,NEW_YORK_KNICKS,CLEVELAND_CAVALIERS,106,86,9836,20
9836,2020-01-20,2020-01-19,OKLAHOMA_CITY_THUNDER,HOUSTON_ROCKETS,112,107,9837,5
9837,2020-01-20,2020-01-19,NEW_ORLEANS_PELICANS,MEMPHIS_GRIZZLIES,126,116,9838,10
9838,2020-01-20,2020-01-19,SACRAMENTO_KINGS,MIAMI_HEAT,113,118,9839,5
9839,2020-01-20,2020-01-19,CHICAGO_BULLS,MILWAUKEE_BUCKS,98,111,9840,13
9840,2020-01-21,2020-01-20,LOS_ANGELES_LAKERS,BOSTON_CELTICS,107,139,9841,32
9841,2020-01-21,2020-01-20,DENVER_NUGGETS,MINNESOTA_TIMBERWOLVES,107,100,9842,7
9842,2020-01-21,2020-01-20,SAN_ANTONIO_SPURS,PHOENIX_SUNS,120,118,9843,2
9843,2020-01-21,2020-01-20,INDIANA_PACERS,UTAH_JAZZ,88,118,9844,30
9844,2020-01-21,2020-01-20,GOLDEN_STATE_WARRIORS,PORTLAND_TRAIL_BLAZERS,124,129,9845,5
9845,2020-01-22,2020-01-21,LOS_ANGELES_CLIPPERS,DALLAS_MAVERICKS,110,107,9846,3
9846,2020-01-23,2020-01-22,SACRAMENTO_KINGS,DETROIT_PISTONS,106,127,9847,21
9847,2020-01-23,2020-01-22,OKLAHOMA_CITY_THUNDER,ORLANDO_MAGIC,120,114,9848,6
9848,2020-01-23,2020-01-22,PHILADELPHIA_76ERS,TORONTO_RAPTORS,95,107,9849,12
9849,2020-01-23,2020-01-22,LOS_ANGELES_CLIPPERS,ATLANTA_HAWKS,95,102,9850,7
9850,2020-01-23,2020-01-22,MEMPHIS_GRIZZLIES,BOSTON_CELTICS,95,119,9851,24
9851,2020-01-23,2020-01-22,WASHINGTON_WIZARDS,MIAMI_HEAT,129,134,9852,5
9852,2020-01-23,2020-01-22,LOS_ANGELES_LAKERS,NEW_YORK_KNICKS,100,92,9853,8
9853,2020-01-23,2020-01-22,MINNESOTA_TIMBERWOLVES,CHICAGO_BULLS,110,117,9854,7
9854,2020-01-23,2020-01-22,DENVER_NUGGETS,HOUSTON_ROCKETS,105,121,9855,16
9855,2020-01-23,2020-01-22,INDIANA_PACERS,PHOENIX_SUNS,112,87,9856,25
9856,2020-01-23,2020-01-22,SAN_ANTONIO_SPURS,NEW_ORLEANS_PELICANS,121,117,9857,4
9857,2020-01-23,2020-01-22,UTAH_JAZZ,GOLDEN_STATE_WARRIORS,129,96,9858,33
9858,2020-01-24,2020-01-23,WASHINGTON_WIZARDS,CLEVELAND_CAVALIERS,124,112,9859,12
9859,2020-01-24,2020-01-23,LOS_ANGELES_LAKERS,BROOKLYN_NETS,128,113,9860,15
9860,2020-01-24,2020-01-23,DALLAS_MAVERICKS,PORTLAND_TRAIL_BLAZERS,133,125,9861,8
9861,2020-01-24,2020-01-23,MILWAUKEE_BUCKS,CHARLOTTE_HORNETS,116,103,9862,13
9862,2020-01-25,2020-01-24,MEMPHIS_GRIZZLIES,DETROIT_PISTONS,125,112,9863,13
9863,2020-01-25,2020-01-24,BOSTON_CELTICS,ORLANDO_MAGIC,109,98,9864,11
9864,2020-01-25,2020-01-24,TORONTO_RAPTORS,NEW_YORK_KNICKS,118,112,9865,6
9865,2020-01-25,2020-01-24,SACRAMENTO_KINGS,CHICAGO_BULLS,98,81,9866,17
9866,2020-01-25,2020-01-24,LOS_ANGELES_CLIPPERS,MIAMI_HEAT,122,117,9867,5
9867,2020-01-25,2020-01-24,HOUSTON_ROCKETS,MINNESOTA_TIMBERWOLVES,131,124,9868,7
9868,2020-01-25,2020-01-24,DENVER_NUGGETS,NEW_ORLEANS_PELICANS,113,106,9869,7
9869,2020-01-25,2020-01-24,ATLANTA_HAWKS,OKLAHOMA_CITY_THUNDER,111,140,9870,29
9870,2020-01-25,2020-01-24,PHOENIX_SUNS,SAN_ANTONIO_SPURS,103,99,9871,4
9871,2020-01-25,2020-01-24,INDIANA_PACERS,GOLDEN_STATE_WARRIORS,129,118,9872,11
9872,2020-01-25,2020-01-24,DALLAS_MAVERICKS,UTAH_JAZZ,107,112,9873,5
9873,2020-01-26,2020-01-25,BROOKLYN_NETS,DETROIT_PISTONS,121,111,9874,10
9874,2020-01-26,2020-01-25,CHICAGO_BULLS,CLEVELAND_CAVALIERS,118,106,9875,12
9875,2020-01-26,2020-01-25,OKLAHOMA_CITY_THUNDER,MINNESOTA_TIMBERWOLVES,113,104,9876,9
9876,2020-01-26,2020-01-25,LOS_ANGELES_LAKERS,PHILADELPHIA_76ERS,91,108,9877,17
9877,2020-01-26,2020-01-25,HOUSTON_ROCKETS,DENVER_NUGGETS,110,117,9878,7
9878,2020-01-26,2020-01-25,TORONTO_RAPTORS,SAN_ANTONIO_SPURS,110,106,9879,4
9879,2020-01-26,2020-01-25,WASHINGTON_WIZARDS,ATLANTA_HAWKS,133,152,9880,19
9880,2020-01-26,2020-01-25,PHOENIX_SUNS,MEMPHIS_GRIZZLIES,109,114,9881,5
9881,2020-01-26,2020-01-25,BOSTON_CELTICS,NEW_ORLEANS_PELICANS,108,123,9882,15
9882,2020-01-26,2020-01-25,BROOKLYN_NETS,NEW_YORK_KNICKS,97,110,9883,13
9883,2020-01-26,2020-01-25,LOS_ANGELES_CLIPPERS,ORLANDO_MAGIC,112,97,9884,15
9884,2020-01-27,2020-01-26,INDIANA_PACERS,PORTLAND_TRAIL_BLAZERS,129,139,9885,10
9885,2020-01-28,2020-01-27,CLEVELAND_CAVALIERS,DETROIT_PISTONS,115,100,9886,15
9886,2020-01-28,2020-01-27,ORLANDO_MAGIC,MIAMI_HEAT,92,113,9887,21
9887,2020-01-28,2020-01-27,SAN_ANTONIO_SPURS,CHICAGO_BULLS,109,110,9888,1
9888,2020-01-28,2020-01-27,SACRAMENTO_KINGS,MINNESOTA_TIMBERWOLVES,133,129,9889,4
9889,2020-01-28,2020-01-27,DALLAS_MAVERICKS,OKLAHOMA_CITY_THUNDER,107,97,9890,10
9890,2020-01-28,2020-01-27,HOUSTON_ROCKETS,UTAH_JAZZ,126,117,9891,9
9891,2020-01-29,2020-01-28,NEW_YORK_KNICKS,CHARLOTTE_HORNETS,92,97,9892,5
9892,2020-01-29,2020-01-28,GOLDEN_STATE_WARRIORS,PHILADELPHIA_76ERS,104,115,9893,11
9893,2020-01-29,2020-01-28,NEW_ORLEANS_PELICANS,CLEVELAND_CAVALIERS,125,111,9894,14
9894,2020-01-29,2020-01-28,ATLANTA_HAWKS,TORONTO_RAPTORS,114,130,9895,16
9895,2020-01-29,2020-01-28,DENVER_NUGGETS,MEMPHIS_GRIZZLIES,96,104,9896,8
9896,2020-01-29,2020-01-28,BOSTON_CELTICS,MIAMI_HEAT,109,101,9897,8
9897,2020-01-29,2020-01-28,WASHINGTON_WIZARDS,MILWAUKEE_BUCKS,131,151,9898,20
9898,2020-01-29,2020-01-28,PHOENIX_SUNS,DALLAS_MAVERICKS,133,104,9899,29
9899,2020-01-30,2020-01-29,CHICAGO_BULLS,INDIANA_PACERS,106,115,9900,9
9900,2020-01-30,2020-01-29,DETROIT_PISTONS,BROOKLYN_NETS,115,125,9901,10
9901,2020-01-30,2020-01-29,MEMPHIS_GRIZZLIES,NEW_YORK_KNICKS,127,106,9902,21
9902,2020-01-30,2020-01-29,UTAH_JAZZ,SAN_ANTONIO_SPURS,120,127,9903,7
9903,2020-01-30,2020-01-29,HOUSTON_ROCKETS,PORTLAND_TRAIL_BLAZERS,112,125,9904,13
9904,2020-01-30,2020-01-29,OKLAHOMA_CITY_THUNDER,SACRAMENTO_KINGS,120,100,9905,20
9905,2020-01-31,2020-01-30,TORONTO_RAPTORS,CLEVELAND_CAVALIERS,115,109,9906,6
9906,2020-01-31,2020-01-30,CHARLOTTE_HORNETS,WASHINGTON_WIZARDS,107,121,9907,14
9907,2020-01-31,2020-01-30,PHILADELPHIA_76ERS,ATLANTA_HAWKS,117,127,9908,10
9908,2020-01-31,2020-01-30,GOLDEN_STATE_WARRIORS,BOSTON_CELTICS,104,119,9909,15
9909,2020-01-31,2020-01-30,UTAH_JAZZ,DENVER_NUGGETS,100,106,9910,6
9910,2020-01-31,2020-01-30,SACRAMENTO_KINGS,LOS_ANGELES_CLIPPERS,124,103,9911,21
9911,2020-02-01,2020-01-31,TORONTO_RAPTORS,DETROIT_PISTONS,105,92,9912,13
9912,2020-02-01,2020-01-31,CHICAGO_BULLS,BROOKLYN_NETS,118,133,9913,15
9913,2020-02-01,2020-01-31,DALLAS_MAVERICKS,HOUSTON_ROCKETS,121,128,9914,7
9914,2020-02-01,2020-01-31,MEMPHIS_GRIZZLIES,NEW_ORLEANS_PELICANS,111,139,9915,28
9915,2020-02-01,2020-01-31,DENVER_NUGGETS,MILWAUKEE_BUCKS,127,115,9916,12
9916,2020-02-01,2020-01-31,OKLAHOMA_CITY_THUNDER,PHOENIX_SUNS,111,107,9917,4
9917,2020-02-01,2020-01-31,PORTLAND_TRAIL_BLAZERS,LOS_ANGELES_LAKERS,127,119,9918,8
9918,2020-02-01,2020-01-31,MINNESOTA_TIMBERWOLVES,LOS_ANGELES_CLIPPERS,106,118,9919,12
9919,2020-02-02,2020-02-01,NEW_YORK_KNICKS,INDIANA_PACERS,92,85,9920,7
9920,2020-02-02,2020-02-01,MIAMI_HEAT,ORLANDO_MAGIC,102,89,9921,13
9921,2020-02-02,2020-02-01,GOLDEN_STATE_WARRIORS,CLEVELAND_CAVALIERS,131,112,9922,19
9922,2020-02-02,2020-02-01,BROOKLYN_NETS,WASHINGTON_WIZARDS,107,113,9923,6
9923,2020-02-02,2020-02-01,PHILADELPHIA_76ERS,BOSTON_CELTICS,95,116,9924,21
9924,2020-02-02,2020-02-01,ATLANTA_HAWKS,DALLAS_MAVERICKS,100,123,9925,23
9925,2020-02-02,2020-02-01,CHARLOTTE_HORNETS,SAN_ANTONIO_SPURS,90,114,9926,24
9926,2020-02-02,2020-02-01,LOS_ANGELES_LAKERS,SACRAMENTO_KINGS,129,113,9927,16
9927,2020-02-02,2020-02-01,UTAH_JAZZ,PORTLAND_TRAIL_BLAZERS,107,124,9928,17
9928,2020-02-02,2020-02-01,DENVER_NUGGETS,DETROIT_PISTONS,123,128,9929,5
9929,2020-02-02,2020-02-01,NEW_ORLEANS_PELICANS,HOUSTON_ROCKETS,109,117,9930,8
9930,2020-02-02,2020-02-01,PHOENIX_SUNS,MILWAUKEE_BUCKS,108,129,9931,21
9931,2020-02-02,2020-02-01,CHICAGO_BULLS,TORONTO_RAPTORS,102,129,9932,27
9932,2020-02-04,2020-02-03,ORLANDO_MAGIC,CHARLOTTE_HORNETS,112,100,9933,12
9933,2020-02-04,2020-02-03,NEW_YORK_KNICKS,CLEVELAND_CAVALIERS,139,134,9934,5
9934,2020-02-04,2020-02-03,DALLAS_MAVERICKS,INDIANA_PACERS,112,103,9935,9
9935,2020-02-04,2020-02-03,GOLDEN_STATE_WARRIORS,WASHINGTON_WIZARDS,125,117,9936,8
9936,2020-02-04,2020-02-03,BOSTON_CELTICS,ATLANTA_HAWKS,123,115,9937,8
9937,2020-02-04,2020-02-03,PHOENIX_SUNS,BROOKLYN_NETS,97,119,9938,22
9938,2020-02-04,2020-02-03,PHILADELPHIA_76ERS,MIAMI_HEAT,106,137,9939,31
9939,2020-02-04,2020-02-03,DETROIT_PISTONS,MEMPHIS_GRIZZLIES,82,96,9940,14
9940,2020-02-04,2020-02-03,MINNESOTA_TIMBERWOLVES,SACRAMENTO_KINGS,109,113,9941,4
9941,2020-02-04,2020-02-03,SAN_ANTONIO_SPURS,LOS_ANGELES_CLIPPERS,105,108,9942,3
9942,2020-02-05,2020-02-04,MILWAUKEE_BUCKS,NEW_ORLEANS_PELICANS,120,108,9943,12
9943,2020-02-05,2020-02-04,CHARLOTTE_HORNETS,HOUSTON_ROCKETS,110,125,9944,15
9944,2020-02-05,2020-02-04,PORTLAND_TRAIL_BLAZERS,DENVER_NUGGETS,99,127,9945,28
9945,2020-02-05,2020-02-04,SAN_ANTONIO_SPURS,LOS_ANGELES_LAKERS,102,129,9946,27
9946,2020-02-06,2020-02-05,PHOENIX_SUNS,DETROIT_PISTONS,108,116,9947,8
9947,2020-02-06,2020-02-05,ORLANDO_MAGIC,BOSTON_CELTICS,100,116,9948,16
9948,2020-02-06,2020-02-05,GOLDEN_STATE_WARRIORS,BROOKLYN_NETS,88,129,9949,41
9949,2020-02-06,2020-02-05,INDIANA_PACERS,TORONTO_RAPTORS,118,119,9950,1
9950,2020-02-06,2020-02-05,ATLANTA_HAWKS,MINNESOTA_TIMBERWOLVES,127,120,9951,7
9951,2020-02-06,2020-02-05,CLEVELAND_CAVALIERS,OKLAHOMA_CITY_THUNDER,103,109,9952,6
9952,2020-02-06,2020-02-05,MEMPHIS_GRIZZLIES,DALLAS_MAVERICKS,121,107,9953,14
9953,2020-02-06,2020-02-05,DENVER_NUGGETS,UTAH_JAZZ,98,95,9954,3
9954,2020-02-06,2020-02-05,MIAMI_HEAT,LOS_ANGELES_CLIPPERS,111,128,9955,17
9955,2020-02-07,2020-02-06,ORLANDO_MAGIC,NEW_YORK_KNICKS,103,105,9956,2
9956,2020-02-07,2020-02-06,NEW_ORLEANS_PELICANS,CHICAGO_BULLS,125,119,9957,6
9957,2020-02-07,2020-02-06,PHILADELPHIA_76ERS,MILWAUKEE_BUCKS,101,112,9958,11
9958,2020-02-07,2020-02-06,SAN_ANTONIO_SPURS,PORTLAND_TRAIL_BLAZERS,117,125,9959,8
9959,2020-02-07,2020-02-06,HOUSTON_ROCKETS,LOS_ANGELES_LAKERS,121,111,9960,10
9960,2020-02-08,2020-02-07,MEMPHIS_GRIZZLIES,PHILADELPHIA_76ERS,0,0,9961,0
9961,2020-02-08,2020-02-07,DALLAS_MAVERICKS,WASHINGTON_WIZARDS,0,0,9962,0
9962,2020-02-08,2020-02-07,ATLANTA_HAWKS,BOSTON_CELTICS,0,0,9963,0
9963,2020-02-08,2020-02-07,TORONTO_RAPTORS,INDIANA_PACERS,0,0,9964,0
9964,2020-02-08,2020-02-07,DETROIT_PISTONS,OKLAHOMA_CITY_THUNDER,0,0,9965,0
9965,2020-02-08,2020-02-07,HOUSTON_ROCKETS,PHOENIX_SUNS,0,0,9966,0
9966,2020-02-08,2020-02-07,MIAMI_HEAT,SACRAMENTO_KINGS,0,0,9967,0
9967,2020-02-08,2020-02-07,PORTLAND_TRAIL_BLAZERS,UTAH_JAZZ,0,0,9968,0
9968,2020-02-08,2020-02-07,MILWAUKEE_BUCKS,ORLANDO_MAGIC,0,0,9969,0
9969,2020-02-09,2020-02-08,DALLAS_MAVERICKS,CHARLOTTE_HORNETS,0,0,9970,0
9970,2020-02-09,2020-02-08,NEW_YORK_KNICKS,DETROIT_PISTONS,0,0,9971,0
9971,2020-02-09,2020-02-08,NEW_ORLEANS_PELICANS,INDIANA_PACERS,0,0,9972,0
9972,2020-02-09,2020-02-08,BROOKLYN_NETS,TORONTO_RAPTORS,0,0,9973,0
9973,2020-02-09,2020-02-08,LOS_ANGELES_CLIPPERS,MINNESOTA_TIMBERWOLVES,0,0,9974,0
9974,2020-02-09,2020-02-08,LOS_ANGELES_LAKERS,GOLDEN_STATE_WARRIORS,0,0,9975,0
9975,2020-02-09,2020-02-08,DENVER_NUGGETS,PHOENIX_SUNS,0,0,9976,0
9976,2020-02-09,2020-02-08,SAN_ANTONIO_SPURS,SACRAMENTO_KINGS,0,0,9977,0
9977,2020-02-09,2020-02-08,BOSTON_CELTICS,OKLAHOMA_CITY_THUNDER,0,0,9978,0
9978,2020-02-09,2020-02-08,NEW_YORK_KNICKS,ATLANTA_HAWKS,0,0,9979,0
9979,2020-02-09,2020-02-08,CHICAGO_BULLS,PHILADELPHIA_76ERS,0,0,9980,0
9980,2020-02-09,2020-02-08,MEMPHIS_GRIZZLIES,WASHINGTON_WIZARDS,0,0,9981,0
9981,2020-02-10,2020-02-09,UTAH_JAZZ,HOUSTON_ROCKETS,0,0,9982,0
9982,2020-02-10,2020-02-09,LOS_ANGELES_CLIPPERS,CLEVELAND_CAVALIERS,0,0,9983,0
9983,2020-02-10,2020-02-09,MIAMI_HEAT,PORTLAND_TRAIL_BLAZERS,0,0,9984,0
9984,2020-02-11,2020-02-10,CHARLOTTE_HORNETS,DETROIT_PISTONS,0,0,9985,0
9985,2020-02-11,2020-02-10,BROOKLYN_NETS,INDIANA_PACERS,0,0,9986,0
9986,2020-02-11,2020-02-10,ATLANTA_HAWKS,ORLANDO_MAGIC,0,0,9987,0
9987,2020-02-11,2020-02-10,MINNESOTA_TIMBERWOLVES,TORONTO_RAPTORS,0,0,9988,0
9988,2020-02-11,2020-02-10,SACRAMENTO_KINGS,MILWAUKEE_BUCKS,0,0,9989,0
9989,2020-02-11,2020-02-10,UTAH_JAZZ,DALLAS_MAVERICKS,0,0,9990,0
9990,2020-02-11,2020-02-10,SAN_ANTONIO_SPURS,DENVER_NUGGETS,0,0,9991,0
9991,2020-02-11,2020-02-10,MIAMI_HEAT,GOLDEN_STATE_WARRIORS,0,0,9992,0
9992,2020-02-11,2020-02-10,PHOENIX_SUNS,LOS_ANGELES_LAKERS,0,0,9993,0
9993,2020-02-12,2020-02-11,LOS_ANGELES_CLIPPERS,PHILADELPHIA_76ERS,0,0,9994,0
9994,2020-02-12,2020-02-11,CHICAGO_BULLS,WASHINGTON_WIZARDS,0,0,9995,0
9995,2020-02-12,2020-02-11,PORTLAND_TRAIL_BLAZERS,NEW_ORLEANS_PELICANS,0,0,9996,0
9996,2020-02-12,2020-02-11,SAN_ANTONIO_SPURS,OKLAHOMA_CITY_THUNDER,0,0,9997,0
9997,2020-02-12,2020-02-11,BOSTON_CELTICS,HOUSTON_ROCKETS,0,0,9998,0
9998,2020-02-13,2020-02-12,ATLANTA_HAWKS,CLEVELAND_CAVALIERS,0,0,9999,0
9999,2020-02-13,2020-02-12,DETROIT_PISTONS,ORLANDO_MAGIC,0,0,10000,0
10000,2020-02-13,2020-02-12,TORONTO_RAPTORS,BROOKLYN_NETS,0,0,10001,0
10001,2020-02-13,2020-02-12,MILWAUKEE_BUCKS,INDIANA_PACERS,0,0,10002,0
10002,2020-02-13,2020-02-12,WASHINGTON_WIZARDS,NEW_YORK_KNICKS,0,0,10003,0
10003,2020-02-13,2020-02-12,PORTLAND_TRAIL_BLAZERS,MEMPHIS_GRIZZLIES,0,0,10004,0
10004,2020-02-13,2020-02-12,CHARLOTTE_HORNETS,MINNESOTA_TIMBERWOLVES,0,0,10005,0
10005,2020-02-13,2020-02-12,SACRAMENTO_KINGS,DALLAS_MAVERICKS,0,0,10006,0
10006,2020-02-13,2020-02-12,GOLDEN_STATE_WARRIORS,PHOENIX_SUNS,0,0,10007,0
10007,2020-02-13,2020-02-12,MIAMI_HEAT,UTAH_JAZZ,0,0,10008,0
10008,2020-02-13,2020-02-12,LOS_ANGELES_LAKERS,DENVER_NUGGETS,0,0,10009,0
10009,2020-02-14,2020-02-13,LOS_ANGELES_CLIPPERS,BOSTON_CELTICS,0,0,10010,0
10010,2020-02-14,2020-02-13,OKLAHOMA_CITY_THUNDER,NEW_ORLEANS_PELICANS,0,0,10011,0
10011,2020-02-21,2020-02-20,MILWAUKEE_BUCKS,DETROIT_PISTONS,0,0,10012,0
10012,2020-02-21,2020-02-20,MIAMI_HEAT,ATLANTA_HAWKS,0,0,10013,0
10013,2020-02-21,2020-02-20,CHARLOTTE_HORNETS,CHICAGO_BULLS,0,0,10014,0
10014,2020-02-21,2020-02-20,BROOKLYN_NETS,PHILADELPHIA_76ERS,0,0,10015,0
10015,2020-02-21,2020-02-20,MEMPHIS_GRIZZLIES,SACRAMENTO_KINGS,0,0,10016,0
10016,2020-02-21,2020-02-20,HOUSTON_ROCKETS,GOLDEN_STATE_WARRIORS,0,0,10017,0
10017,2020-02-22,2020-02-21,DALLAS_MAVERICKS,ORLANDO_MAGIC,0,0,10018,0
10018,2020-02-22,2020-02-21,CLEVELAND_CAVALIERS,WASHINGTON_WIZARDS,0,0,10019,0
10019,2020-02-22,2020-02-21,INDIANA_PACERS,NEW_YORK_KNICKS,0,0,10020,0
10020,2020-02-22,2020-02-21,PHOENIX_SUNS,TORONTO_RAPTORS,0,0,10021,0
10021,2020-02-22,2020-02-21,BOSTON_CELTICS,MINNESOTA_TIMBERWOLVES,0,0,10022,0
10022,2020-02-22,2020-02-21,DENVER_NUGGETS,OKLAHOMA_CITY_THUNDER,0,0,10023,0
10023,2020-02-22,2020-02-21,SAN_ANTONIO_SPURS,UTAH_JAZZ,0,0,10024,0
10024,2020-02-22,2020-02-21,MEMPHIS_GRIZZLIES,LOS_ANGELES_LAKERS,0,0,10025,0
10025,2020-02-22,2020-02-21,NEW_ORLEANS_PELICANS,PORTLAND_TRAIL_BLAZERS,0,0,10026,0
10026,2020-02-22,2020-02-21,SACRAMENTO_KINGS,LOS_ANGELES_CLIPPERS,0,0,10027,0
10027,2020-02-23,2020-02-22,BROOKLYN_NETS,CHARLOTTE_HORNETS,0,0,10028,0
10028,2020-02-23,2020-02-22,DALLAS_MAVERICKS,ATLANTA_HAWKS,0,0,10029,0
10029,2020-02-23,2020-02-22,PHOENIX_SUNS,CHICAGO_BULLS,0,0,10030,0
10030,2020-02-23,2020-02-22,CLEVELAND_CAVALIERS,MIAMI_HEAT,0,0,10031,0
10031,2020-02-23,2020-02-22,PHILADELPHIA_76ERS,MILWAUKEE_BUCKS,0,0,10032,0
10032,2020-02-23,2020-02-22,HOUSTON_ROCKETS,UTAH_JAZZ,0,0,10033,0
10033,2020-02-23,2020-02-22,BOSTON_CELTICS,LOS_ANGELES_LAKERS,0,0,10034,0
10034,2020-02-23,2020-02-22,MINNESOTA_TIMBERWOLVES,DENVER_NUGGETS,0,0,10035,0
10035,2020-02-23,2020-02-22,INDIANA_PACERS,TORONTO_RAPTORS,0,0,10036,0
10036,2020-02-24,2020-02-23,WASHINGTON_WIZARDS,CHICAGO_BULLS,0,0,10037,0
10037,2020-02-24,2020-02-23,SAN_ANTONIO_SPURS,OKLAHOMA_CITY_THUNDER,0,0,10038,0
10038,2020-02-24,2020-02-23,NEW_ORLEANS_PELICANS,GOLDEN_STATE_WARRIORS,0,0,10039,0
10039,2020-02-24,2020-02-23,DETROIT_PISTONS,PORTLAND_TRAIL_BLAZERS,0,0,10040,0
10040,2020-02-25,2020-02-24,MIAMI_HEAT,CLEVELAND_CAVALIERS,0,0,10041,0
10041,2020-02-25,2020-02-24,ATLANTA_HAWKS,PHILADELPHIA_76ERS,0,0,10042,0
10042,2020-02-25,2020-02-24,MILWAUKEE_BUCKS,WASHINGTON_WIZARDS,0,0,10043,0
10043,2020-02-25,2020-02-24,ORLANDO_MAGIC,BROOKLYN_NETS,0,0,10044,0
10044,2020-02-25,2020-02-24,NEW_YORK_KNICKS,HOUSTON_ROCKETS,0,0,10045,0
10045,2020-02-25,2020-02-24,MINNESOTA_TIMBERWOLVES,DALLAS_MAVERICKS,0,0,10046,0
10046,2020-02-25,2020-02-24,PHOENIX_SUNS,UTAH_JAZZ,0,0,10047,0
10047,2020-02-25,2020-02-24,MEMPHIS_GRIZZLIES,LOS_ANGELES_CLIPPERS,0,0,10048,0
10048,2020-02-26,2020-02-25,CHARLOTTE_HORNETS,INDIANA_PACERS,0,0,10049,0
10049,2020-02-26,2020-02-25,MILWAUKEE_BUCKS,TORONTO_RAPTORS,0,0,10050,0
10050,2020-02-26,2020-02-25,OKLAHOMA_CITY_THUNDER,CHICAGO_BULLS,0,0,10051,0
10051,2020-02-26,2020-02-25,DETROIT_PISTONS,DENVER_NUGGETS,0,0,10052,0
10052,2020-02-26,2020-02-25,NEW_ORLEANS_PELICANS,LOS_ANGELES_LAKERS,0,0,10053,0
10053,2020-02-26,2020-02-25,BOSTON_CELTICS,PORTLAND_TRAIL_BLAZERS,0,0,10054,0
10054,2020-02-26,2020-02-25,SACRAMENTO_KINGS,GOLDEN_STATE_WARRIORS,0,0,10055,0
10055,2020-02-27,2020-02-26,NEW_YORK_KNICKS,CHARLOTTE_HORNETS,0,0,10056,0
10056,2020-02-27,2020-02-26,PHILADELPHIA_76ERS,CLEVELAND_CAVALIERS,0,0,10057,0
10057,2020-02-27,2020-02-26,BROOKLYN_NETS,WASHINGTON_WIZARDS,0,0,10058,0
10058,2020-02-27,2020-02-26,ORLANDO_MAGIC,ATLANTA_HAWKS,0,0,10059,0
10059,2020-02-27,2020-02-26,MINNESOTA_TIMBERWOLVES,MIAMI_HEAT,0,0,10060,0
10060,2020-02-27,2020-02-26,DALLAS_MAVERICKS,SAN_ANTONIO_SPURS,0,0,10061,0
10061,2020-02-27,2020-02-26,MEMPHIS_GRIZZLIES,HOUSTON_ROCKETS,0,0,10062,0
10062,2020-02-27,2020-02-26,LOS_ANGELES_CLIPPERS,PHOENIX_SUNS,0,0,10063,0
10063,2020-02-27,2020-02-26,BOSTON_CELTICS,UTAH_JAZZ,0,0,10064,0
10064,2020-02-28,2020-02-27,NEW_YORK_KNICKS,PHILADELPHIA_76ERS,0,0,10065,0
10065,2020-02-28,2020-02-27,PORTLAND_TRAIL_BLAZERS,INDIANA_PACERS,0,0,10066,0
10066,2020-02-28,2020-02-27,SACRAMENTO_KINGS,OKLAHOMA_CITY_THUNDER,0,0,10067,0
10067,2020-02-28,2020-02-27,LOS_ANGELES_LAKERS,GOLDEN_STATE_WARRIORS,0,0,10068,0
10068,2020-02-29,2020-02-28,MINNESOTA_TIMBERWOLVES,ORLANDO_MAGIC,0,0,10069,0
10069,2020-02-29,2020-02-28,BROOKLYN_NETS,ATLANTA_HAWKS,0,0,10070,0
10070,2020-02-29,2020-02-28,CHARLOTTE_HORNETS,TORONTO_RAPTORS,0,0,10071,0
10071,2020-02-29,2020-02-28,SACRAMENTO_KINGS,MEMPHIS_GRIZZLIES,0,0,10072,0
10072,2020-02-29,2020-02-28,DALLAS_MAVERICKS,MIAMI_HEAT,0,0,10073,0
10073,2020-02-29,2020-02-28,OKLAHOMA_CITY_THUNDER,MILWAUKEE_BUCKS,0,0,10074,0
10074,2020-02-29,2020-02-28,CLEVELAND_CAVALIERS,NEW_ORLEANS_PELICANS,0,0,10075,0
10075,2020-02-29,2020-02-28,DETROIT_PISTONS,PHOENIX_SUNS,0,0,10076,0
10076,2020-02-29,2020-02-28,WASHINGTON_WIZARDS,UTAH_JAZZ,0,0,10077,0
10077,2020-02-29,2020-02-28,DENVER_NUGGETS,LOS_ANGELES_CLIPPERS,0,0,10078,0
10078,2020-02-29,2020-02-28,CHICAGO_BULLS,NEW_YORK_KNICKS,0,0,10079,0
10079,2020-03-01,2020-02-29,PORTLAND_TRAIL_BLAZERS,ATLANTA_HAWKS,0,0,10080,0
10080,2020-03-01,2020-02-29,BROOKLYN_NETS,MIAMI_HEAT,0,0,10081,0
10081,2020-03-01,2020-02-29,INDIANA_PACERS,CLEVELAND_CAVALIERS,0,0,10082,0
10082,2020-03-01,2020-02-29,LOS_ANGELES_LAKERS,MEMPHIS_GRIZZLIES,0,0,10083,0
10083,2020-03-01,2020-02-29,HOUSTON_ROCKETS,BOSTON_CELTICS,0,0,10084,0
10084,2020-03-01,2020-02-29,ORLANDO_MAGIC,SAN_ANTONIO_SPURS,0,0,10085,0
10085,2020-03-01,2020-02-29,GOLDEN_STATE_WARRIORS,PHOENIX_SUNS,0,0,10086,0
10086,2020-03-01,2020-02-29,MILWAUKEE_BUCKS,CHARLOTTE_HORNETS,0,0,10087,0
10087,2020-03-01,2020-02-29,PHILADELPHIA_76ERS,LOS_ANGELES_CLIPPERS,0,0,10088,0
10088,2020-03-01,2020-02-29,DALLAS_MAVERICKS,MINNESOTA_TIMBERWOLVES,0,0,10089,0
10089,2020-03-01,2020-02-29,TORONTO_RAPTORS,DENVER_NUGGETS,0,0,10090,0
10090,2020-03-01,2020-02-29,DETROIT_PISTONS,SACRAMENTO_KINGS,0,0,10091,0
10091,2020-03-02,2020-03-01,LOS_ANGELES_LAKERS,NEW_ORLEANS_PELICANS,0,0,10092,0
10092,2020-03-02,2020-03-01,WASHINGTON_WIZARDS,GOLDEN_STATE_WARRIORS,0,0,10093,0
10093,2020-03-03,2020-03-02,UTAH_JAZZ,CLEVELAND_CAVALIERS,0,0,10094,0
10094,2020-03-03,2020-03-02,HOUSTON_ROCKETS,NEW_YORK_KNICKS,0,0,10095,0
10095,2020-03-03,2020-03-02,PORTLAND_TRAIL_BLAZERS,ORLANDO_MAGIC,0,0,10096,0
10096,2020-03-03,2020-03-02,MEMPHIS_GRIZZLIES,ATLANTA_HAWKS,0,0,10097,0
10097,2020-03-03,2020-03-02,MILWAUKEE_BUCKS,MIAMI_HEAT,0,0,10098,0
10098,2020-03-03,2020-03-02,DALLAS_MAVERICKS,CHICAGO_BULLS,0,0,10099,0
10099,2020-03-03,2020-03-02,INDIANA_PACERS,SAN_ANTONIO_SPURS,0,0,10100,0
10100,2020-03-04,2020-03-03,SAN_ANTONIO_SPURS,CHARLOTTE_HORNETS,0,0,10101,0
10101,2020-03-04,2020-03-03,BROOKLYN_NETS,BOSTON_CELTICS,0,0,10102,0
10102,2020-03-04,2020-03-03,MINNESOTA_TIMBERWOLVES,NEW_ORLEANS_PELICANS,0,0,10103,0
10103,2020-03-04,2020-03-03,LOS_ANGELES_CLIPPERS,OKLAHOMA_CITY_THUNDER,0,0,10104,0
10104,2020-03-04,2020-03-03,GOLDEN_STATE_WARRIORS,DENVER_NUGGETS,0,0,10105,0
10105,2020-03-04,2020-03-03,TORONTO_RAPTORS,PHOENIX_SUNS,0,0,10106,0
10106,2020-03-04,2020-03-03,PHILADELPHIA_76ERS,LOS_ANGELES_LAKERS,0,0,10107,0
10107,2020-03-04,2020-03-03,WASHINGTON_WIZARDS,SACRAMENTO_KINGS,0,0,10108,0
10108,2020-03-05,2020-03-04,BOSTON_CELTICS,CLEVELAND_CAVALIERS,0,0,10109,0
10109,2020-03-05,2020-03-04,OKLAHOMA_CITY_THUNDER,DETROIT_PISTONS,0,0,10110,0
10110,2020-03-05,2020-03-04,INDIANA_PACERS,MILWAUKEE_BUCKS,0,0,10111,0
10111,2020-03-05,2020-03-04,MEMPHIS_GRIZZLIES,BROOKLYN_NETS,0,0,10112,0
10112,2020-03-05,2020-03-04,ORLANDO_MAGIC,MIAMI_HEAT,0,0,10113,0
10113,2020-03-05,2020-03-04,UTAH_JAZZ,NEW_YORK_KNICKS,0,0,10114,0
10114,2020-03-05,2020-03-04,CHICAGO_BULLS,MINNESOTA_TIMBERWOLVES,0,0,10115,0
10115,2020-03-05,2020-03-04,NEW_ORLEANS_PELICANS,DALLAS_MAVERICKS,0,0,10116,0
10116,2020-03-05,2020-03-04,WASHINGTON_WIZARDS,PORTLAND_TRAIL_BLAZERS,0,0,10117,0
10117,2020-03-06,2020-03-05,DENVER_NUGGETS,CHARLOTTE_HORNETS,0,0,10118,0
10118,2020-03-06,2020-03-05,LOS_ANGELES_CLIPPERS,HOUSTON_ROCKETS,0,0,10119,0
10119,2020-03-06,2020-03-05,PHILADELPHIA_76ERS,SACRAMENTO_KINGS,0,0,10120,0
10120,2020-03-06,2020-03-05,TORONTO_RAPTORS,GOLDEN_STATE_WARRIORS,0,0,10121,0
10121,2020-03-07,2020-03-06,ATLANTA_HAWKS,WASHINGTON_WIZARDS,0,0,10122,0
10122,2020-03-07,2020-03-06,SAN_ANTONIO_SPURS,BROOKLYN_NETS,0,0,10123,0
10123,2020-03-07,2020-03-06,OKLAHOMA_CITY_THUNDER,NEW_YORK_KNICKS,0,0,10124,0
10124,2020-03-07,2020-03-06,UTAH_JAZZ,BOSTON_CELTICS,0,0,10125,0
10125,2020-03-07,2020-03-06,INDIANA_PACERS,CHICAGO_BULLS,0,0,10126,0
10126,2020-03-07,2020-03-06,ORLANDO_MAGIC,MINNESOTA_TIMBERWOLVES,0,0,10127,0
10127,2020-03-07,2020-03-06,MIAMI_HEAT,NEW_ORLEANS_PELICANS,0,0,10128,0
10128,2020-03-07,2020-03-06,MEMPHIS_GRIZZLIES,DALLAS_MAVERICKS,0,0,10129,0
10129,2020-03-07,2020-03-06,PORTLAND_TRAIL_BLAZERS,PHOENIX_SUNS,0,0,10130,0
10130,2020-03-07,2020-03-06,MILWAUKEE_BUCKS,LOS_ANGELES_LAKERS,0,0,10131,0
10131,2020-03-07,2020-03-06,HOUSTON_ROCKETS,CHARLOTTE_HORNETS,0,0,10132,0
10132,2020-03-08,2020-03-07,UTAH_JAZZ,DETROIT_PISTONS,0,0,10133,0
10133,2020-03-08,2020-03-07,DENVER_NUGGETS,CLEVELAND_CAVALIERS,0,0,10134,0
10134,2020-03-08,2020-03-07,ATLANTA_HAWKS,MEMPHIS_GRIZZLIES,0,0,10135,0
10135,2020-03-08,2020-03-07,PHILADELPHIA_76ERS,GOLDEN_STATE_WARRIORS,0,0,10136,0
10136,2020-03-08,2020-03-07,SACRAMENTO_KINGS,PORTLAND_TRAIL_BLAZERS,0,0,10137,0
10137,2020-03-08,2020-03-07,CHICAGO_BULLS,BROOKLYN_NETS,0,0,10138,0
10138,2020-03-08,2020-03-07,LOS_ANGELES_LAKERS,LOS_ANGELES_CLIPPERS,0,0,10139,0
10139,2020-03-08,2020-03-07,NEW_ORLEANS_PELICANS,MINNESOTA_TIMBERWOLVES,0,0,10140,0
10140,2020-03-08,2020-03-07,OKLAHOMA_CITY_THUNDER,BOSTON_CELTICS,0,0,10141,0
10141,2020-03-08,2020-03-07,MILWAUKEE_BUCKS,PHOENIX_SUNS,0,0,10142,0
10142,2020-03-08,2020-03-07,INDIANA_PACERS,DALLAS_MAVERICKS,0,0,10143,0
10143,2020-03-08,2020-03-07,ORLANDO_MAGIC,HOUSTON_ROCKETS,0,0,10144,0
10144,2020-03-08,2020-03-07,MIAMI_HEAT,WASHINGTON_WIZARDS,0,0,10145,0
10145,2020-03-08,2020-03-07,SAN_ANTONIO_SPURS,CLEVELAND_CAVALIERS,0,0,10146,0
10146,2020-03-08,2020-03-07,DETROIT_PISTONS,NEW_YORK_KNICKS,0,0,10147,0
10147,2020-03-09,2020-03-08,TORONTO_RAPTORS,SACRAMENTO_KINGS,0,0,10148,0
10148,2020-03-09,2020-03-08,CHARLOTTE_HORNETS,ATLANTA_HAWKS,0,0,10149,0
10149,2020-03-10,2020-03-09,MILWAUKEE_BUCKS,DENVER_NUGGETS,0,0,10150,0
10150,2020-03-10,2020-03-09,TORONTO_RAPTORS,UTAH_JAZZ,0,0,10151,0
10151,2020-03-10,2020-03-09,BOSTON_CELTICS,INDIANA_PACERS,0,0,10152,0
10152,2020-03-10,2020-03-09,NEW_YORK_KNICKS,WASHINGTON_WIZARDS,0,0,10153,0
10153,2020-03-11,2020-03-10,CLEVELAND_CAVALIERS,CHICAGO_BULLS,0,0,10154,0
10154,2020-03-11,2020-03-10,MINNESOTA_TIMBERWOLVES,HOUSTON_ROCKETS,0,0,10155,0
10155,2020-03-11,2020-03-10,ORLANDO_MAGIC,MEMPHIS_GRIZZLIES,0,0,10156,0
10156,2020-03-11,2020-03-10,DALLAS_MAVERICKS,SAN_ANTONIO_SPURS,0,0,10157,0
10157,2020-03-11,2020-03-10,PHOENIX_SUNS,PORTLAND_TRAIL_BLAZERS,0,0,10158,0
10158,2020-03-11,2020-03-10,LOS_ANGELES_CLIPPERS,GOLDEN_STATE_WARRIORS,0,0,10159,0
10159,2020-03-11,2020-03-10,BROOKLYN_NETS,LOS_ANGELES_LAKERS,0,0,10160,0
10160,2020-03-11,2020-03-10,NEW_YORK_KNICKS,ATLANTA_HAWKS,0,0,10161,0
10161,2020-03-11,2020-03-10,CHARLOTTE_HORNETS,MIAMI_HEAT,0,0,10162,0
10162,2020-03-11,2020-03-10,DETROIT_PISTONS,PHILADELPHIA_76ERS,0,0,10163,0
10163,2020-03-12,2020-03-11,UTAH_JAZZ,OKLAHOMA_CITY_THUNDER,0,0,10164,0
10164,2020-03-12,2020-03-11,DENVER_NUGGETS,DALLAS_MAVERICKS,0,0,10165,0
10165,2020-03-12,2020-03-11,NEW_ORLEANS_PELICANS,SACRAMENTO_KINGS,0,0,10166,0
10166,2020-03-12,2020-03-11,CHICAGO_BULLS,ORLANDO_MAGIC,0,0,10167,0
10167,2020-03-13,2020-03-12,BOSTON_CELTICS,MILWAUKEE_BUCKS,0,0,10168,0
10168,2020-03-13,2020-03-12,MEMPHIS_GRIZZLIES,PORTLAND_TRAIL_BLAZERS,0,0,10169,0
10169,2020-03-13,2020-03-12,BROOKLYN_NETS,GOLDEN_STATE_WARRIORS,0,0,10170,0
10170,2020-03-13,2020-03-12,HOUSTON_ROCKETS,LOS_ANGELES_LAKERS,0,0,10171,0
10171,2020-03-13,2020-03-12,CLEVELAND_CAVALIERS,CHARLOTTE_HORNETS,0,0,10172,0
10172,2020-03-13,2020-03-12,WASHINGTON_WIZARDS,BOSTON_CELTICS,0,0,10173,0
10173,2020-03-14,2020-03-13,NEW_YORK_KNICKS,MIAMI_HEAT,0,0,10174,0
10174,2020-03-14,2020-03-13,MINNESOTA_TIMBERWOLVES,OKLAHOMA_CITY_THUNDER,0,0,10175,0
10175,2020-03-14,2020-03-13,DENVER_NUGGETS,SAN_ANTONIO_SPURS,0,0,10176,0
10176,2020-03-14,2020-03-13,NEW_ORLEANS_PELICANS,UTAH_JAZZ,0,0,10177,0
10177,2020-03-14,2020-03-13,BROOKLYN_NETS,LOS_ANGELES_CLIPPERS,0,0,10178,0
10178,2020-03-14,2020-03-13,PHOENIX_SUNS,DALLAS_MAVERICKS,0,0,10179,0
10179,2020-03-14,2020-03-13,CLEVELAND_CAVALIERS,ATLANTA_HAWKS,0,0,10180,0
10180,2020-03-14,2020-03-13,INDIANA_PACERS,PHILADELPHIA_76ERS,0,0,10181,0
10181,2020-03-14,2020-03-13,DETROIT_PISTONS,TORONTO_RAPTORS,0,0,10182,0
10182,2020-03-15,2020-03-14,CHICAGO_BULLS,MIAMI_HEAT,0,0,10183,0
10183,2020-03-15,2020-03-14,GOLDEN_STATE_WARRIORS,MILWAUKEE_BUCKS,0,0,10184,0
10184,2020-03-15,2020-03-14,MINNESOTA_TIMBERWOLVES,SAN_ANTONIO_SPURS,0,0,10185,0
10185,2020-03-15,2020-03-14,MEMPHIS_GRIZZLIES,UTAH_JAZZ,0,0,10186,0
10186,2020-03-15,2020-03-14,NEW_ORLEANS_PELICANS,LOS_ANGELES_CLIPPERS,0,0,10187,0
10187,2020-03-15,2020-03-14,HOUSTON_ROCKETS,PORTLAND_TRAIL_BLAZERS,0,0,10188,0
10188,2020-03-15,2020-03-14,CHARLOTTE_HORNETS,ORLANDO_MAGIC,0,0,10189,0
10189,2020-03-15,2020-03-14,OKLAHOMA_CITY_THUNDER,WASHINGTON_WIZARDS,0,0,10190,0
10190,2020-03-16,2020-03-15,BOSTON_CELTICS,CHICAGO_BULLS,0,0,10191,0
10191,2020-03-16,2020-03-15,DENVER_NUGGETS,LOS_ANGELES_LAKERS,0,0,10192,0
10192,2020-03-16,2020-03-15,BROOKLYN_NETS,SACRAMENTO_KINGS,0,0,10193,0
10193,2020-03-16,2020-03-15,WASHINGTON_WIZARDS,PHILADELPHIA_76ERS,0,0,10194,0
10194,2020-03-17,2020-03-16,MIAMI_HEAT,MILWAUKEE_BUCKS,0,0,10195,0
10195,2020-03-17,2020-03-16,ATLANTA_HAWKS,NEW_ORLEANS_PELICANS,0,0,10196,0
10196,2020-03-17,2020-03-16,GOLDEN_STATE_WARRIORS,TORONTO_RAPTORS,0,0,10197,0
10197,2020-03-17,2020-03-16,MEMPHIS_GRIZZLIES,SAN_ANTONIO_SPURS,0,0,10198,0
10198,2020-03-17,2020-03-16,LOS_ANGELES_LAKERS,UTAH_JAZZ,0,0,10199,0
10199,2020-03-17,2020-03-16,DALLAS_MAVERICKS,LOS_ANGELES_CLIPPERS,0,0,10200,0
10200,2020-03-17,2020-03-16,ORLANDO_MAGIC,DETROIT_PISTONS,0,0,10201,0
10201,2020-03-17,2020-03-16,CHARLOTTE_HORNETS,NEW_YORK_KNICKS,0,0,10202,0
10202,2020-03-18,2020-03-17,CLEVELAND_CAVALIERS,HOUSTON_ROCKETS,0,0,10203,0
10203,2020-03-18,2020-03-17,OKLAHOMA_CITY_THUNDER,MEMPHIS_GRIZZLIES,0,0,10204,0
10204,2020-03-18,2020-03-17,MINNESOTA_TIMBERWOLVES,PORTLAND_TRAIL_BLAZERS,0,0,10205,0
10205,2020-03-18,2020-03-17,DALLAS_MAVERICKS,SACRAMENTO_KINGS,0,0,10206,0
10206,2020-03-18,2020-03-17,TORONTO_RAPTORS,PHILADELPHIA_76ERS,0,0,10207,0
10207,2020-03-18,2020-03-17,OKLAHOMA_CITY_THUNDER,ATLANTA_HAWKS,0,0,10208,0
10208,2020-03-18,2020-03-17,NEW_YORK_KNICKS,BOSTON_CELTICS,0,0,10209,0
10209,2020-03-18,2020-03-17,WASHINGTON_WIZARDS,BROOKLYN_NETS,0,0,10210,0
10210,2020-03-18,2020-03-17,GOLDEN_STATE_WARRIORS,INDIANA_PACERS,0,0,10211,0
10211,2020-03-19,2020-03-18,MIAMI_HEAT,CHICAGO_BULLS,0,0,10212,0
10212,2020-03-19,2020-03-18,SAN_ANTONIO_SPURS,NEW_ORLEANS_PELICANS,0,0,10213,0
10213,2020-03-19,2020-03-18,LOS_ANGELES_CLIPPERS,DENVER_NUGGETS,0,0,10214,0
10214,2020-03-19,2020-03-18,UTAH_JAZZ,LOS_ANGELES_LAKERS,0,0,10215,0
10215,2020-03-19,2020-03-18,MINNESOTA_TIMBERWOLVES,PHOENIX_SUNS,0,0,10216,0
10216,2020-03-19,2020-03-18,PHILADELPHIA_76ERS,CHARLOTTE_HORNETS,0,0,10217,0
10217,2020-03-19,2020-03-18,CLEVELAND_CAVALIERS,ORLANDO_MAGIC,0,0,10218,0
10218,2020-03-20,2020-03-19,SACRAMENTO_KINGS,HOUSTON_ROCKETS,0,0,10219,0
10219,2020-03-20,2020-03-19,MEMPHIS_GRIZZLIES,MILWAUKEE_BUCKS,0,0,10220,0
10220,2020-03-20,2020-03-19,DALLAS_MAVERICKS,PORTLAND_TRAIL_BLAZERS,0,0,10221,0
10221,2020-03-20,2020-03-19,GOLDEN_STATE_WARRIORS,DETROIT_PISTONS,0,0,10222,0
10222,2020-03-20,2020-03-19,MIAMI_HEAT,INDIANA_PACERS,0,0,10223,0
10223,2020-03-20,2020-03-19,WASHINGTON_WIZARDS,ATLANTA_HAWKS,0,0,10224,0
10224,2020-03-20,2020-03-19,BOSTON_CELTICS,TORONTO_RAPTORS,0,0,10225,0
10225,2020-03-21,2020-03-20,DENVER_NUGGETS,OKLAHOMA_CITY_THUNDER,0,0,10226,0
10226,2020-03-21,2020-03-20,CHICAGO_BULLS,SAN_ANTONIO_SPURS,0,0,10227,0
10227,2020-03-21,2020-03-20,MINNESOTA_TIMBERWOLVES,UTAH_JAZZ,0,0,10228,0
10228,2020-03-21,2020-03-20,PHOENIX_SUNS,LOS_ANGELES_CLIPPERS,0,0,10229,0
10229,2020-03-21,2020-03-20,BOSTON_CELTICS,BROOKLYN_NETS,0,0,10230,0
10230,2020-03-21,2020-03-20,LOS_ANGELES_LAKERS,CHARLOTTE_HORNETS,0,0,10231,0
10231,2020-03-21,2020-03-20,CLEVELAND_CAVALIERS,INDIANA_PACERS,0,0,10232,0
10232,2020-03-21,2020-03-20,SACRAMENTO_KINGS,ORLANDO_MAGIC,0,0,10233,0
10233,2020-03-21,2020-03-20,ATLANTA_HAWKS,PHILADELPHIA_76ERS,0,0,10234,0
10234,2020-03-21,2020-03-20,GOLDEN_STATE_WARRIORS,NEW_YORK_KNICKS,0,0,10235,0
10235,2020-03-22,2020-03-21,CHICAGO_BULLS,HOUSTON_ROCKETS,0,0,10236,0
10236,2020-03-22,2020-03-21,NEW_ORLEANS_PELICANS,MEMPHIS_GRIZZLIES,0,0,10237,0
10237,2020-03-22,2020-03-21,MILWAUKEE_BUCKS,WASHINGTON_WIZARDS,0,0,10238,0
10238,2020-03-22,2020-03-21,DALLAS_MAVERICKS,PHOENIX_SUNS,0,0,10239,0
10239,2020-03-22,2020-03-21,LOS_ANGELES_LAKERS,DETROIT_PISTONS,0,0,10240,0
10240,2020-03-22,2020-03-21,DENVER_NUGGETS,TORONTO_RAPTORS,0,0,10241,0
10241,2020-03-22,2020-03-21,PORTLAND_TRAIL_BLAZERS,MINNESOTA_TIMBERWOLVES,0,0,10242,0
10242,2020-03-22,2020-03-21,SACRAMENTO_KINGS,NEW_ORLEANS_PELICANS,0,0,10243,0
10243,2020-03-22,2020-03-21,UTAH_JAZZ,SAN_ANTONIO_SPURS,0,0,10244,0
10244,2020-03-23,2020-03-22,PHOENIX_SUNS,INDIANA_PACERS,0,0,10245,0
10245,2020-03-23,2020-03-22,LOS_ANGELES_CLIPPERS,NEW_YORK_KNICKS,0,0,10246,0
10246,2020-03-23,2020-03-22,BOSTON_CELTICS,WASHINGTON_WIZARDS,0,0,10247,0
10247,2020-03-23,2020-03-22,ORLANDO_MAGIC,BROOKLYN_NETS,0,0,10248,0
10248,2020-03-23,2020-03-22,OKLAHOMA_CITY_THUNDER,MIAMI_HEAT,0,0,10249,0
10249,2020-03-24,2020-03-23,DENVER_NUGGETS,CHICAGO_BULLS,0,0,10250,0
10250,2020-03-24,2020-03-23,DETROIT_PISTONS,MILWAUKEE_BUCKS,0,0,10251,0
10251,2020-03-24,2020-03-23,HOUSTON_ROCKETS,DALLAS_MAVERICKS,0,0,10252,0
10252,2020-03-24,2020-03-23,PORTLAND_TRAIL_BLAZERS,CHARLOTTE_HORNETS,0,0,10253,0
10253,2020-03-24,2020-03-23,SACRAMENTO_KINGS,CLEVELAND_CAVALIERS,0,0,10254,0
10254,2020-03-24,2020-03-23,LOS_ANGELES_LAKERS,TORONTO_RAPTORS,0,0,10255,0
10255,2020-03-25,2020-03-24,PHILADELPHIA_76ERS,MINNESOTA_TIMBERWOLVES,0,0,10256,0
10256,2020-03-25,2020-03-24,MEMPHIS_GRIZZLIES,NEW_ORLEANS_PELICANS,0,0,10257,0
10257,2020-03-25,2020-03-24,SAN_ANTONIO_SPURS,UTAH_JAZZ,0,0,10258,0
10258,2020-03-25,2020-03-24,LOS_ANGELES_CLIPPERS,BROOKLYN_NETS,0,0,10259,0
10259,2020-03-25,2020-03-24,PORTLAND_TRAIL_BLAZERS,DETROIT_PISTONS,0,0,10260,0
10260,2020-03-25,2020-03-24,INDIANA_PACERS,ORLANDO_MAGIC,0,0,10261,0
10261,2020-03-25,2020-03-24,PHOENIX_SUNS,WASHINGTON_WIZARDS,0,0,10262,0
10262,2020-03-25,2020-03-24,DENVER_NUGGETS,MIAMI_HEAT,0,0,10263,0
10263,2020-03-25,2020-03-24,TORONTO_RAPTORS,NEW_YORK_KNICKS,0,0,10264,0
10264,2020-03-26,2020-03-25,BOSTON_CELTICS,MEMPHIS_GRIZZLIES,0,0,10265,0
10265,2020-03-26,2020-03-25,HOUSTON_ROCKETS,MILWAUKEE_BUCKS,0,0,10266,0
10266,2020-03-26,2020-03-25,ATLANTA_HAWKS,GOLDEN_STATE_WARRIORS,0,0,10267,0
10267,2020-03-26,2020-03-25,LOS_ANGELES_LAKERS,CLEVELAND_CAVALIERS,0,0,10268,0
10268,2020-03-27,2020-03-26,PHILADELPHIA_76ERS,CHICAGO_BULLS,0,0,10269,0
10269,2020-03-27,2020-03-26,SAN_ANTONIO_SPURS,MINNESOTA_TIMBERWOLVES,0,0,10270,0
10270,2020-03-27,2020-03-26,CHARLOTTE_HORNETS,OKLAHOMA_CITY_THUNDER,0,0,10271,0
10271,2020-03-27,2020-03-26,UTAH_JAZZ,DALLAS_MAVERICKS,0,0,10272,0
10272,2020-03-27,2020-03-26,ATLANTA_HAWKS,SACRAMENTO_KINGS,0,0,10273,0
10273,2020-03-27,2020-03-26,LOS_ANGELES_CLIPPERS,DETROIT_PISTONS,0,0,10274,0
10274,2020-03-27,2020-03-26,HOUSTON_ROCKETS,INDIANA_PACERS,0,0,10275,0
10275,2020-03-27,2020-03-26,BROOKLYN_NETS,ORLANDO_MAGIC,0,0,10276,0
10276,2020-03-27,2020-03-26,PHOENIX_SUNS,PHILADELPHIA_76ERS,0,0,10277,0
10277,2020-03-27,2020-03-26,PORTLAND_TRAIL_BLAZERS,BOSTON_CELTICS,0,0,10278,0
10278,2020-03-28,2020-03-27,NEW_YORK_KNICKS,NEW_ORLEANS_PELICANS,0,0,10279,0
10279,2020-03-28,2020-03-27,WASHINGTON_WIZARDS,MILWAUKEE_BUCKS,0,0,10280,0
10280,2020-03-28,2020-03-27,SAN_ANTONIO_SPURS,DENVER_NUGGETS,0,0,10281,0
10281,2020-03-28,2020-03-27,CLEVELAND_CAVALIERS,BROOKLYN_NETS,0,0,10282,0
10282,2020-03-28,2020-03-27,LOS_ANGELES_CLIPPERS,CHARLOTTE_HORNETS,0,0,10283,0
10283,2020-03-29,2020-03-28,NEW_YORK_KNICKS,CHICAGO_BULLS,0,0,10284,0
10284,2020-03-29,2020-03-28,TORONTO_RAPTORS,MEMPHIS_GRIZZLIES,0,0,10285,0
10285,2020-03-29,2020-03-28,PHOENIX_SUNS,MIAMI_HEAT,0,0,10286,0
10286,2020-03-29,2020-03-28,LOS_ANGELES_LAKERS,WASHINGTON_WIZARDS,0,0,10287,0
10287,2020-03-29,2020-03-28,OKLAHOMA_CITY_THUNDER,GOLDEN_STATE_WARRIORS,0,0,10288,0
10288,2020-03-29,2020-03-28,ATLANTA_HAWKS,UTAH_JAZZ,0,0,10289,0
10289,2020-03-29,2020-03-28,MILWAUKEE_BUCKS,DALLAS_MAVERICKS,0,0,10290,0
10290,2020-03-29,2020-03-28,HOUSTON_ROCKETS,DETROIT_PISTONS,0,0,10291,0
10291,2020-03-29,2020-03-28,MINNESOTA_TIMBERWOLVES,BOSTON_CELTICS,0,0,10292,0
10292,2020-03-29,2020-03-28,NEW_ORLEANS_PELICANS,ORLANDO_MAGIC,0,0,10293,0
10293,2020-03-29,2020-03-28,PORTLAND_TRAIL_BLAZERS,PHILADELPHIA_76ERS,0,0,10294,0
10294,2020-03-30,2020-03-29,SAN_ANTONIO_SPURS,GOLDEN_STATE_WARRIORS,0,0,10295,0
10295,2020-03-30,2020-03-29,INDIANA_PACERS,SACRAMENTO_KINGS,0,0,10296,0
10296,2020-03-30,2020-03-29,MIAMI_HEAT,CHARLOTTE_HORNETS,0,0,10297,0
10297,2020-03-30,2020-03-29,PHOENIX_SUNS,CLEVELAND_CAVALIERS,0,0,10298,0
10298,2020-03-30,2020-03-29,PORTLAND_TRAIL_BLAZERS,BROOKLYN_NETS,0,0,10299,0
10299,2020-03-30,2020-03-29,MEMPHIS_GRIZZLIES,TORONTO_RAPTORS,0,0,10300,0
10300,2020-03-31,2020-03-30,LOS_ANGELES_LAKERS,MINNESOTA_TIMBERWOLVES,0,0,10301,0
10301,2020-03-31,2020-03-30,OKLAHOMA_CITY_THUNDER,DENVER_NUGGETS,0,0,10302,0
10302,2020-03-31,2020-03-30,CHICAGO_BULLS,UTAH_JAZZ,0,0,10303,0
10303,2020-03-31,2020-03-30,INDIANA_PACERS,LOS_ANGELES_CLIPPERS,0,0,10304,0
10304,2020-03-31,2020-03-30,NEW_ORLEANS_PELICANS,ATLANTA_HAWKS,0,0,10305,0
10305,2020-03-31,2020-03-30,HOUSTON_ROCKETS,PHILADELPHIA_76ERS,0,0,10306,0
10306,2020-04-01,2020-03-31,DENVER_NUGGETS,GOLDEN_STATE_WARRIORS,0,0,10307,0
10307,2020-04-01,2020-03-31,SAN_ANTONIO_SPURS,SACRAMENTO_KINGS,0,0,10308,0
10308,2020-04-01,2020-03-31,CHARLOTTE_HORNETS,ORLANDO_MAGIC,0,0,10309,0
10309,2020-04-01,2020-03-31,NEW_ORLEANS_PELICANS,WASHINGTON_WIZARDS,0,0,10310,0
10310,2020-04-01,2020-03-31,MIAMI_HEAT,BOSTON_CELTICS,0,0,10311,0
10311,2020-04-01,2020-03-31,DETROIT_PISTONS,BROOKLYN_NETS,0,0,10312,0
10312,2020-04-02,2020-04-01,NEW_YORK_KNICKS,MEMPHIS_GRIZZLIES,0,0,10313,0
10313,2020-04-02,2020-04-01,DALLAS_MAVERICKS,MINNESOTA_TIMBERWOLVES,0,0,10314,0
10314,2020-04-02,2020-04-01,PHOENIX_SUNS,OKLAHOMA_CITY_THUNDER,0,0,10315,0
10315,2020-04-02,2020-04-01,TORONTO_RAPTORS,MILWAUKEE_BUCKS,0,0,10316,0
10316,2020-04-02,2020-04-01,CLEVELAND_CAVALIERS,UTAH_JAZZ,0,0,10317,0
10317,2020-04-02,2020-04-01,INDIANA_PACERS,LOS_ANGELES_LAKERS,0,0,10318,0
10318,2020-04-03,2020-04-02,GOLDEN_STATE_WARRIORS,HOUSTON_ROCKETS,0,0,10319,0
10319,2020-04-03,2020-04-02,LOS_ANGELES_CLIPPERS,SACRAMENTO_KINGS,0,0,10320,0
10320,2020-04-03,2020-04-02,UTAH_JAZZ,PORTLAND_TRAIL_BLAZERS,0,0,10321,0
10321,2020-04-03,2020-04-02,MIAMI_HEAT,DETROIT_PISTONS,0,0,10322,0
10322,2020-04-03,2020-04-02,BROOKLYN_NETS,INDIANA_PACERS,0,0,10323,0
10323,2020-04-03,2020-04-02,PHILADELPHIA_76ERS,WASHINGTON_WIZARDS,0,0,10324,0
10324,2020-04-03,2020-04-02,CHARLOTTE_HORNETS,ATLANTA_HAWKS,0,0,10325,0
10325,2020-04-03,2020-04-02,ORLANDO_MAGIC,BOSTON_CELTICS,0,0,10326,0
10326,2020-04-03,2020-04-02,MINNESOTA_TIMBERWOLVES,NEW_YORK_KNICKS,0,0,10327,0
10327,2020-04-03,2020-04-02,MILWAUKEE_BUCKS,TORONTO_RAPTORS,0,0,10328,0
10328,2020-04-04,2020-04-03,DALLAS_MAVERICKS,MEMPHIS_GRIZZLIES,0,0,10329,0
10329,2020-04-04,2020-04-03,GOLDEN_STATE_WARRIORS,SAN_ANTONIO_SPURS,0,0,10330,0
10330,2020-04-04,2020-04-03,CHICAGO_BULLS,DENVER_NUGGETS,0,0,10331,0
10331,2020-04-04,2020-04-03,CLEVELAND_CAVALIERS,PHOENIX_SUNS,0,0,10332,0
10332,2020-04-04,2020-04-03,OKLAHOMA_CITY_THUNDER,LOS_ANGELES_CLIPPERS,0,0,10333,0
10333,2020-04-05,2020-04-04,LOS_ANGELES_LAKERS,SACRAMENTO_KINGS,0,0,10334,0
10334,2020-04-05,2020-04-04,ATLANTA_HAWKS,CHARLOTTE_HORNETS,0,0,10335,0
10335,2020-04-05,2020-04-04,ORLANDO_MAGIC,PHILADELPHIA_76ERS,0,0,10336,0
10336,2020-04-05,2020-04-04,MILWAUKEE_BUCKS,BOSTON_CELTICS,0,0,10337,0
10337,2020-04-05,2020-04-04,WASHINGTON_WIZARDS,INDIANA_PACERS,0,0,10338,0
10338,2020-04-05,2020-04-04,MIAMI_HEAT,NEW_YORK_KNICKS,0,0,10339,0
10339,2020-04-05,2020-04-04,DALLAS_MAVERICKS,BROOKLYN_NETS,0,0,10340,0
10340,2020-04-05,2020-04-04,UTAH_JAZZ,DENVER_NUGGETS,0,0,10341,0
10341,2020-04-05,2020-04-04,CHICAGO_BULLS,PHOENIX_SUNS,0,0,10342,0
10342,2020-04-05,2020-04-04,TORONTO_RAPTORS,HOUSTON_ROCKETS,0,0,10343,0
10343,2020-04-05,2020-04-04,DETROIT_PISTONS,MINNESOTA_TIMBERWOLVES,0,0,10344,0
10344,2020-04-05,2020-04-04,NEW_ORLEANS_PELICANS,SAN_ANTONIO_SPURS,0,0,10345,0
10345,2020-04-06,2020-04-05,MEMPHIS_GRIZZLIES,PORTLAND_TRAIL_BLAZERS,0,0,10346,0
10346,2020-04-06,2020-04-05,CLEVELAND_CAVALIERS,SACRAMENTO_KINGS,0,0,10347,0
10347,2020-04-06,2020-04-05,OKLAHOMA_CITY_THUNDER,LOS_ANGELES_LAKERS,0,0,10348,0
10348,2020-04-07,2020-04-06,TORONTO_RAPTORS,WASHINGTON_WIZARDS,0,0,10349,0
10349,2020-04-07,2020-04-06,DETROIT_PISTONS,ATLANTA_HAWKS,0,0,10350,0
10350,2020-04-07,2020-04-06,INDIANA_PACERS,MIAMI_HEAT,0,0,10351,0
10351,2020-04-07,2020-04-06,MILWAUKEE_BUCKS,PHILADELPHIA_76ERS,0,0,10352,0
10352,2020-04-08,2020-04-07,PHOENIX_SUNS,MINNESOTA_TIMBERWOLVES,0,0,10353,0
10353,2020-04-08,2020-04-07,CHARLOTTE_HORNETS,NEW_ORLEANS_PELICANS,0,0,10354,0
10354,2020-04-08,2020-04-07,BROOKLYN_NETS,OKLAHOMA_CITY_THUNDER,0,0,10355,0
10355,2020-04-08,2020-04-07,HOUSTON_ROCKETS,DALLAS_MAVERICKS,0,0,10356,0
10356,2020-04-08,2020-04-07,SACRAMENTO_KINGS,SAN_ANTONIO_SPURS,0,0,10357,0
10357,2020-04-08,2020-04-07,MEMPHIS_GRIZZLIES,DENVER_NUGGETS,0,0,10358,0
10358,2020-04-08,2020-04-07,CLEVELAND_CAVALIERS,PORTLAND_TRAIL_BLAZERS,0,0,10359,0
10359,2020-04-08,2020-04-07,LOS_ANGELES_CLIPPERS,UTAH_JAZZ,0,0,10360,0
10360,2020-04-08,2020-04-07,CHICAGO_BULLS,LOS_ANGELES_LAKERS,0,0,10361,0
10361,2020-04-08,2020-04-07,INDIANA_PACERS,BOSTON_CELTICS,0,0,10362,0
10362,2020-04-08,2020-04-07,TORONTO_RAPTORS,CHARLOTTE_HORNETS,0,0,10363,0
10363,2020-04-08,2020-04-07,ORLANDO_MAGIC,NEW_YORK_KNICKS,0,0,10364,0
10364,2020-04-09,2020-04-08,SAN_ANTONIO_SPURS,HOUSTON_ROCKETS,0,0,10365,0
10365,2020-04-09,2020-04-08,CLEVELAND_CAVALIERS,GOLDEN_STATE_WARRIORS,0,0,10366,0
10366,2020-04-09,2020-04-08,CHICAGO_BULLS,LOS_ANGELES_CLIPPERS,0,0,10367,0
10367,2020-04-09,2020-04-08,DETROIT_PISTONS,MIAMI_HEAT,0,0,10368,0
10368,2020-04-10,2020-04-09,BROOKLYN_NETS,MILWAUKEE_BUCKS,0,0,10369,0
10369,2020-04-10,2020-04-09,SACRAMENTO_KINGS,MINNESOTA_TIMBERWOLVES,0,0,10370,0
10370,2020-04-10,2020-04-09,PHOENIX_SUNS,NEW_ORLEANS_PELICANS,0,0,10371,0
10371,2020-04-10,2020-04-09,DENVER_NUGGETS,PORTLAND_TRAIL_BLAZERS,0,0,10372,0
10372,2020-04-10,2020-04-09,GOLDEN_STATE_WARRIORS,LOS_ANGELES_LAKERS,0,0,10373,0
10373,2020-04-10,2020-04-09,BOSTON_CELTICS,ORLANDO_MAGIC,0,0,10374,0
10374,2020-04-10,2020-04-09,ATLANTA_HAWKS,TORONTO_RAPTORS,0,0,10375,0
10375,2020-04-11,2020-04-10,WASHINGTON_WIZARDS,HOUSTON_ROCKETS,0,0,10376,0
10376,2020-04-11,2020-04-10,NEW_YORK_KNICKS,OKLAHOMA_CITY_THUNDER,0,0,10377,0
10377,2020-04-11,2020-04-10,PHILADELPHIA_76ERS,SAN_ANTONIO_SPURS,0,0,10378,0
10378,2020-04-11,2020-04-10,DETROIT_PISTONS,DALLAS_MAVERICKS,0,0,10379,0
10379,2020-04-11,2020-04-10,WASHINGTON_WIZARDS,CHARLOTTE_HORNETS,0,0,10380,0
10380,2020-04-11,2020-04-10,ORLANDO_MAGIC,INDIANA_PACERS,0,0,10381,0
10381,2020-04-11,2020-04-10,PHILADELPHIA_76ERS,NEW_ORLEANS_PELICANS,0,0,10382,0
10382,2020-04-11,2020-04-10,MILWAUKEE_BUCKS,CLEVELAND_CAVALIERS,0,0,10383,0
10383,2020-04-12,2020-04-11,BROOKLYN_NETS,CHICAGO_BULLS,0,0,10384,0
10384,2020-04-12,2020-04-11,OKLAHOMA_CITY_THUNDER,MEMPHIS_GRIZZLIES,0,0,10385,0
10385,2020-04-12,2020-04-11,BOSTON_CELTICS,MIAMI_HEAT,0,0,10386,0
10386,2020-04-12,2020-04-11,GOLDEN_STATE_WARRIORS,LOS_ANGELES_CLIPPERS,0,0,10387,0
10387,2020-04-12,2020-04-11,SACRAMENTO_KINGS,DENVER_NUGGETS,0,0,10388,0
10388,2020-04-12,2020-04-11,UTAH_JAZZ,PHOENIX_SUNS,0,0,10389,0
10389,2020-04-12,2020-04-11,HOUSTON_ROCKETS,SAN_ANTONIO_SPURS,0,0,10390,0
10390,2020-04-12,2020-04-11,NEW_YORK_KNICKS,TORONTO_RAPTORS,0,0,10391,0
10391,2020-04-12,2020-04-11,ATLANTA_HAWKS,MILWAUKEE_BUCKS,0,0,10392,0
10392,2020-04-13,2020-04-12,MINNESOTA_TIMBERWOLVES,LOS_ANGELES_LAKERS,0,0,10393,0
10393,2020-04-13,2020-04-12,MIAMI_HEAT,CHARLOTTE_HORNETS,0,0,10394,0
10394,2020-04-13,2020-04-12,BROOKLYN_NETS,CLEVELAND_CAVALIERS,0,0,10395,0
10395,2020-04-13,2020-04-12,BOSTON_CELTICS,DETROIT_PISTONS,0,0,10396,0
10396,2020-04-13,2020-04-12,SAN_ANTONIO_SPURS,INDIANA_PACERS,0,0,10397,0
10397,2020-04-14,2020-04-13,ORLANDO_MAGIC,CHICAGO_BULLS,0,0,10398,0
10398,2020-04-14,2020-04-13,PHOENIX_SUNS,HOUSTON_ROCKETS,0,0,10399,0
10399,2020-04-14,2020-04-13,PHILADELPHIA_76ERS,MEMPHIS_GRIZZLIES,0,0,10400,0
10400,2020-04-14,2020-04-13,WASHINGTON_WIZARDS,NEW_ORLEANS_PELICANS,0,0,10401,0
10401,2020-04-14,2020-04-13,UTAH_JAZZ,OKLAHOMA_CITY_THUNDER,0,0,10402,0
10402,2020-04-14,2020-04-13,DALLAS_MAVERICKS,DENVER_NUGGETS,0,0,10403,0
10403,2020-04-14,2020-04-13,PORTLAND_TRAIL_BLAZERS,GOLDEN_STATE_WARRIORS,0,0,10404,0
10404,2020-04-14,2020-04-13,MINNESOTA_TIMBERWOLVES,LOS_ANGELES_CLIPPERS,0,0,10405,0
10405,2020-04-14,2020-04-13,TORONTO_RAPTORS,MIAMI_HEAT,0,0,10406,0
10406,2020-04-14,2020-04-13,DETROIT_PISTONS,NEW_YORK_KNICKS,0,0,10407,0
10407,2020-04-15,2020-04-14,DENVER_NUGGETS,UTAH_JAZZ,0,0,10408,0
10408,2020-04-15,2020-04-14,SACRAMENTO_KINGS,LOS_ANGELES_LAKERS,0,0,10409,0
10409,2020-04-15,2020-04-14,CLEVELAND_CAVALIERS,ATLANTA_HAWKS,0,0,10410,0
10410,2020-04-15,2020-04-14,CHICAGO_BULLS,BOSTON_CELTICS,0,0,10411,0
10411,2020-04-15,2020-04-14,MILWAUKEE_BUCKS,BROOKLYN_NETS,0,0,10412,0
10412,2020-04-15,2020-04-14,OKLAHOMA_CITY_THUNDER,DALLAS_MAVERICKS,0,0,10413,0
10413,2020-04-15,2020-04-14,MEMPHIS_GRIZZLIES,HOUSTON_ROCKETS,0,0,10414,0
10414,2020-04-15,2020-04-14,NEW_YORK_KNICKS,MINNESOTA_TIMBERWOLVES,0,0,10415,0
10415,2020-04-15,2020-04-14,TORONTO_RAPTORS,ORLANDO_MAGIC,0,0,10416,0
10416,2020-04-15,2020-04-14,CHARLOTTE_HORNETS,PHILADELPHIA_76ERS,0,0,10417,0
10417,2020-04-15,2020-04-14,NEW_ORLEANS_PELICANS,SAN_ANTONIO_SPURS,0,0,10418,0
10418,2020-04-15,2020-04-14,INDIANA_PACERS,WASHINGTON_WIZARDS,0,0,10419,0
10419,2020-04-16,2020-04-15,LOS_ANGELES_LAKERS,PHOENIX_SUNS,0,0,10420,0
10420,2020-04-16,2020-04-15,LOS_ANGELES_CLIPPERS,PORTLAND_TRAIL_BLAZERS,0,0,10421,0
10421,2020-04-16,2020-04-15,GOLDEN_STATE_WARRIORS,SACRAMENTO_KINGS,0,0,10422,0
